//MAP CONVERTED BY dmm2tgm.py THIS HEADER COMMENT PREVENTS RECONVERSION, DO NOT REMOVE
"a" = (
/turf/template_noop,
/area/template_noop)
"b" = (
/obj/machinery/mining/brace,
/turf/template_noop,
/area/template_noop)
"c" = (
/obj/machinery/mining/drill,
/turf/template_noop,
/area/template_noop)

(1,1,1) = {"
a
b
a
"}
(2,1,1) = {"
a
c
a
"}
(3,1,1) = {"
a
b
a
"}
