"a" = (/mob/living/heavy_vehicle/premade/light,/turf/simulated/floor/reinforced/airless,/area/security/armoury)

(1,1,1) = {"
a
"}
