//MAP CONVERTED BY dmm2tgm.py THIS HEADER COMMENT PREVENTS RECONVERSION, DO NOT REMOVE
"b" = (
/obj/structure/table/rack,
/obj/item/gun/projectile/dragunov,
/obj/item/gun/energy/rifle/icelance,
/turf/simulated/floor/reinforced/airless,
/area/template_noop)
"d" = (
/obj/structure/railing/mapped{
	dir = 4
	},
/turf/template_noop,
/area/template_noop)
"e" = (
/turf/simulated/floor/reinforced/airless,
/area/template_noop)
"g" = (
/turf/template_noop,
/area/template_noop)
"q" = (
/obj/structure/table/rack,
/obj/item/gun/energy/rifle/icelance,
/obj/item/gun/projectile/shotgun/pump/combat,
/turf/simulated/floor/reinforced/airless,
/area/template_noop)
"y" = (
/obj/structure/railing/mapped{
	dir = 8
	},
/turf/template_noop,
/area/template_noop)
"A" = (
/obj/structure/table/rack,
/obj/item/gun/projectile/tanto,
/obj/item/gun/projectile/automatic/mini_uzi,
/turf/simulated/floor/reinforced/airless,
/area/template_noop)
"K" = (
/obj/structure/railing/mapped,
/turf/template_noop,
/area/template_noop)
"P" = (
/obj/structure/table/rack,
/obj/item/gun/projectile/automatic/rifle/sts35,
/obj/item/gun/projectile/silenced,
/turf/simulated/floor/reinforced/airless,
/area/template_noop)
"Q" = (
/obj/structure/table/rack,
/obj/item/gun/projectile/automatic/mini_uzi,
/obj/item/gun/projectile/silenced,
/turf/simulated/floor/reinforced/airless,
/area/template_noop)
"V" = (
/obj/structure/table/rack,
/obj/item/gun/projectile/shotgun/pump/combat,
/obj/item/gun/projectile/tanto,
/turf/simulated/floor/reinforced/airless,
/area/template_noop)
"Y" = (
/obj/structure/railing/mapped{
	dir = 1
	},
/turf/template_noop,
/area/template_noop)

(1,1,1) = {"
g
d
d
d
g
"}
(2,1,1) = {"
K
Q
b
V
Y
"}
(3,1,1) = {"
g
e
e
e
g
"}
(4,1,1) = {"
K
q
A
P
Y
"}
(5,1,1) = {"
g
y
y
y
g
"}
