"a" = (/turf/unsimulated/chasm_mask,/area/space)
"b" = (/turf/simulated/mineral,/area/space)
"c" = (/turf/simulated/floor/asteroid/ash/rocky,/area/space)
"d" = (/mob/living/simple_animal/hostile/carp,/turf/simulated/floor/asteroid/ash/rocky,/area/space)
"e" = (/obj/effect/decal/remains/human,/obj/random/mining_reward_major,/turf/simulated/floor/asteroid/ash/rocky,/area/space)
"f" = (/obj/effect/decal/remains/human,/obj/random/loot,/turf/simulated/floor/asteroid/ash/rocky,/area/space)
"g" = (/obj/effect/decal/remains/human,/obj/random/mining_reward_minor,/turf/simulated/floor/asteroid/ash/rocky,/area/space)

(1,1,1) = {"
aaaaaaaaaaaaaaaaaaaaaaaaaaaaaaaa
aaaaaaaaaaaaaaaaaaaaaaaaaaaaaaaa
aaaaaaaaaaaaaaaaaaaaaaaaaaaaaaaa
aaaaaaaaaaaaaaaaaaaaaaaaaaaaaaaa
aaaaaaaaaaaaaaaaaaaaaabbbbbbaaaa
aaaaaaaaaaaaaaaaaaaabbbaaaaabaaa
aaaaaabbbbbaaaaaaaabbaaaccaabbaa
aaaaabbababbbaaaaaabaacccccaabaa
aaaabbaaaaaabbaaaabbaccecdccabaa
aaabbaaccccaabaaabbaacccccccabaa
aaabaadccecabbbbbbaaccaaccccabaa
aabbacccccaaaabcaaaccccaacgcabaa
aabaaccgcaaacccccccccdcaacccabaa
abbaccccccccccaaaaacccaacccaabaa
abaacdcccgcdccccccccccccdccabbaa
abbaaccacccccbbbbcaaagccccaabaaa
aabbaaaaccccabaabbbbaacaaaabbaaa
aaabbbaaacccabaaaaabbaaabbbbaaaa
aaaaabbbaaccabaaaaaabbbbbaaaaaaa
aaaaaaabbacaabaaaaaaaaaaaaaaaaaa
aaaaaaabaacabbaaaaaaaaaaaaaaaaaa
aaaaaabbaccabbaaaaaaaaaaaaaaaaaa
aaaaaabaaccaabbaaaaaaaaaaaaaaaaa
aaaaaabacdccaabbaaaaaaaaaaaaaaaa
aaaaaabaaccccaabbaaaaaaaaaaaaaaa
aaaaaabbaaacccaabbaaaaaaaaaaaaaa
aaaaaaabbbbacccaabaaaaaaaaaaaaaa
aaaaaaaaaabaacccabaaaaaaaaaaaaaa
aaaaaaaaaabaacccabaaaaaaaaaaaaaa
aaaaaaaaaabaccdcabaaaaaaaaaaaaaa
aaaaaaaaaabaacccabaaaaaaaaaaaaaa
aaaaaaaaaabaacfcbbaaaaaaaaaaaaaa
"}
