"a" = (/turf/unsimulated/chasm_mask,/area/space)
"b" = (/turf/simulated/mineral,/area/space)
"c" = (/turf/simulated/floor/asteroid/ash/rocky,/area/space)
"d" = (/obj/effect/decal/remains/human,/obj/random/mining_reward_minor,/turf/simulated/floor/asteroid/ash/rocky,/area/space)
"e" = (/mob/living/simple_animal/hostile/carp,/turf/simulated/floor/asteroid/ash/rocky,/area/space)
"f" = (/obj/effect/decal/remains/human,/obj/random/mining_reward_major,/turf/simulated/floor/asteroid/ash/rocky,/area/space)
"g" = (/mob/living/simple_animal/hostile/carp/shark,/turf/simulated/floor/asteroid/ash/rocky,/area/space)

(1,1,1) = {"
aaaaaaabaaaaaaaaaaaaaaaaaaaaaaaa
baaaaaaabaaaaaaaaaaaaaaaaaaaaaaa
bbbbbbaabaaaaaaaaaaaaaaaaaaaaaaa
aaaaabbbbbaaaaaaaaaaaaaaaaaabbbb
cccaaaaabbbaaaaaaaaaabbbbbbbbbbb
cdcccccaaabbaaaaaabbbbbbbbbbbbaa
cceccccccaabaaaabbbaaabbbbbbbaaa
aaccccccccabbaabbaaaaaaaaaaaaacc
baaacccccccababbaaaccccaaaaccccc
bbaaaacccccabbbaaaccfgcaccccccaa
abbbaaacccccabbaaaccccccccccaaac
aaabbaaaccccabbaacccaaccaaaaaccc
aaaabbbaacccaabacccaaacccccccccc
aaaaaabbaaccaaaccccaaccccccccaaa
aaaaaaabacccaacccaaaccccaacccaaa
aaaaaaabcdcccccccaccccaaaacecaaa
aaaaaaabccceccdcccccccaaaaccdaaa
aaaaaaabacccccccacccaaaaaacccaaa
aaaaaaabaccccccaaaaaaaaaaacccaaa
aaaaaabbaacccecaaaabbbbbaaaccaaa
aaaaaabaacccccccaaaabbbbbaacccaa
aaaaabbaccccccccccaaaabbbbacccaa
aaaabbaaccccaaaccccaaaabbbacccaa
aaaabaacccccaaaacccccaaaaaaaccaa
aaaabaaccccaabaaacccccaaaaaaccaa
aaabbacccccabbbaaaccccccaaaaccaa
aaabaaccecaababaaaaccccccaaaacca
aaabaacdccabbabbbaaaccccccaaacca
aabbaacccaabaaaabbbaaccccccaacca
aabaaacccaabaaaaaabbaaccceccacca
abbaacccaabbaaaaaaabbbaaccdccaca
abaaaccaaabaaaaaaaaaabbaacccccca
"}
