"a" = (/turf/unsimulated/chasm_mask,/area/mine/unexplored)
"b" = (/turf/simulated/floor/asteroid/ash/rocky,/area/mine/unexplored)
"c" = (/mob/living/simple_animal/hostile/carp,/turf/simulated/floor/asteroid/ash/rocky,/area/mine/unexplored)
"d" = (/obj/effect/decal/remains,/obj/random/mining_reward_minor,/turf/simulated/floor/asteroid/ash/rocky,/area/mine/unexplored)
"e" = (/turf/simulated/mineral,/area/mine/unexplored)
"f" = (/obj/structure/closet/crate,/obj/random/spacecash,/obj/random/spacecash,/obj/random/spacecash,/obj/random/spacecash,/obj/random/spacecash,/obj/random/spacecash,/obj/random/spacecash,/obj/random/spacecash,/obj/random/spacecash,/obj/random/spacecash,/obj/random/mining_reward_major,/obj/random/mining_reward_minor,/turf/simulated/floor/asteroid/ash/rocky,/area/mine/unexplored)
"g" = (/obj/structure/simple_door/wood,/turf/simulated/floor/asteroid/ash/rocky,/area/mine/unexplored)
"h" = (/mob/living/simple_animal/hostile/carp/shark,/turf/simulated/floor/asteroid/ash/rocky,/area/mine/unexplored)

(1,1,1) = {"
aaaaaebbbeaaaaaaaaaaaaaaaaaaaaaa
aaaaaebbbeeaaaaaaaaaaaaaaaaaaaaa
aaaaaebbbbeaaaaaaaaaaaaaaaaaaaaa
aaaaaeebdbeaaaaaaaaaaaaaaaaaaaaa
aaaaaeebbbeaaaaaaaaaaaaaaaaaaaee
aaaaaaebbbeaaaaaaaaaaaaaaaaaaeeb
aaaaaaeebbeaaaeeeeeaaaaaaaaaeebb
aaaaaaaebbeeeeebbbeeeeaaaaaeebbb
aaaaaaeeebbbbbbbcbbbbeaaaaeebbbb
eeeeaeebbbbbbbbbbbbbbeeeaeebbbbb
bbbeeebbbbdbbbaaaabbbbbeeebbbbbe
bbbbbbbbbcbbbaaaaabbbbbbebbbbbee
bbbbbbbbbbbbbbaaaaabbbbbbbbbbeea
eeebbbbcbbbbbbbaaaabbbcbbbbbeeaa
aaeeeebbbbbabbbbaaaabbbbbbdbeeea
aaaaeebbaaaaabbbaaaabbbbbbbbbbee
aaaaebbaaaaabbbbbaabbbbbbbbbbbbe
aaaaebbaaabbbbdbbbbbbbaabbbbbbbb
aaaaebbbabbbbbbbbbbbbaaaaaaabbbb
aaaeeebbbbbbaabbbcbbaaeeeeeaabbb
aeeebbbbbcbbbaabbbbbaeeahaeeabbe
eebbbbbbbbbbbaabbbbbaeabbbaeabbe
bbdbbbeeeebbbaaabbbbaebbfbbeabbe
bbbbeeeaaebbbaaaabbbaeabbbaeabbb
bbeeeaaaeebbbaaaabbaaeeabaeeabbb
eeeaaaaaebbbaaaaabbaaaeebeeaabbb
aaaaaaaaebbbaaaaabbbaaaegeaabbbe
aaaaaaeeebbaaaaabbbbaaeebeebbdbe
aaaaeeebbbbbaaaabbbbbbbbbbbcbbbe
aaaeebbbbbdbbbbbbbbbbbdbeeebbbbe
aeeebbbbeebbbbdbbcbbbbeeebbbbbbb
aebbbbeeeeeeeebbbbeeeeeebbbeebbb
"}
