"a" = (/turf/unsimulated/chasm_mask,/area/mine/unexplored)
"b" = (/turf/simulated/wall/cult,/area/mine/unexplored)
"c" = (/obj/structure/cult/pylon,/turf/simulated/floor/cult,/area/mine/unexplored)
"d" = (/turf/simulated/floor/cult,/area/mine/unexplored)
"e" = (/obj/structure/constructshell/cult,/turf/simulated/floor/cult,/area/mine/unexplored)
"f" = (/obj/structure/cult/talisman,/obj/item/clothing/suit/space/cult,/obj/item/clothing/head/helmet/space/cult,/obj/item/weapon/melee/cultblade,/turf/simulated/floor/cult,/area/mine/unexplored)

(1,1,1) = {"
aaaaaaaaaaaaaaaaaaaaaaaaaaaaaaaa
aaaaaaaaaaaaaaaaaaaaaaaaaaaaaaaa
aaaaaaaaaaaaaaaaaaaaaaaaaaaaaaaa
aaaaaaaaaaaaaaaaaaaaaaaaaaaaaaaa
aaaaaaaaaaaaaaaaaaaaaaaaaaaaaaaa
aaaaaaaaaaaaaaaaaaaaaaaaaaaaaaaa
aaaaaaaaaaaaaaaaaaaaaaaaaaaaaaaa
aaaaaaaaaaaaaaaaaaaaaaaaaaaaaaaa
aaaaaaaaaaaaaaaaaaaaaaaaaaaaaaaa
aaaaaaaaaaaaaaaaaaaaaaaaaaaaaaaa
aaaaaaaaaaaaaaaaaaaaaaaaaaaaaaaa
aaaaaaaaaaaaaaaaaaaaaaaaaaaaaaaa
aaaaaaaaaaaaaaaaaaaaaaaaaaaaaaaa
aaaaaaaaaabbbbbbbbbaaaaaaaaaaaaa
aaaaaaaaaabcdddddcbaaaaaaaaaaaaa
aaaaaaaaaabdddddddbaaaaaaaaaaaaa
aaaaaaaaaabddefeddbaaaaaaaaaaaaa
aaaaaaaaaabdddddddbaaaaaaaaaaaaa
aaaaaaaaaabdddddddbaaaaaaaaaaaaa
aaaaaaaaaabdddddddbaaaaaaaaaaaaa
aaaaaaaaaabcdddddcbaaaaaaaaaaaaa
aaaaaaaaaabbbbdbbbbaaaaaaaaaaaaa
aaaaaaaaaaaaaaaaaaaaaaaaaaaaaaaa
aaaaaaaaaaaaaaaaaaaaaaaaaaaaaaaa
aaaaaaaaaaaaaaaaaaaaaaaaaaaaaaaa
aaaaaaaaaaaaaaaaaaaaaaaaaaaaaaaa
aaaaaaaaaaaaaaaaaaaaaaaaaaaaaaaa
aaaaaaaaaaaaaaaaaaaaaaaaaaaaaaaa
aaaaaaaaaaaaaaaaaaaaaaaaaaaaaaaa
aaaaaaaaaaaaaaaaaaaaaaaaaaaaaaaa
aaaaaaaaaaaaaaaaaaaaaaaaaaaaaaaa
aaaaaaaaaaaaaaaaaaaaaaaaaaaaaaaa
"}
