"a" = (/turf/unsimulated/chasm_mask,/area/mine/unexplored)
"b" = (/turf/simulated/floor/asteroid/ash/rocky,/area/mine/unexplored)
"c" = (/obj/effect/decal/remains/human,/turf/simulated/floor/asteroid/ash/rocky,/area/mine/unexplored)
"d" = (/obj/effect/decal/remains/human,/obj/random/mining_reward_minor,/turf/simulated/floor/asteroid/ash/rocky,/area/mine/unexplored)
"e" = (/obj/item/stack/material/gold{amount = 50},/obj/item/stack/material/gold{amount = 50},/obj/item/stack/material/gold{amount = 50},/obj/random/mining_reward_major,/obj/random/mining_reward_major,/mob/living/simple_animal/hostile/mimic/crate,/turf/simulated/floor/asteroid/ash/rocky,/area/mine/unexplored)

(1,1,1) = {"
aaaaaaaaaabbbbbbbbbbbaaaaaaaaaaa
aaaaaaaaabbbcbbbcbbbbbbbaaaaaaaa
aaaaaaabbbbbbbbbbbbcbbbbbaaaaaaa
aaaaabbbbbbcbbbbbbbbbbbbbbbaaaaa
aaaabbbbbbbbbbbbdbbbbcbbbbbbaaaa
aabbbbcbcbbbbbbbbcbbbbbcbbbbbaaa
aabcbbbbbbbbcbbbbbbcbbbbbbbbbbaa
aabbbbbbcbbbbbbbbbbbbbbcbbbbbbaa
aabbbbbbbbbbbbbcbbbbbbbbbbbbcbba
abbbcbbbbbbbbbbbbbdbbbbbbbbbbbba
abbbbbbbdbbbcbbbbbbbbbcbbcbbcbba
abbbbbbbbbbbbbbbbbbbbbbbbbbbbbcb
abbcbcbbbbbbbbbbbbbcbcbbbbbbbbbb
abbbbbbbbbbbbbbbcbbbbbbbbbbbcbbb
bbbbbbbbbcbbcbbbbbbbbbbbcbbbbcbb
bbbcbbbbbbbbbbbbbbbbbbbbbbbbbbbb
bcbbbbcbbbbbbbbbebbbbcbbbbbbbbbb
bbbbbbbbcbbbbbbbbbbbbbbbbbbcbbbb
bbbbbbbbbbbbbbcbbbbbbbbdbbbbbbbb
bbbbbbbbbbdbbbbbbbbbbbbbbcbbbcbb
abbbbbbbbbbbbbbbbbbcbbbbbbbbbbbb
aabbcbbbbbbbbcbbcbbbbbbcbbbbbbbb
aabbbbbbbbbbbbbbbbbbbbbbbbbbbbbb
aabbbcbcbbcbbbbbbbbbbbbbbbcbcbba
aaabbbbbbbbbbcbbbdbbbcbbbbbbbbba
aaaabbbbbbbbbbbbbbbbbbbbbbbbbbba
aaaaabbbbbcbbbbbbbbbbcbbbcbbbbaa
aaaaaabbbbbbbbbbbbbbbbbbbbbbbbaa
aaaaaaabbbbbbcbbbcbbbcbbbbbbaaaa
aaaaaaaaabbbbbbbbbbbbbbbbcbaaaaa
aaaaaaaaaaaabbbbbbbbbbbbbaaaaaaa
aaaaaaaaaaaaaabbbbbbaaaaaaaaaaaa
"}
