//MAP CONVERTED BY dmm2tgm.py THIS HEADER COMMENT PREVENTS RECONVERSION, DO NOT REMOVE
"cB" = (
/obj/machinery/door/airlock/external{
	dir = 2
	},
/obj/effect/shuttle_landmark{
	dir = 1
	},
/turf/simulated/floor/plating,
/area/template_noop)
"du" = (
/obj/machinery/portable_atmospherics/canister/air/airlock,
/turf/simulated/floor/tiled/dark/full,
/area/template_noop)
"dA" = (
/obj/effect/map_effect/map_helper/mark_good,
/turf/simulated/floor/tiled/dark/full,
/area/template_noop)
"fG" = (
/obj/effect/shuttle_landmark{
	dir = 1
	},
/turf/template_noop,
/area/template_noop)
"iU" = (
/obj/effect/map_effect/map_helper/mark_bad,
/obj/machinery/atmospherics/unary/vent_pump{
	dir = 1
	},
/turf/simulated/floor/plating,
/area/template_noop)
"iY" = (
/obj/machinery/door/airlock/external{
	dir = 4
	},
/turf/simulated/floor/plating,
/area/template_noop)
"kZ" = (
/turf/simulated/floor/tiled/dark/full,
/area/template_noop)
"ly" = (
/obj/effect/map_effect/map_helper/mark_acceptable,
/turf/simulated/wall/shuttle/scc_space_ship/cardinal,
/area/template_noop)
"lO" = (
/obj/machinery/door/airlock/external{
	dir = 2
	},
/obj/effect/map_effect/map_helper/mark_good,
/turf/simulated/floor/plating,
/area/template_noop)
"nd" = (
/turf/simulated/wall,
/area/template_noop)
"pS" = (
/obj/machinery/door/airlock/external{
	dir = 2
	},
/obj/effect/map_effect/map_helper/mark_bad,
/turf/simulated/floor/plating,
/area/template_noop)
"qS" = (
/obj/machinery/atmospherics/unary/vent_pump{
	dir = 2
	},
/turf/simulated/floor/plating,
/area/template_noop)
"sX" = (
/obj/machinery/door/airlock/external{
	dir = 4
	},
/obj/effect/shuttle_landmark{
	dir = 4
	},
/turf/simulated/floor/plating,
/area/template_noop)
"zb" = (
/obj/machinery/atmospherics/unary/vent_pump{
	dir = 1
	},
/turf/simulated/floor/plating,
/area/template_noop)
"zc" = (
/obj/machinery/atmospherics/unary/vent_pump{
	dir = 8
	},
/turf/simulated/floor/plating,
/area/template_noop)
"AE" = (
/obj/effect/shuttle_landmark{
	dir = 2
	},
/turf/template_noop,
/area/template_noop)
"AS" = (
/obj/machinery/atmospherics/unary/vent_pump{
	dir = 1
	},
/obj/effect/map_effect/map_helper/mark_good,
/turf/simulated/floor/plating,
/area/template_noop)
"Cz" = (
/obj/machinery/atmospherics/unary/vent_pump{
	dir = 1
	},
/obj/effect/map_effect/map_helper/mark_bad,
/turf/simulated/floor/plating,
/area/template_noop)
"DW" = (
/turf/template_noop,
/area/template_noop)
"KT" = (
/obj/machinery/atmospherics/unary/vent_pump{
	dir = 1
	},
/obj/effect/map_effect/map_helper/mark_acceptable,
/turf/simulated/floor/plating,
/area/template_noop)
"KX" = (
/obj/machinery/door/airlock/external{
	dir = 2
	},
/turf/simulated/floor/plating,
/area/template_noop)
"Lt" = (
/turf/simulated/wall/shuttle/scc_space_ship/cardinal,
/area/template_noop)
"MH" = (
/obj/effect/shuttle_landmark{
	dir = 1
	},
/turf/simulated/floor/plating,
/area/template_noop)
"Nh" = (
/obj/machinery/door/airlock/external{
	dir = 2
	},
/obj/effect/shuttle_landmark{
	dir = 2
	},
/turf/simulated/floor/plating,
/area/template_noop)
"Qa" = (
/obj/machinery/atmospherics/unary/vent_pump{
	dir = 4
	},
/turf/simulated/floor/plating,
/area/template_noop)
"Ss" = (
/obj/machinery/door/airlock/external{
	dir = 4
	},
/obj/effect/shuttle_landmark{
	dir = 8
	},
/turf/simulated/floor/plating,
/area/template_noop)
"YK" = (
/turf/simulated/floor/plating,
/area/template_noop)
"Zz" = (
/obj/machinery/door/airlock/external{
	dir = 2
	},
/obj/effect/map_effect/map_helper/mark_acceptable,
/turf/simulated/floor/plating,
/area/template_noop)

(1,1,1) = {"
DW
DW
DW
DW
DW
DW
DW
DW
DW
DW
DW
DW
DW
DW
DW
DW
DW
DW
DW
DW
DW
DW
DW
DW
DW
DW
DW
DW
DW
DW
DW
DW
DW
DW
DW
DW
DW
DW
DW
DW
DW
DW
DW
DW
DW
DW
DW
DW
DW
DW
DW
DW
DW
DW
DW
DW
DW
DW
DW
DW
"}
(2,1,1) = {"
DW
DW
DW
DW
DW
DW
DW
DW
DW
DW
DW
DW
DW
DW
DW
DW
DW
DW
DW
DW
DW
DW
DW
DW
DW
DW
DW
DW
DW
DW
DW
DW
DW
DW
nd
nd
nd
nd
nd
nd
nd
nd
nd
nd
nd
nd
nd
nd
nd
nd
nd
nd
nd
nd
nd
nd
nd
nd
nd
DW
"}
(3,1,1) = {"
DW
DW
DW
DW
DW
DW
DW
DW
DW
DW
DW
DW
DW
DW
DW
DW
DW
DW
DW
DW
DW
DW
DW
DW
DW
DW
DW
DW
DW
DW
DW
DW
DW
DW
nd
DW
DW
DW
DW
DW
DW
DW
DW
DW
DW
DW
DW
DW
DW
DW
DW
DW
DW
DW
DW
DW
DW
DW
nd
DW
"}
(4,1,1) = {"
DW
DW
DW
DW
DW
DW
DW
DW
DW
DW
DW
DW
DW
DW
DW
DW
DW
DW
DW
DW
DW
DW
DW
DW
DW
DW
DW
DW
DW
DW
DW
DW
DW
DW
nd
DW
DW
DW
DW
DW
DW
DW
DW
DW
Lt
kZ
kZ
Lt
Lt
DW
DW
DW
DW
DW
DW
DW
DW
DW
nd
DW
"}
(5,1,1) = {"
DW
DW
DW
DW
DW
DW
DW
DW
DW
DW
DW
DW
DW
DW
DW
DW
DW
DW
DW
DW
DW
DW
DW
DW
DW
DW
DW
DW
DW
DW
DW
DW
DW
DW
nd
DW
DW
DW
DW
DW
DW
DW
DW
DW
Lt
dA
kZ
du
Lt
DW
DW
DW
DW
DW
DW
DW
DW
DW
nd
DW
"}
(6,1,1) = {"
DW
DW
DW
DW
DW
DW
DW
DW
DW
DW
DW
DW
DW
DW
DW
DW
DW
DW
DW
DW
DW
DW
DW
DW
DW
DW
DW
DW
DW
DW
DW
DW
DW
DW
nd
DW
DW
DW
DW
DW
DW
DW
DW
DW
Lt
kZ
kZ
du
Lt
DW
DW
DW
DW
DW
DW
DW
DW
DW
nd
DW
"}
(7,1,1) = {"
DW
DW
DW
DW
DW
DW
DW
DW
DW
DW
DW
DW
DW
DW
DW
DW
DW
DW
DW
DW
DW
DW
DW
DW
DW
DW
DW
DW
DW
DW
DW
DW
DW
DW
nd
DW
DW
DW
DW
DW
DW
DW
DW
DW
Lt
iY
iY
Lt
Lt
DW
DW
DW
DW
DW
DW
DW
DW
DW
nd
DW
"}
(8,1,1) = {"
DW
DW
DW
DW
DW
DW
DW
DW
DW
DW
DW
DW
DW
DW
DW
DW
DW
DW
DW
DW
DW
DW
DW
DW
DW
DW
DW
DW
DW
DW
DW
DW
DW
DW
nd
DW
DW
DW
DW
DW
DW
DW
DW
DW
Lt
zc
zc
Lt
DW
DW
DW
DW
DW
DW
DW
DW
DW
DW
nd
DW
"}
(9,1,1) = {"
DW
DW
DW
DW
DW
DW
DW
DW
DW
DW
DW
DW
DW
DW
DW
DW
DW
DW
DW
DW
DW
DW
DW
DW
DW
DW
DW
DW
DW
DW
DW
DW
DW
DW
nd
DW
DW
DW
DW
DW
DW
DW
DW
DW
Lt
YK
YK
Lt
DW
DW
DW
DW
DW
DW
DW
DW
DW
DW
nd
DW
"}
(10,1,1) = {"
DW
DW
DW
DW
DW
DW
DW
DW
DW
DW
DW
DW
DW
DW
DW
DW
DW
DW
DW
DW
DW
DW
DW
DW
DW
DW
DW
DW
DW
DW
DW
DW
DW
DW
nd
DW
DW
DW
DW
DW
DW
DW
DW
DW
Lt
Ss
iY
Lt
DW
DW
DW
DW
DW
DW
DW
DW
DW
DW
nd
DW
"}
(11,1,1) = {"
DW
DW
DW
DW
DW
DW
DW
DW
DW
DW
DW
DW
DW
DW
DW
DW
DW
DW
DW
DW
DW
DW
DW
DW
DW
DW
DW
DW
DW
DW
DW
DW
DW
DW
nd
DW
DW
DW
DW
DW
DW
DW
DW
DW
DW
DW
DW
DW
DW
DW
DW
DW
DW
DW
DW
DW
DW
DW
nd
DW
"}
(12,1,1) = {"
DW
DW
DW
DW
DW
DW
DW
DW
DW
DW
DW
DW
DW
DW
DW
DW
DW
DW
DW
DW
DW
DW
DW
DW
DW
DW
DW
DW
DW
DW
DW
DW
DW
DW
nd
DW
DW
DW
DW
DW
DW
DW
DW
DW
DW
DW
DW
DW
DW
DW
DW
DW
DW
DW
DW
DW
DW
DW
nd
DW
"}
(13,1,1) = {"
DW
DW
DW
DW
DW
DW
DW
DW
DW
DW
DW
DW
DW
DW
DW
DW
DW
DW
DW
DW
DW
DW
DW
DW
DW
DW
DW
DW
DW
DW
DW
DW
DW
DW
nd
DW
Lt
Lt
Lt
Lt
Lt
Lt
Lt
DW
DW
DW
DW
DW
DW
DW
Lt
Lt
Lt
Lt
Lt
Lt
Lt
DW
nd
DW
"}
(14,1,1) = {"
DW
DW
DW
DW
DW
DW
DW
DW
DW
DW
DW
DW
DW
DW
DW
DW
DW
DW
DW
DW
DW
DW
DW
DW
DW
DW
DW
DW
DW
DW
DW
DW
DW
DW
nd
DW
kZ
kZ
kZ
KX
zb
YK
KX
DW
DW
DW
DW
DW
DW
DW
Nh
YK
qS
KX
kZ
kZ
kZ
DW
nd
DW
"}
(15,1,1) = {"
DW
DW
DW
DW
DW
DW
DW
DW
DW
DW
DW
DW
DW
DW
DW
DW
DW
DW
DW
DW
DW
DW
DW
DW
DW
DW
DW
DW
DW
DW
DW
DW
DW
DW
nd
DW
kZ
kZ
dA
KX
zb
YK
cB
DW
DW
DW
DW
DW
DW
DW
KX
YK
qS
KX
kZ
dA
kZ
DW
nd
DW
"}
(16,1,1) = {"
DW
DW
DW
DW
DW
DW
DW
DW
DW
DW
DW
DW
DW
DW
DW
DW
DW
DW
DW
DW
DW
DW
DW
DW
DW
DW
DW
DW
DW
DW
DW
DW
DW
DW
nd
DW
Lt
du
du
Lt
Lt
Lt
Lt
DW
DW
DW
DW
DW
DW
DW
Lt
Lt
Lt
Lt
du
du
Lt
DW
nd
DW
"}
(17,1,1) = {"
DW
DW
DW
DW
DW
DW
DW
DW
DW
DW
DW
DW
DW
DW
DW
DW
DW
DW
DW
DW
DW
DW
DW
DW
DW
DW
DW
DW
DW
DW
DW
DW
DW
DW
nd
DW
Lt
Lt
Lt
Lt
DW
DW
DW
DW
DW
DW
DW
DW
DW
DW
DW
DW
DW
Lt
Lt
Lt
Lt
DW
nd
DW
"}
(18,1,1) = {"
DW
DW
DW
DW
DW
DW
DW
DW
DW
DW
DW
DW
DW
DW
DW
DW
DW
DW
DW
DW
DW
DW
DW
DW
DW
DW
DW
DW
DW
DW
DW
DW
DW
DW
nd
DW
DW
DW
DW
DW
DW
DW
DW
DW
DW
DW
DW
DW
DW
DW
DW
DW
DW
DW
DW
DW
DW
DW
nd
DW
"}
(19,1,1) = {"
DW
DW
DW
DW
DW
DW
DW
DW
DW
DW
DW
DW
DW
DW
DW
DW
DW
DW
DW
DW
DW
DW
DW
DW
DW
DW
DW
DW
DW
DW
DW
DW
DW
DW
nd
DW
DW
DW
DW
DW
DW
DW
DW
DW
Lt
iY
sX
Lt
DW
DW
DW
DW
DW
DW
DW
DW
DW
DW
nd
DW
"}
(20,1,1) = {"
DW
DW
DW
DW
DW
DW
DW
DW
DW
DW
DW
DW
DW
DW
DW
DW
DW
DW
DW
DW
DW
DW
DW
DW
DW
DW
DW
DW
DW
DW
DW
DW
DW
DW
nd
DW
DW
DW
DW
DW
DW
DW
DW
DW
Lt
YK
YK
Lt
DW
DW
DW
DW
DW
DW
DW
DW
DW
DW
nd
DW
"}
(21,1,1) = {"
DW
DW
DW
DW
DW
DW
DW
DW
DW
DW
DW
DW
DW
DW
DW
DW
DW
DW
DW
DW
DW
DW
DW
DW
DW
DW
DW
DW
DW
DW
DW
DW
DW
DW
nd
DW
DW
DW
DW
DW
DW
DW
DW
DW
Lt
Qa
Qa
Lt
DW
DW
DW
DW
DW
DW
DW
DW
DW
DW
nd
DW
"}
(22,1,1) = {"
DW
DW
DW
DW
DW
DW
DW
DW
DW
DW
DW
DW
DW
DW
DW
DW
DW
DW
DW
DW
DW
DW
DW
DW
DW
DW
DW
DW
DW
DW
DW
DW
DW
DW
nd
DW
DW
DW
DW
DW
DW
DW
DW
DW
Lt
iY
iY
Lt
Lt
DW
DW
DW
DW
DW
DW
DW
DW
DW
nd
DW
"}
(23,1,1) = {"
DW
DW
DW
DW
DW
DW
DW
DW
DW
DW
DW
DW
DW
DW
DW
DW
DW
DW
DW
DW
DW
DW
DW
DW
DW
DW
DW
DW
DW
DW
DW
DW
DW
DW
nd
DW
DW
DW
DW
DW
DW
DW
DW
DW
Lt
dA
kZ
du
Lt
DW
DW
DW
DW
DW
DW
DW
DW
DW
nd
DW
"}
(24,1,1) = {"
DW
DW
DW
DW
DW
DW
DW
DW
DW
DW
DW
DW
DW
DW
DW
DW
DW
DW
DW
DW
DW
DW
DW
DW
DW
DW
DW
DW
DW
DW
DW
DW
DW
DW
nd
DW
DW
DW
DW
DW
DW
DW
DW
DW
Lt
kZ
kZ
du
Lt
DW
DW
DW
DW
DW
DW
DW
DW
DW
nd
DW
"}
(25,1,1) = {"
DW
DW
DW
DW
DW
DW
DW
DW
DW
DW
DW
DW
DW
DW
DW
DW
DW
DW
DW
DW
DW
DW
DW
DW
DW
DW
DW
DW
DW
DW
DW
DW
DW
DW
nd
DW
DW
DW
DW
DW
DW
DW
DW
DW
Lt
kZ
kZ
Lt
Lt
DW
DW
DW
DW
DW
DW
DW
DW
DW
nd
DW
"}
(26,1,1) = {"
DW
DW
DW
DW
DW
DW
DW
DW
DW
DW
DW
DW
DW
DW
DW
DW
DW
DW
DW
DW
DW
DW
DW
DW
DW
DW
DW
DW
DW
DW
DW
DW
DW
DW
nd
DW
DW
DW
DW
DW
DW
DW
DW
DW
DW
DW
DW
DW
DW
DW
DW
DW
DW
DW
DW
DW
DW
DW
nd
DW
"}
(27,1,1) = {"
DW
DW
DW
DW
DW
DW
DW
DW
DW
DW
DW
DW
DW
DW
DW
DW
DW
DW
DW
DW
DW
DW
DW
DW
DW
DW
DW
DW
DW
DW
DW
DW
DW
DW
nd
nd
nd
nd
nd
nd
nd
nd
nd
nd
nd
nd
nd
nd
nd
nd
nd
nd
nd
nd
nd
nd
nd
nd
nd
DW
"}
(28,1,1) = {"
DW
DW
DW
DW
DW
DW
DW
DW
DW
DW
DW
DW
DW
DW
DW
DW
DW
DW
DW
DW
DW
DW
DW
DW
DW
DW
DW
DW
DW
DW
DW
DW
DW
DW
DW
DW
DW
DW
DW
DW
DW
DW
DW
DW
DW
DW
DW
DW
DW
DW
DW
DW
DW
DW
DW
DW
DW
DW
DW
DW
"}
(29,1,1) = {"
DW
DW
DW
DW
DW
DW
DW
DW
nd
nd
nd
nd
nd
nd
nd
nd
nd
nd
nd
nd
nd
nd
nd
nd
nd
nd
nd
nd
nd
nd
nd
nd
nd
DW
nd
nd
nd
nd
nd
nd
nd
nd
nd
nd
nd
nd
nd
nd
nd
nd
nd
nd
nd
nd
nd
nd
nd
nd
nd
DW
"}
(30,1,1) = {"
DW
DW
DW
DW
DW
DW
DW
DW
nd
DW
DW
DW
DW
DW
DW
DW
DW
DW
DW
DW
DW
DW
DW
DW
DW
DW
DW
DW
DW
DW
DW
DW
nd
DW
nd
DW
DW
DW
DW
DW
DW
DW
DW
DW
DW
DW
DW
DW
DW
DW
DW
DW
DW
DW
DW
DW
DW
DW
nd
DW
"}
(31,1,1) = {"
DW
DW
DW
DW
DW
DW
DW
DW
nd
DW
Lt
Lt
Lt
Lt
Lt
Lt
Lt
DW
DW
DW
DW
Lt
Lt
Lt
Lt
Lt
Lt
Lt
DW
DW
DW
DW
nd
DW
nd
DW
Lt
Lt
Lt
Lt
Lt
Lt
Lt
DW
DW
DW
DW
DW
Lt
Lt
Lt
Lt
Lt
Lt
Lt
Lt
DW
DW
nd
DW
"}
(32,1,1) = {"
DW
DW
DW
DW
DW
DW
DW
DW
nd
DW
kZ
kZ
kZ
KX
iU
YK
cB
DW
DW
DW
DW
kZ
kZ
kZ
KX
iU
YK
KX
AE
DW
DW
DW
nd
DW
nd
DW
kZ
kZ
kZ
lO
zb
YK
KX
DW
DW
DW
DW
DW
kZ
kZ
kZ
pS
zb
YK
KX
YK
DW
DW
nd
DW
"}
(33,1,1) = {"
DW
DW
DW
DW
DW
DW
DW
DW
nd
DW
kZ
kZ
kZ
KX
zb
YK
KX
DW
DW
DW
DW
kZ
kZ
kZ
KX
zb
YK
KX
DW
DW
DW
DW
nd
DW
nd
DW
kZ
kZ
kZ
KX
zb
YK
cB
DW
DW
DW
DW
DW
kZ
kZ
kZ
KX
zb
YK
cB
YK
DW
DW
nd
DW
"}
(34,1,1) = {"
DW
DW
DW
DW
DW
DW
DW
DW
nd
DW
Lt
du
du
Lt
Lt
Lt
Lt
DW
DW
DW
DW
Lt
du
du
Lt
Lt
Lt
Lt
DW
DW
DW
DW
nd
DW
nd
DW
Lt
du
du
Lt
Lt
Lt
Lt
DW
DW
DW
DW
DW
Lt
du
du
Lt
Lt
Lt
Lt
Lt
DW
DW
nd
DW
"}
(35,1,1) = {"
DW
DW
DW
DW
DW
DW
DW
DW
nd
DW
Lt
Lt
Lt
Lt
DW
DW
DW
DW
DW
DW
DW
Lt
Lt
Lt
Lt
DW
DW
DW
DW
DW
DW
DW
nd
DW
nd
DW
Lt
Lt
Lt
Lt
DW
DW
DW
DW
DW
DW
DW
DW
Lt
Lt
Lt
Lt
DW
DW
DW
DW
DW
DW
nd
DW
"}
(36,1,1) = {"
DW
DW
DW
DW
DW
DW
DW
DW
nd
DW
DW
DW
DW
DW
DW
DW
DW
DW
DW
DW
DW
DW
DW
DW
DW
DW
DW
DW
DW
DW
DW
DW
nd
DW
nd
DW
DW
DW
DW
DW
DW
DW
DW
DW
DW
DW
DW
DW
DW
DW
DW
DW
DW
DW
DW
DW
DW
DW
nd
DW
"}
(37,1,1) = {"
DW
DW
DW
DW
DW
DW
DW
DW
nd
DW
DW
DW
DW
DW
DW
DW
DW
DW
DW
DW
DW
DW
DW
DW
DW
DW
DW
DW
DW
DW
DW
DW
nd
DW
nd
DW
Lt
Lt
Lt
Lt
Lt
Lt
Lt
Lt
DW
DW
DW
DW
Lt
Lt
Lt
Lt
Lt
Lt
Lt
Lt
DW
DW
nd
DW
"}
(38,1,1) = {"
DW
DW
DW
DW
DW
DW
DW
DW
nd
DW
Lt
Lt
Lt
Lt
Lt
Lt
Lt
DW
DW
DW
DW
Lt
Lt
Lt
Lt
Lt
Lt
Lt
DW
DW
DW
DW
nd
DW
nd
DW
kZ
kZ
kZ
Zz
zb
YK
KX
YK
DW
DW
DW
DW
kZ
kZ
kZ
pS
zb
YK
KX
YK
DW
DW
nd
DW
"}
(39,1,1) = {"
DW
DW
DW
DW
DW
DW
DW
DW
nd
DW
kZ
kZ
kZ
KX
iU
YK
Nh
DW
DW
DW
DW
kZ
kZ
kZ
KX
iU
YK
KX
DW
DW
DW
DW
nd
DW
nd
DW
kZ
kZ
kZ
KX
zb
YK
KX
MH
DW
DW
DW
DW
kZ
kZ
kZ
KX
zb
YK
KX
MH
DW
DW
nd
DW
"}
(40,1,1) = {"
DW
DW
DW
DW
DW
DW
DW
DW
nd
DW
kZ
kZ
kZ
KX
zb
YK
KX
DW
DW
DW
DW
kZ
kZ
kZ
KX
zb
YK
KX
fG
DW
DW
DW
nd
DW
nd
DW
Lt
du
du
Lt
Lt
Lt
Lt
Lt
DW
DW
DW
DW
Lt
du
du
Lt
Lt
Lt
Lt
YK
DW
DW
nd
DW
"}
(41,1,1) = {"
DW
DW
DW
DW
DW
DW
DW
DW
nd
DW
Lt
du
du
Lt
Lt
Lt
Lt
DW
DW
DW
DW
Lt
du
du
Lt
Lt
Lt
Lt
DW
DW
DW
DW
nd
DW
nd
DW
Lt
Lt
Lt
Lt
DW
DW
DW
DW
DW
DW
DW
DW
Lt
Lt
Lt
Lt
YK
YK
YK
YK
DW
DW
nd
DW
"}
(42,1,1) = {"
DW
DW
DW
DW
DW
DW
DW
DW
nd
DW
Lt
Lt
Lt
Lt
DW
DW
DW
DW
DW
DW
DW
Lt
Lt
Lt
Lt
DW
DW
DW
DW
DW
DW
DW
nd
DW
nd
DW
DW
DW
DW
DW
DW
DW
DW
DW
DW
DW
DW
DW
DW
DW
DW
DW
DW
DW
DW
DW
DW
DW
nd
DW
"}
(43,1,1) = {"
DW
DW
DW
DW
DW
DW
DW
DW
nd
DW
DW
DW
DW
DW
DW
DW
DW
DW
DW
DW
DW
DW
DW
DW
DW
DW
DW
DW
DW
DW
DW
DW
nd
DW
nd
DW
Lt
Lt
Lt
Lt
Lt
Lt
Lt
Lt
Lt
DW
DW
DW
Lt
Lt
Lt
Lt
Lt
Lt
Lt
YK
DW
DW
nd
DW
"}
(44,1,1) = {"
DW
DW
DW
DW
DW
DW
DW
DW
nd
nd
nd
nd
nd
nd
nd
nd
nd
nd
nd
nd
nd
nd
nd
nd
nd
nd
nd
nd
nd
nd
nd
nd
nd
DW
nd
DW
kZ
kZ
kZ
pS
zb
YK
KX
YK
YK
DW
DW
DW
kZ
kZ
kZ
pS
zb
YK
KX
YK
DW
DW
nd
DW
"}
(45,1,1) = {"
DW
DW
DW
DW
DW
DW
DW
DW
DW
DW
DW
DW
DW
DW
DW
DW
DW
DW
DW
DW
DW
DW
DW
DW
DW
DW
DW
DW
DW
DW
DW
DW
DW
DW
nd
DW
kZ
kZ
kZ
KX
zb
YK
KX
YK
MH
DW
DW
DW
kZ
kZ
kZ
KX
zb
YK
KX
MH
DW
DW
nd
DW
"}
(46,1,1) = {"
DW
DW
DW
DW
DW
DW
DW
DW
nd
nd
nd
nd
nd
nd
nd
nd
nd
nd
nd
nd
nd
nd
nd
nd
nd
nd
nd
nd
nd
nd
nd
nd
nd
DW
nd
DW
Lt
du
du
Lt
Lt
Lt
Lt
Lt
Lt
DW
DW
DW
Lt
du
du
Lt
Lt
Lt
Lt
YK
DW
DW
nd
DW
"}
(47,1,1) = {"
DW
DW
DW
DW
DW
DW
DW
DW
nd
DW
DW
DW
DW
DW
DW
DW
DW
DW
DW
DW
DW
DW
DW
DW
DW
DW
DW
DW
DW
DW
DW
DW
nd
DW
nd
DW
Lt
Lt
Lt
Lt
DW
DW
DW
DW
DW
DW
DW
DW
Lt
Lt
Lt
Lt
YK
YK
YK
YK
DW
DW
nd
DW
"}
(48,1,1) = {"
DW
DW
DW
DW
DW
DW
DW
DW
nd
DW
Lt
Lt
Lt
Lt
Lt
Lt
Lt
DW
DW
DW
DW
DW
DW
DW
DW
DW
DW
DW
DW
DW
DW
DW
nd
DW
nd
DW
DW
DW
DW
DW
DW
DW
DW
DW
DW
DW
DW
DW
DW
DW
DW
DW
DW
DW
DW
DW
DW
DW
nd
DW
"}
(49,1,1) = {"
DW
DW
DW
DW
DW
DW
DW
DW
nd
DW
kZ
kZ
kZ
KX
AS
YK
KX
DW
DW
DW
DW
Lt
Lt
Lt
Lt
ly
Lt
Lt
DW
DW
DW
DW
nd
DW
nd
nd
nd
nd
nd
nd
nd
nd
nd
nd
nd
nd
nd
nd
nd
nd
nd
nd
nd
nd
nd
nd
nd
nd
nd
DW
"}
(50,1,1) = {"
DW
DW
DW
DW
DW
DW
DW
DW
nd
DW
kZ
kZ
kZ
KX
zb
YK
cB
DW
DW
DW
DW
kZ
kZ
kZ
KX
zb
YK
cB
DW
DW
DW
DW
nd
DW
DW
DW
DW
DW
DW
DW
DW
DW
DW
DW
DW
DW
DW
DW
DW
DW
DW
DW
DW
DW
DW
DW
DW
DW
DW
DW
"}
(51,1,1) = {"
DW
DW
DW
DW
DW
DW
DW
DW
nd
DW
kZ
kZ
kZ
KX
zb
YK
KX
DW
DW
DW
DW
Lt
du
du
Lt
Lt
Lt
Lt
DW
DW
DW
DW
nd
DW
nd
nd
nd
nd
nd
nd
nd
nd
nd
nd
nd
nd
nd
nd
nd
nd
nd
nd
nd
nd
nd
nd
nd
nd
nd
DW
"}
(52,1,1) = {"
DW
DW
DW
DW
DW
DW
DW
DW
nd
DW
Lt
du
du
Lt
Lt
Lt
Lt
DW
DW
DW
DW
Lt
Lt
Lt
Lt
DW
DW
DW
DW
DW
DW
DW
nd
DW
nd
DW
DW
DW
DW
DW
DW
DW
DW
DW
DW
DW
DW
DW
DW
DW
DW
DW
DW
DW
DW
DW
DW
DW
nd
DW
"}
(53,1,1) = {"
DW
DW
DW
DW
DW
DW
DW
DW
nd
DW
Lt
Lt
Lt
Lt
DW
DW
DW
DW
DW
DW
DW
DW
DW
DW
DW
DW
DW
DW
DW
DW
DW
DW
nd
DW
nd
DW
Lt
Lt
Lt
Lt
DW
DW
DW
DW
DW
DW
DW
DW
Lt
Lt
Lt
Lt
Lt
Lt
DW
DW
DW
DW
nd
DW
"}
(54,1,1) = {"
DW
DW
DW
DW
DW
DW
DW
DW
nd
DW
DW
DW
DW
DW
DW
DW
DW
DW
DW
DW
DW
DW
DW
DW
DW
DW
DW
DW
DW
DW
DW
DW
nd
DW
nd
DW
Lt
Lt
Lt
Lt
DW
DW
DW
DW
DW
DW
DW
DW
Lt
Lt
Lt
Lt
Lt
Lt
DW
DW
DW
DW
nd
DW
"}
(55,1,1) = {"
DW
DW
DW
DW
DW
DW
DW
DW
nd
DW
Lt
Lt
Lt
Lt
Lt
Lt
Lt
DW
DW
DW
DW
Lt
Lt
Lt
Lt
Lt
Lt
Lt
DW
DW
DW
DW
nd
DW
nd
DW
Lt
Lt
Lt
Lt
DW
DW
DW
DW
DW
DW
DW
DW
Lt
Lt
Lt
Lt
Lt
Lt
DW
DW
DW
DW
nd
DW
"}
(56,1,1) = {"
DW
DW
DW
DW
DW
DW
DW
DW
nd
DW
kZ
kZ
kZ
KX
zb
YK
KX
DW
DW
DW
DW
kZ
kZ
kZ
KX
zb
YK
KX
DW
DW
DW
DW
nd
DW
nd
DW
Lt
Lt
Lt
Lt
DW
DW
DW
DW
DW
DW
DW
DW
Lt
Lt
Lt
Lt
Lt
Lt
DW
DW
DW
DW
nd
DW
"}
(57,1,1) = {"
DW
DW
DW
DW
DW
DW
DW
DW
nd
DW
kZ
kZ
kZ
KX
KT
YK
KX
DW
DW
DW
DW
kZ
kZ
kZ
KX
iU
YK
KX
DW
DW
DW
DW
nd
DW
nd
DW
Lt
Lt
Lt
Lt
Lt
Lt
Lt
DW
DW
DW
DW
DW
Lt
Lt
Lt
Lt
Lt
Lt
Lt
DW
DW
DW
nd
DW
"}
(58,1,1) = {"
DW
DW
DW
DW
DW
DW
DW
DW
nd
DW
kZ
kZ
kZ
KX
zb
YK
cB
DW
DW
DW
DW
kZ
kZ
kZ
KX
zb
YK
cB
DW
DW
DW
DW
nd
DW
nd
DW
kZ
kZ
kZ
KX
AS
YK
KX
DW
DW
DW
DW
DW
kZ
kZ
kZ
KX
AS
YK
KX
DW
DW
DW
nd
DW
"}
(59,1,1) = {"
DW
DW
DW
DW
DW
DW
DW
DW
nd
DW
kZ
kZ
kZ
KX
zb
YK
KX
DW
DW
DW
DW
kZ
kZ
kZ
KX
zb
YK
KX
DW
DW
DW
DW
nd
DW
nd
DW
kZ
kZ
kZ
KX
zb
YK
cB
DW
DW
DW
DW
DW
kZ
kZ
kZ
KX
zb
YK
cB
DW
DW
DW
nd
DW
"}
(60,1,1) = {"
DW
DW
DW
DW
DW
DW
DW
DW
nd
DW
Lt
du
du
Lt
Lt
Lt
Lt
DW
DW
DW
DW
kZ
kZ
kZ
KX
zb
YK
KX
DW
DW
DW
DW
nd
DW
nd
DW
Lt
du
du
Lt
Lt
Lt
Lt
DW
DW
DW
DW
DW
Lt
du
du
Lt
Lt
Lt
Lt
DW
DW
DW
nd
DW
"}
(61,1,1) = {"
DW
DW
DW
DW
DW
DW
DW
DW
nd
DW
Lt
Lt
Lt
Lt
DW
DW
DW
DW
DW
DW
DW
Lt
du
du
Lt
Lt
Lt
Lt
DW
DW
DW
DW
nd
DW
nd
DW
Lt
Lt
Lt
Lt
DW
DW
DW
DW
DW
DW
DW
DW
Lt
Lt
Lt
Lt
Lt
Lt
DW
DW
DW
DW
nd
DW
"}
(62,1,1) = {"
DW
DW
DW
DW
DW
DW
DW
DW
nd
DW
DW
DW
DW
DW
DW
DW
DW
DW
DW
DW
DW
Lt
Lt
Lt
Lt
DW
DW
DW
DW
DW
DW
DW
nd
DW
nd
DW
Lt
Lt
Lt
Lt
DW
DW
DW
DW
DW
DW
DW
DW
Lt
Lt
Lt
Lt
Lt
Lt
DW
DW
DW
DW
nd
DW
"}
(63,1,1) = {"
DW
DW
DW
DW
DW
DW
DW
DW
nd
DW
Lt
Lt
Lt
Lt
Lt
Lt
Lt
DW
DW
DW
DW
DW
DW
DW
DW
DW
DW
DW
DW
DW
DW
DW
nd
DW
nd
DW
Lt
Lt
Lt
Lt
DW
DW
DW
DW
DW
DW
DW
DW
Lt
Lt
Lt
Lt
Lt
Lt
DW
DW
DW
DW
nd
DW
"}
(64,1,1) = {"
DW
DW
DW
DW
DW
DW
DW
DW
nd
DW
kZ
kZ
kZ
KX
zb
YK
KX
DW
DW
DW
DW
Lt
Lt
Lt
Lt
Lt
Lt
Lt
DW
DW
DW
DW
nd
DW
nd
DW
Lt
Lt
Lt
Lt
DW
DW
DW
DW
DW
DW
DW
DW
Lt
Lt
Lt
Lt
Lt
Lt
DW
DW
DW
DW
nd
DW
"}
(65,1,1) = {"
DW
DW
DW
DW
DW
DW
DW
DW
nd
DW
kZ
kZ
kZ
KX
zb
YK
KX
DW
DW
DW
DW
kZ
kZ
kZ
KX
zb
YK
KX
DW
DW
DW
DW
nd
DW
nd
DW
DW
DW
DW
DW
DW
DW
DW
DW
DW
DW
DW
DW
DW
DW
DW
DW
DW
DW
DW
DW
DW
DW
nd
DW
"}
(66,1,1) = {"
DW
DW
DW
DW
DW
DW
DW
DW
nd
DW
kZ
kZ
kZ
KX
Cz
YK
KX
DW
DW
DW
DW
kZ
kZ
kZ
KX
zb
YK
KX
DW
DW
DW
DW
nd
DW
nd
DW
Lt
Lt
Lt
Lt
Lt
Lt
Lt
DW
DW
DW
DW
DW
Lt
Lt
Lt
Lt
Lt
Lt
Lt
Lt
DW
DW
nd
DW
"}
(67,1,1) = {"
DW
DW
DW
DW
DW
DW
DW
DW
nd
DW
kZ
kZ
kZ
KX
zb
YK
cB
DW
DW
DW
DW
kZ
kZ
kZ
KX
iU
YK
KX
DW
DW
DW
DW
nd
DW
nd
DW
Lt
Lt
Lt
Lt
Lt
Lt
Lt
DW
DW
DW
DW
DW
Lt
Lt
Lt
Lt
Lt
Lt
Lt
Lt
DW
DW
nd
DW
"}
(68,1,1) = {"
DW
DW
DW
DW
DW
DW
DW
DW
nd
DW
kZ
kZ
kZ
KX
zb
YK
KX
DW
DW
DW
DW
kZ
kZ
kZ
KX
zb
YK
cB
DW
DW
DW
DW
nd
DW
nd
DW
Lt
Lt
Lt
Lt
Lt
Lt
Lt
DW
DW
DW
DW
DW
Lt
Lt
Lt
Lt
Lt
Lt
Lt
Lt
DW
DW
nd
DW
"}
(69,1,1) = {"
DW
DW
DW
DW
DW
DW
DW
DW
nd
DW
kZ
kZ
kZ
KX
zb
YK
KX
DW
DW
DW
DW
kZ
kZ
kZ
KX
zb
YK
KX
DW
DW
DW
DW
nd
DW
nd
DW
Lt
Lt
Lt
Lt
Lt
Lt
Lt
DW
DW
DW
DW
DW
Lt
Lt
Lt
Lt
Lt
Lt
Lt
DW
DW
DW
nd
DW
"}
(70,1,1) = {"
DW
DW
DW
DW
DW
DW
DW
DW
nd
DW
kZ
kZ
kZ
KX
zb
YK
KX
DW
DW
DW
DW
kZ
kZ
kZ
KX
zb
YK
KX
DW
DW
DW
DW
nd
DW
nd
DW
Lt
Lt
Lt
Lt
Lt
Lt
Lt
DW
DW
DW
DW
DW
Lt
Lt
Lt
Lt
Lt
Lt
Lt
DW
DW
DW
nd
DW
"}
(71,1,1) = {"
DW
DW
DW
DW
DW
DW
DW
DW
nd
DW
Lt
du
du
Lt
Lt
Lt
Lt
DW
DW
DW
DW
Lt
du
du
Lt
Lt
Lt
Lt
DW
DW
DW
DW
nd
DW
nd
DW
kZ
kZ
kZ
KX
KT
YK
KX
DW
DW
DW
DW
DW
kZ
kZ
kZ
KX
Cz
YK
KX
DW
DW
DW
nd
DW
"}
(72,1,1) = {"
DW
DW
DW
DW
DW
DW
DW
DW
nd
DW
Lt
Lt
Lt
Lt
DW
DW
DW
DW
DW
DW
DW
Lt
Lt
Lt
Lt
DW
DW
DW
DW
DW
DW
DW
nd
DW
nd
DW
kZ
kZ
kZ
KX
zb
YK
cB
DW
DW
DW
DW
DW
kZ
kZ
kZ
KX
zb
YK
cB
DW
DW
DW
nd
DW
"}
(73,1,1) = {"
DW
DW
DW
DW
DW
DW
DW
DW
nd
DW
DW
DW
DW
DW
DW
DW
DW
DW
DW
DW
DW
DW
DW
DW
DW
DW
DW
DW
DW
DW
DW
DW
nd
DW
nd
DW
Lt
du
du
Lt
Lt
Lt
Lt
DW
DW
DW
DW
DW
Lt
du
du
Lt
Lt
Lt
Lt
DW
DW
DW
nd
DW
"}
(74,1,1) = {"
DW
DW
DW
DW
DW
DW
DW
DW
nd
nd
nd
nd
nd
nd
nd
nd
nd
nd
nd
nd
nd
nd
nd
nd
nd
nd
nd
nd
nd
nd
nd
nd
nd
DW
nd
DW
Lt
Lt
Lt
Lt
Lt
Lt
Lt
DW
DW
DW
DW
DW
Lt
Lt
Lt
Lt
Lt
Lt
Lt
DW
DW
DW
nd
DW
"}
(75,1,1) = {"
DW
DW
DW
DW
DW
DW
DW
DW
DW
DW
DW
DW
DW
DW
DW
DW
DW
DW
DW
DW
DW
DW
DW
DW
DW
DW
DW
DW
DW
DW
DW
DW
DW
DW
nd
DW
Lt
Lt
Lt
Lt
Lt
Lt
Lt
DW
DW
DW
DW
DW
Lt
Lt
Lt
Lt
Lt
Lt
Lt
Lt
DW
DW
nd
DW
"}
(76,1,1) = {"
DW
DW
DW
DW
DW
DW
DW
DW
DW
DW
DW
DW
DW
DW
DW
DW
DW
DW
DW
DW
DW
DW
DW
DW
DW
DW
DW
DW
DW
DW
DW
DW
DW
DW
nd
DW
Lt
Lt
Lt
Lt
Lt
Lt
Lt
DW
DW
DW
DW
DW
Lt
Lt
Lt
Lt
Lt
Lt
Lt
Lt
DW
DW
nd
DW
"}
(77,1,1) = {"
DW
DW
DW
DW
DW
DW
DW
DW
DW
DW
DW
DW
DW
DW
DW
DW
DW
DW
DW
DW
DW
DW
DW
DW
DW
DW
DW
DW
DW
DW
DW
DW
DW
DW
nd
DW
Lt
Lt
Lt
Lt
Lt
Lt
Lt
DW
DW
DW
DW
DW
Lt
Lt
Lt
Lt
Lt
Lt
Lt
Lt
DW
DW
nd
DW
"}
(78,1,1) = {"
DW
DW
DW
DW
DW
DW
DW
DW
DW
DW
DW
DW
DW
DW
DW
DW
DW
DW
DW
DW
DW
DW
DW
DW
DW
DW
DW
DW
DW
DW
DW
DW
DW
DW
nd
DW
DW
DW
DW
DW
DW
DW
DW
DW
DW
DW
DW
DW
DW
DW
DW
DW
DW
DW
DW
DW
DW
DW
nd
DW
"}
(79,1,1) = {"
DW
DW
DW
DW
DW
DW
DW
DW
DW
DW
DW
DW
DW
DW
DW
DW
DW
DW
DW
DW
DW
DW
DW
DW
DW
DW
DW
DW
DW
DW
DW
DW
DW
DW
nd
nd
nd
nd
nd
nd
nd
nd
nd
nd
nd
nd
nd
nd
nd
nd
nd
nd
nd
nd
nd
nd
nd
nd
nd
DW
"}
(80,1,1) = {"
DW
DW
DW
DW
DW
DW
DW
DW
DW
DW
DW
DW
DW
DW
DW
DW
DW
DW
DW
DW
DW
DW
DW
DW
DW
DW
DW
DW
DW
DW
DW
DW
DW
DW
DW
DW
DW
DW
DW
DW
DW
DW
DW
DW
DW
DW
DW
DW
DW
DW
DW
DW
DW
DW
DW
DW
DW
DW
DW
DW
"}
(81,1,1) = {"
DW
DW
DW
DW
DW
DW
DW
DW
DW
DW
DW
DW
DW
DW
DW
DW
DW
DW
DW
DW
DW
DW
DW
DW
DW
DW
DW
DW
DW
DW
DW
DW
DW
DW
DW
DW
DW
DW
DW
DW
DW
DW
DW
DW
DW
DW
DW
DW
DW
DW
DW
DW
DW
DW
DW
DW
DW
DW
DW
DW
"}
(82,1,1) = {"
DW
DW
DW
DW
DW
DW
DW
DW
DW
DW
DW
DW
DW
DW
DW
DW
DW
DW
DW
DW
DW
DW
DW
DW
DW
DW
DW
DW
DW
DW
DW
DW
DW
DW
DW
DW
DW
DW
DW
DW
DW
DW
DW
DW
DW
DW
DW
DW
DW
DW
DW
DW
DW
DW
DW
DW
DW
DW
DW
DW
"}
(83,1,1) = {"
DW
DW
DW
DW
DW
DW
DW
DW
DW
DW
DW
DW
DW
DW
DW
DW
DW
DW
DW
DW
DW
DW
DW
DW
DW
DW
DW
DW
DW
DW
DW
DW
DW
DW
DW
DW
DW
DW
DW
DW
DW
DW
DW
DW
DW
DW
DW
DW
DW
DW
DW
DW
DW
DW
DW
DW
DW
DW
DW
DW
"}
(84,1,1) = {"
DW
DW
DW
DW
DW
DW
DW
DW
DW
DW
DW
DW
DW
DW
DW
DW
DW
DW
DW
DW
DW
DW
DW
DW
DW
DW
DW
DW
DW
DW
DW
DW
DW
DW
DW
DW
DW
DW
DW
DW
DW
DW
DW
DW
DW
DW
DW
DW
DW
DW
DW
DW
DW
DW
DW
DW
DW
DW
DW
DW
"}
(85,1,1) = {"
DW
DW
DW
DW
DW
DW
DW
DW
DW
DW
DW
DW
DW
DW
DW
DW
DW
DW
DW
DW
DW
DW
DW
DW
DW
DW
DW
DW
DW
DW
DW
DW
DW
DW
DW
DW
DW
DW
DW
DW
DW
DW
DW
DW
DW
DW
DW
DW
DW
DW
DW
DW
DW
DW
DW
DW
DW
DW
DW
DW
"}
(86,1,1) = {"
DW
DW
DW
DW
DW
DW
DW
DW
DW
DW
DW
DW
DW
DW
DW
DW
DW
DW
DW
DW
DW
DW
DW
DW
DW
DW
DW
DW
DW
DW
DW
DW
DW
DW
DW
DW
DW
DW
DW
DW
DW
DW
DW
DW
DW
DW
DW
DW
DW
DW
DW
DW
DW
DW
DW
DW
DW
DW
DW
DW
"}
(87,1,1) = {"
DW
DW
DW
DW
DW
DW
DW
DW
DW
DW
DW
DW
DW
DW
DW
DW
DW
DW
DW
DW
DW
DW
DW
DW
DW
DW
DW
DW
DW
DW
DW
DW
DW
DW
DW
DW
DW
DW
DW
DW
DW
DW
DW
DW
DW
DW
DW
DW
DW
DW
DW
DW
DW
DW
DW
DW
DW
DW
DW
DW
"}
(88,1,1) = {"
DW
DW
DW
DW
DW
DW
DW
DW
DW
DW
DW
DW
DW
DW
DW
DW
DW
DW
DW
DW
DW
DW
DW
DW
DW
DW
DW
DW
DW
DW
DW
DW
DW
DW
DW
DW
DW
DW
DW
DW
DW
DW
DW
DW
DW
DW
DW
DW
DW
DW
DW
DW
DW
DW
DW
DW
DW
DW
DW
DW
"}
(89,1,1) = {"
DW
DW
DW
DW
DW
DW
DW
DW
DW
DW
DW
DW
DW
DW
DW
DW
DW
DW
DW
DW
DW
DW
DW
DW
DW
DW
DW
DW
DW
DW
DW
DW
DW
DW
DW
DW
DW
DW
DW
DW
DW
DW
DW
DW
DW
DW
DW
DW
DW
DW
DW
DW
DW
DW
DW
DW
DW
DW
DW
DW
"}
(90,1,1) = {"
DW
DW
DW
DW
DW
DW
DW
DW
DW
DW
DW
DW
DW
DW
DW
DW
DW
DW
DW
DW
DW
DW
DW
DW
DW
DW
DW
DW
DW
DW
DW
DW
DW
DW
DW
DW
DW
DW
DW
DW
DW
DW
DW
DW
DW
DW
DW
DW
DW
DW
DW
DW
DW
DW
DW
DW
DW
DW
DW
DW
"}
(91,1,1) = {"
DW
DW
DW
DW
DW
DW
DW
DW
DW
DW
DW
DW
DW
DW
DW
DW
DW
DW
DW
DW
DW
DW
DW
DW
DW
DW
DW
DW
DW
DW
DW
DW
DW
DW
DW
DW
DW
DW
DW
DW
DW
DW
DW
DW
DW
DW
DW
DW
DW
DW
DW
DW
DW
DW
DW
DW
DW
DW
DW
DW
"}
(92,1,1) = {"
DW
DW
DW
DW
DW
DW
DW
DW
DW
DW
DW
DW
DW
DW
DW
DW
DW
DW
DW
DW
DW
DW
DW
DW
DW
DW
DW
DW
DW
DW
DW
DW
DW
DW
DW
DW
DW
DW
DW
DW
DW
DW
DW
DW
DW
DW
DW
DW
DW
DW
DW
DW
DW
DW
DW
DW
DW
DW
DW
DW
"}
(93,1,1) = {"
DW
DW
DW
DW
DW
DW
DW
DW
DW
DW
DW
DW
DW
DW
DW
DW
DW
DW
DW
DW
DW
DW
DW
DW
DW
DW
DW
DW
DW
DW
DW
DW
DW
DW
DW
DW
DW
DW
DW
DW
DW
DW
DW
DW
DW
DW
DW
DW
DW
DW
DW
DW
DW
DW
DW
DW
DW
DW
DW
DW
"}
(94,1,1) = {"
DW
DW
DW
DW
DW
DW
DW
DW
DW
DW
DW
DW
DW
DW
DW
DW
DW
DW
DW
DW
DW
DW
DW
DW
DW
DW
DW
DW
DW
DW
DW
DW
DW
DW
DW
DW
DW
DW
DW
DW
DW
DW
DW
DW
DW
DW
DW
DW
DW
DW
DW
DW
DW
DW
DW
DW
DW
DW
DW
DW
"}
(95,1,1) = {"
DW
DW
DW
DW
DW
DW
DW
DW
DW
DW
DW
DW
DW
DW
DW
DW
DW
DW
DW
DW
DW
DW
DW
DW
DW
DW
DW
DW
DW
DW
DW
DW
DW
DW
DW
DW
DW
DW
DW
DW
DW
DW
DW
DW
DW
DW
DW
DW
DW
DW
DW
DW
DW
DW
DW
DW
DW
DW
DW
DW
"}
(96,1,1) = {"
DW
DW
DW
DW
DW
DW
DW
DW
DW
DW
DW
DW
DW
DW
DW
DW
DW
DW
DW
DW
DW
DW
DW
DW
DW
DW
DW
DW
DW
DW
DW
DW
DW
DW
DW
DW
DW
DW
DW
DW
DW
DW
DW
DW
DW
DW
DW
DW
DW
DW
DW
DW
DW
DW
DW
DW
DW
DW
DW
DW
"}
(97,1,1) = {"
DW
DW
DW
DW
DW
DW
DW
DW
DW
DW
DW
DW
DW
DW
DW
DW
DW
DW
DW
DW
DW
DW
DW
DW
DW
DW
DW
DW
DW
DW
DW
DW
DW
DW
DW
DW
DW
DW
DW
DW
DW
DW
DW
DW
DW
DW
DW
DW
DW
DW
DW
DW
DW
DW
DW
DW
DW
DW
DW
DW
"}
(98,1,1) = {"
DW
DW
DW
DW
DW
DW
DW
DW
DW
DW
DW
DW
DW
DW
DW
DW
DW
DW
DW
DW
DW
DW
DW
DW
DW
DW
DW
DW
DW
DW
DW
DW
DW
DW
DW
DW
DW
DW
DW
DW
DW
DW
DW
DW
DW
DW
DW
DW
DW
DW
DW
DW
DW
DW
DW
DW
DW
DW
DW
DW
"}
(99,1,1) = {"
DW
DW
DW
DW
DW
DW
DW
DW
DW
DW
DW
DW
DW
DW
DW
DW
DW
DW
DW
DW
DW
DW
DW
DW
DW
DW
DW
DW
DW
DW
DW
DW
DW
DW
DW
DW
DW
DW
DW
DW
DW
DW
DW
DW
DW
DW
DW
DW
DW
DW
DW
DW
DW
DW
DW
DW
DW
DW
DW
DW
"}
(100,1,1) = {"
DW
DW
DW
DW
DW
DW
DW
DW
DW
DW
DW
DW
DW
DW
DW
DW
DW
DW
DW
DW
DW
DW
DW
DW
DW
DW
DW
DW
DW
DW
DW
DW
DW
DW
DW
DW
DW
DW
DW
DW
DW
DW
DW
DW
DW
DW
DW
DW
DW
DW
DW
DW
DW
DW
DW
DW
DW
DW
DW
DW
"}
