//MAP CONVERTED BY dmm2tgm.py THIS HEADER COMMENT PREVENTS RECONVERSION, DO NOT REMOVE
"f" = (
/obj/structure/flora/ausbushes/reedbush,
/turf/simulated/floor/exoplanet/desert,
/area/template_noop)
"u" = (
/turf/simulated/floor/exoplanet/water/shallow,
/area/template_noop)
"C" = (
/obj/structure/flora/ausbushes/grassybush,
/turf/simulated/floor/exoplanet/desert,
/area/template_noop)
"O" = (
/turf/simulated/floor/exoplanet/desert,
/area/template_noop)

(1,1,1) = {"
O
O
O
O
O
O
O
"}
(2,1,1) = {"
O
O
f
u
u
u
O
"}
(3,1,1) = {"
O
O
u
u
u
C
O
"}
(4,1,1) = {"
O
C
u
u
u
O
O
"}
(5,1,1) = {"
O
u
u
u
u
O
O
"}
(6,1,1) = {"
O
u
u
u
f
O
O
"}
(7,1,1) = {"
O
O
O
O
O
O
O
"}
