//MAP CONVERTED BY dmm2tgm.py THIS HEADER COMMENT PREVENTS RECONVERSION, DO NOT REMOVE
"aW" = (
/obj/item/device/flashlight/flare/torch,
/turf/simulated/wall/wood,
/area/exoplanet/grass/grove)
"dw" = (
/obj/effect/spider/stickyweb,
/turf/simulated/floor/exoplanet/grass/grovedirt,
/area/exoplanet/grass/grove)
"dM" = (
/mob/living/simple_animal/hostile/giant_spider,
/turf/simulated/floor/exoplanet/grass/grovedirt,
/area/exoplanet/grass/grove)
"em" = (
/obj/structure/flora/tree/jungle,
/turf/simulated/floor/exoplanet/grass/grove,
/area/exoplanet/grass/grove)
"eW" = (
/obj/structure/barricade/wooden,
/turf/simulated/floor/exoplanet/grass/grovedirt,
/area/exoplanet/grass/grove)
"fr" = (
/obj/structure/table/stone,
/obj/item/material/knife/trench,
/obj/item/storage/box/fancy/mre/menu10,
/turf/simulated/floor/exoplanet/grass/grovedirt,
/area/exoplanet/grass/grove)
"fy" = (
/turf/simulated/wall/wood,
/area/exoplanet/grass/grove)
"gj" = (
/mob/living/simple_animal/hostile/giant_spider/emp,
/turf/simulated/floor/exoplanet/grass/grovegravel,
/area/exoplanet/grass/grove)
"gn" = (
/obj/structure/flora/tree/grove{
	icon_state = "grove_tree6"
	},
/turf/simulated/floor/exoplanet/grass/grove,
/area/exoplanet/grass/grove)
"hi" = (
/mob/living/simple_animal/hostile/giant_spider/hunter,
/turf/simulated/floor/exoplanet/grass/grovedirt,
/area/exoplanet/grass/grove)
"jL" = (
/obj/structure/flora/rock/pile,
/turf/simulated/floor/exoplanet/grass/grovegravel,
/area/exoplanet/grass/grove)
"kn" = (
/obj/item/trash/mollusc_shell/clam,
/obj/item/cell/device/emergency_light/empty,
/turf/simulated/floor/exoplanet/grass/grovegravel,
/area/exoplanet/grass/grove)
"kA" = (
/obj/structure/boulder,
/turf/simulated/floor/exoplanet/grass/grovedirt,
/area/exoplanet/grass/grove)
"lg" = (
/obj/structure/trash_pile,
/turf/simulated/floor/exoplanet/grass/grovedirt,
/area/exoplanet/grass/grove)
"oB" = (
/obj/structure/boulder,
/turf/simulated/floor/exoplanet/grass/grovegravel,
/area/exoplanet/grass/grove)
"qh" = (
/obj/effect/decal/cleanable/cobweb2,
/turf/simulated/floor/exoplanet/grass/grovedirt,
/area/exoplanet/grass/grove)
"qk" = (
/obj/item/device/electronic_assembly/medium/radio,
/turf/simulated/mineral/random/exoplanet,
/area/exoplanet/grass/grove)
"qW" = (
/mob/living/simple_animal/hostile/giant_spider/emp,
/obj/effect/decal/cleanable/cobweb2,
/turf/simulated/floor/exoplanet/grass/grovedirt,
/area/exoplanet/grass/grove)
"rb" = (
/obj/item/device/flashlight/flare/torch,
/turf/simulated/floor/exoplanet/grass/grovedirt,
/area/exoplanet/grass/grove)
"rm" = (
/obj/structure/boulder,
/turf/simulated/mineral/random/exoplanet,
/area/exoplanet/grass/grove)
"rt" = (
/obj/structure/flora/tree/grove{
	icon_state = "grove_tree3"
	},
/turf/simulated/floor/exoplanet/grass/grove,
/area/exoplanet/grass/grove)
"sq" = (
/obj/item/trash/mollusc_shell,
/turf/simulated/floor/exoplanet/water/shallow,
/area/exoplanet/grass/grove)
"tx" = (
/obj/structure/trash_pile,
/obj/item/gun/launcher/crossbow/RFD,
/turf/simulated/floor/exoplanet/grass/grovedirt,
/area/exoplanet/grass/grove)
"tO" = (
/obj/effect/spider/stickyweb,
/turf/simulated/floor/exoplanet/water/shallow,
/area/exoplanet/grass/grove)
"us" = (
/obj/structure/barricade/wooden{
	dir = 4
	},
/turf/simulated/floor/exoplanet/grass/grovedirt,
/area/exoplanet/grass/grove)
"uH" = (
/obj/item/device/assembly/mousetrap/armed,
/turf/simulated/floor/exoplanet/grass/grovedirt,
/area/exoplanet/grass/grove)
"yh" = (
/obj/structure/flora/ausbushes/stalkybush,
/turf/simulated/floor/exoplanet/water/shallow,
/area/exoplanet/grass/grove)
"yx" = (
/turf/simulated/floor/exoplanet/grass/grovedirt,
/area/exoplanet/grass/grove)
"yD" = (
/obj/item/stack/material/wood/full,
/turf/simulated/floor/exoplanet/grass/grovedirt,
/area/exoplanet/grass/grove)
"Bp" = (
/turf/simulated/floor/exoplanet/grass/grove,
/area/exoplanet/grass/grove)
"CH" = (
/obj/item/broken_device,
/turf/simulated/floor/exoplanet/grass/grovedirt,
/area/exoplanet/grass/grove)
"Dk" = (
/obj/structure/boulder,
/turf/simulated/floor/exoplanet/water/shallow,
/area/exoplanet/grass/grove)
"DZ" = (
/obj/effect/spider/cocoon,
/turf/simulated/floor/exoplanet/grass/grovedirt,
/area/exoplanet/grass/grove)
"Eu" = (
/obj/structure/barricade/wooden{
	dir = 4
	},
/obj/item/material/knife/bayonet,
/turf/simulated/floor/exoplanet/grass/grovedirt,
/area/exoplanet/grass/grove)
"Ey" = (
/obj/item/device/ano_scanner,
/turf/simulated/floor/exoplanet/grass/grovedirt,
/area/exoplanet/grass/grove)
"Fe" = (
/obj/item/trash/mollusc_shell,
/obj/structure/flora/ausbushes/stalkybush,
/turf/simulated/floor/exoplanet/water/shallow,
/area/exoplanet/grass/grove)
"FN" = (
/obj/item/trash/mollusc_shell/barnacle,
/turf/simulated/floor/exoplanet/water/shallow,
/area/exoplanet/grass/grove)
"Gy" = (
/turf/simulated/mineral/random/exoplanet,
/area/exoplanet/grass/grove)
"Hf" = (
/obj/structure/pit,
/turf/simulated/floor/exoplanet/grass/grovedirt,
/area/exoplanet/grass/grove)
"Hi" = (
/obj/structure/flora/rock,
/turf/simulated/floor/exoplanet/grass/grovedirt,
/area/exoplanet/grass/grove)
"IN" = (
/obj/effect/decal/cleanable/cobweb,
/turf/simulated/floor/exoplanet/grass/grovedirt,
/area/exoplanet/grass/grove)
"Jx" = (
/obj/item/torch,
/turf/simulated/wall/wood,
/area/exoplanet/grass/grove)
"Kq" = (
/obj/structure/sink/puddle,
/obj/effect/decal/cleanable/cobweb2,
/turf/simulated/floor/exoplanet/grass/grovegravel,
/area/exoplanet/grass/grove)
"LP" = (
/turf/simulated/floor/exoplanet/water/shallow,
/area/exoplanet/grass/grove)
"Nw" = (
/obj/item/trash/mollusc_shell/clam,
/turf/simulated/floor/exoplanet/water/shallow,
/area/exoplanet/grass/grove)
"NQ" = (
/obj/item/clothing/shoes/cowboy/classic,
/turf/simulated/floor/exoplanet/grass/grovedirt,
/area/exoplanet/grass/grove)
"OR" = (
/obj/structure/flora/tree/grove,
/turf/simulated/floor/exoplanet/grass/grove,
/area/exoplanet/grass/grove)
"Ph" = (
/obj/structure/flora/tree/jungle/small,
/turf/simulated/floor/exoplanet/grass/grove,
/area/exoplanet/grass/grove)
"Rg" = (
/obj/structure/table/stone,
/obj/item/stack/material/animalhide,
/obj/item/reagent_containers/food/snacks/bearmeat,
/turf/simulated/floor/exoplanet/grass/grovedirt,
/area/exoplanet/grass/grove)
"RD" = (
/obj/item/device/flashlight/flare/torch,
/turf/simulated/floor/exoplanet/grass/grovegravel,
/area/exoplanet/grass/grove)
"RN" = (
/obj/structure/trash_pile,
/mob/living/simple_animal/hostile/giant_spider/nurse,
/turf/simulated/floor/exoplanet/grass/grovedirt,
/area/exoplanet/grass/grove)
"St" = (
/obj/structure/boulder,
/obj/effect/spider/stickyweb,
/turf/simulated/floor/exoplanet/water/shallow,
/area/exoplanet/grass/grove)
"SO" = (
/obj/item/trap/animal/large,
/turf/simulated/floor/exoplanet/grass/grovedirt,
/area/exoplanet/grass/grove)
"Tl" = (
/obj/structure/barricade/wooden{
	dir = 4
	},
/obj/item/gun/launcher/crossbow,
/turf/simulated/floor/exoplanet/grass/grovedirt,
/area/exoplanet/grass/grove)
"Tm" = (
/obj/effect/spider/stickyweb,
/turf/simulated/wall/wood,
/area/exoplanet/grass/grove)
"To" = (
/obj/structure/flora/tree/grove{
	icon_state = "grove_tree4"
	},
/turf/simulated/floor/exoplanet/grass/grove,
/area/exoplanet/grass/grove)
"TE" = (
/turf/simulated/floor/exoplanet/grass/grovegravel,
/area/exoplanet/grass/grove)
"Uc" = (
/obj/structure/flora/ausbushes/stalkybush,
/turf/simulated/floor/exoplanet/grass/grovegravel,
/area/exoplanet/grass/grove)
"Uq" = (
/obj/effect/decal/cleanable/cobweb,
/turf/simulated/floor/exoplanet/grass/grove,
/area/exoplanet/grass/grove)
"WK" = (
/obj/structure/simple_door/wood,
/obj/effect/spider/stickyweb,
/turf/simulated/floor/exoplanet/grass/grovedirt,
/area/exoplanet/grass/grove)
"XD" = (
/obj/structure/flora/rock/pile,
/turf/simulated/floor/exoplanet/grass/grovedirt,
/area/exoplanet/grass/grove)
"Yr" = (
/obj/structure/bed,
/obj/effect/decal/cleanable/cobweb,
/obj/effect/spider/cocoon,
/obj/effect/decal/remains/human,
/obj/item/clothing/under/rank/elyran_fatigues,
/turf/simulated/floor/exoplanet/grass/grovedirt,
/area/exoplanet/grass/grove)
"Yx" = (
/obj/effect/spider/cocoon,
/turf/simulated/floor/exoplanet/grass/grovegravel,
/area/exoplanet/grass/grove)

(1,1,1) = {"
Bp
Bp
Bp
Bp
Bp
Bp
Bp
Bp
Bp
Bp
Bp
Bp
Bp
Bp
Bp
em
Bp
LP
Bp
gn
Bp
Bp
Bp
Bp
Bp
Bp
Bp
Bp
Bp
Bp
"}
(2,1,1) = {"
Bp
Bp
Bp
Gy
Gy
Gy
Gy
Gy
Gy
Gy
Gy
Gy
Gy
Gy
Gy
LP
LP
LP
Gy
Gy
Gy
Gy
Gy
Gy
Gy
Bp
rb
Bp
Bp
Bp
"}
(3,1,1) = {"
rt
Gy
Gy
Gy
Gy
Gy
Gy
Gy
Gy
Gy
Gy
Gy
Gy
Gy
Gy
LP
Gy
Gy
Gy
Gy
Gy
yx
yx
Gy
Gy
yx
Gy
Bp
Bp
Bp
"}
(4,1,1) = {"
Bp
Gy
Gy
Gy
LP
Fe
TE
Rg
fr
TE
Dk
LP
LP
Gy
Gy
LP
Gy
Gy
Gy
Gy
yx
yx
dw
yx
yx
dw
Gy
Gy
Bp
Bp
"}
(5,1,1) = {"
Ph
Gy
Dk
LP
Dk
FN
TE
TE
yx
RD
Uc
LP
Nw
LP
Gy
LP
Gy
Gy
IN
yx
XD
yx
Gy
yx
yx
Gy
Gy
Gy
Bp
Bp
"}
(6,1,1) = {"
LP
LP
LP
rm
tO
yh
kn
XD
SO
yx
TE
sq
LP
LP
St
LP
Gy
Gy
yx
hi
kA
yx
Gy
Gy
yx
Gy
Gy
Gy
Gy
em
"}
(7,1,1) = {"
em
Gy
Gy
Gy
Gy
qk
CH
Ey
CH
yx
yx
TE
yh
LP
Gy
Gy
Gy
Gy
Gy
yx
Gy
Gy
Gy
Gy
XD
Gy
Gy
Gy
Gy
Bp
"}
(8,1,1) = {"
OR
Gy
Gy
Yx
Gy
Gy
yD
fy
fy
WK
fy
yx
TE
Gy
Gy
Gy
Gy
Gy
Gy
Gy
Gy
Gy
Gy
Gy
yx
Gy
Gy
Gy
Gy
Bp
"}
(9,1,1) = {"
Bp
Gy
Yx
TE
yx
yx
yx
Tm
Yr
dM
eW
yx
dw
Gy
Gy
dw
yx
Gy
Gy
Gy
Gy
Gy
Gy
IN
yx
yx
dw
yx
Bp
Bp
"}
(10,1,1) = {"
Bp
Gy
Yx
yx
Yx
Gy
yx
aW
Tl
Eu
Jx
dw
yx
yx
yx
yx
dw
rb
Gy
Gy
Gy
dw
yx
uH
yx
Gy
Gy
Gy
Bp
yx
"}
(11,1,1) = {"
Bp
Gy
Gy
yx
Gy
Gy
Gy
Gy
yx
yx
yx
yx
dw
Gy
yx
yx
dw
yx
Gy
Gy
Gy
dw
SO
Gy
Gy
Gy
Gy
Uq
Bp
Bp
"}
(12,1,1) = {"
Bp
Bp
Gy
yx
Gy
Gy
Gy
Gy
dw
yx
kA
Gy
Gy
Gy
Gy
dw
yx
yx
yx
XD
yx
yx
yx
Gy
Gy
Gy
Gy
Gy
Gy
Bp
"}
(13,1,1) = {"
Bp
Gy
Gy
DZ
Gy
Gy
IN
yx
yx
dw
Gy
Gy
Gy
Gy
Gy
yx
yx
Hi
yx
yx
yx
yx
dw
Gy
Gy
Gy
Gy
Gy
Gy
Bp
"}
(14,1,1) = {"
Bp
Gy
Hf
yx
lg
Gy
SO
dw
SO
us
Gy
Gy
Gy
Gy
yx
yx
Gy
Gy
yx
kA
Gy
yx
yx
Gy
Gy
Gy
Gy
Gy
Gy
Bp
"}
(15,1,1) = {"
Bp
Gy
tx
RN
lg
Gy
yx
uH
Gy
yx
yx
yx
yx
dw
yx
Gy
yx
yx
yx
Gy
yx
yx
Gy
Gy
yx
yx
TE
Gy
Gy
Bp
"}
(16,1,1) = {"
Bp
Gy
Gy
Gy
Gy
Gy
dw
rb
Gy
XD
yx
yx
yx
dw
Gy
NQ
yx
yx
yx
Gy
yx
Gy
yx
dw
yx
jL
Yx
Gy
Gy
Bp
"}
(17,1,1) = {"
Bp
yx
dw
yx
yx
XD
yx
yx
Gy
qh
yx
yx
Gy
Gy
Gy
Gy
RD
TE
yx
Gy
yx
Gy
yx
Gy
yx
TE
Yx
Gy
Gy
Bp
"}
(18,1,1) = {"
Bp
rb
Gy
Gy
Gy
Gy
Gy
Gy
Gy
Gy
qW
yx
Gy
Gy
Gy
Gy
Kq
gj
yx
Gy
yx
yx
yx
Gy
oB
Yx
Yx
Gy
Gy
Bp
"}
(19,1,1) = {"
Bp
Bp
Bp
Bp
Bp
To
Gy
Gy
Gy
Gy
Gy
Gy
Gy
Gy
Gy
Gy
Gy
Gy
qh
Gy
Gy
Gy
Gy
Gy
Gy
Gy
Gy
Gy
Gy
Bp
"}
(20,1,1) = {"
Bp
Bp
Bp
yx
Bp
Bp
Bp
Bp
Bp
Bp
Bp
Bp
Gy
Bp
Bp
Bp
Gy
Gy
Gy
Gy
Bp
Bp
Bp
Gy
Bp
Bp
Bp
Bp
Bp
Bp
"}
