//MAP CONVERTED BY dmm2tgm.py THIS HEADER COMMENT PREVENTS RECONVERSION, DO NOT REMOVE
"a" = (
/obj/structure/diona/vines,
/obj/structure/barricade/wooden{
	dir = 4
	},
/turf/simulated/floor/exoplanet/grass/grovedirt,
/area/exoplanet/grass/grove)
"b" = (
/obj/machinery/floodlight{
	dir = 4
	},
/turf/simulated/floor/exoplanet/grass/grovedirt,
/area/exoplanet/grass/grove)
"c" = (
/obj/structure/barricade/wooden{
	dir = 1
	},
/turf/simulated/wall/wood,
/area/exoplanet/grass/grove)
"e" = (
/obj/structure/flora/tree/grove{
	icon_state = "grove_tree3"
	},
/turf/simulated/floor/exoplanet/grass/grove,
/area/exoplanet/grass/grove)
"f" = (
/obj/structure/flora/tree/grove,
/turf/simulated/floor/exoplanet/grass/grovedirt,
/area/exoplanet/grass/grove)
"g" = (
/obj/structure/barricade/metal/wired{
	dir = 8
	},
/turf/simulated/floor/exoplanet/grass/grovedirt,
/area/exoplanet/grass/grove)
"h" = (
/obj/structure/flora/clutter,
/obj/structure/reagent_dispensers/watertank,
/turf/simulated/floor/exoplanet/water/shallow,
/area/exoplanet/grass/grove)
"i" = (
/obj/structure/barricade/metal/wired,
/turf/simulated/floor/exoplanet/grass/grove,
/area/exoplanet/grass/grove)
"j" = (
/obj/item/material/twohanded/chainsaw/fueled,
/turf/simulated/floor/exoplanet/grass/grovedirt,
/area/exoplanet/grass/grove)
"k" = (
/obj/structure/trash_pile,
/turf/simulated/floor/exoplanet/grass/grovedirt,
/area/exoplanet/grass/grove)
"l" = (
/obj/random/mre,
/obj/random/mre,
/obj/random/mre,
/obj/random/mre,
/obj/random/mre,
/obj/structure/closet/crate,
/obj/item/gun/projectile/pistol/adhomai,
/obj/item/reagent_containers/food/snacks/adhomian_can,
/obj/item/reagent_containers/food/drinks/cans/adhomai_milk,
/obj/item/reagent_containers/food/drinks/cans/adhomai_milk,
/obj/item/reagent_containers/food/drinks/bottle/victorygin,
/obj/structure/diona/vines,
/turf/simulated/floor/exoplanet/grass/grovedirt,
/area/exoplanet/grass/grove)
"m" = (
/obj/item/stack/material/wood/full,
/turf/simulated/floor/exoplanet/grass/grovedirt,
/area/exoplanet/grass/grove)
"n" = (
/turf/simulated/floor/exoplanet/grass/grove,
/area/exoplanet/grass/grove)
"o" = (
/turf/simulated/wall/wood,
/area/exoplanet/grass/grove)
"p" = (
/obj/item/material/twohanded/pike/pitchfork,
/turf/simulated/floor/exoplanet/grass/grovedirt,
/area/exoplanet/grass/grove)
"q" = (
/obj/structure/flora/ausbushes/sparsegrass,
/obj/item/landmine{
	deployed = 1
	},
/turf/simulated/floor/exoplanet/grass/grovedirt,
/area/exoplanet/grass/grove)
"r" = (
/obj/structure/barricade/wooden,
/turf/simulated/wall/wood,
/area/exoplanet/grass/grove)
"u" = (
/obj/structure/barricade/wooden{
	dir = 4
	},
/turf/simulated/floor/exoplanet/grass/grove,
/area/exoplanet/grass/grove)
"v" = (
/obj/structure/flora/ausbushes/sparsegrass,
/obj/item/landmine{
	deployed = 1
	},
/turf/simulated/floor/exoplanet/grass/grove,
/area/exoplanet/grass/grove)
"w" = (
/turf/simulated/floor/exoplanet/grass/grovedirt,
/area/exoplanet/grass/grove)
"x" = (
/obj/structure/bed/stool/chair/folding{
	dir = 8
	},
/turf/simulated/floor/exoplanet/grass/grovedirt,
/area/exoplanet/grass/grove)
"y" = (
/obj/structure/flora/ausbushes/sparsegrass,
/turf/simulated/floor/exoplanet/grass/grovegravel,
/area/exoplanet/grass/grove)
"z" = (
/obj/structure/trash_pile,
/turf/simulated/floor/exoplanet/grass/grovegravel,
/area/exoplanet/grass/grove)
"A" = (
/obj/item/landmine{
	deployed = 1
	},
/obj/structure/flora/ausbushes/sparsegrass,
/turf/simulated/floor/exoplanet/grass/grovedirt,
/area/exoplanet/grass/grove)
"B" = (
/obj/structure/barricade/metal/wired{
	dir = 8
	},
/obj/structure/diona/vines,
/turf/simulated/floor/exoplanet/grass/grove,
/area/exoplanet/grass/grove)
"C" = (
/obj/structure/diona/vines,
/turf/simulated/floor/exoplanet/grass/grovegravel,
/area/exoplanet/grass/grove)
"D" = (
/obj/structure/diona/vines,
/turf/simulated/floor/exoplanet/grass/grove,
/area/exoplanet/grass/grove)
"E" = (
/obj/structure/diona/vines,
/turf/simulated/floor/exoplanet/grass/grovedirt,
/area/exoplanet/grass/grove)
"F" = (
/obj/structure/barricade/metal/wired,
/obj/structure/diona/vines,
/turf/simulated/floor/exoplanet/grass/grove,
/area/exoplanet/grass/grove)
"G" = (
/obj/structure/flora/tree/grove{
	icon_state = "grove_tree5"
	},
/turf/simulated/floor/exoplanet/grass/grovegravel,
/area/exoplanet/grass/grove)
"H" = (
/obj/structure/barricade/wooden{
	dir = 4
	},
/obj/item/stack/material/wood/full,
/turf/simulated/floor/exoplanet/grass/grovedirt,
/area/exoplanet/grass/grove)
"I" = (
/obj/structure/diona/vines,
/turf/simulated/wall/wood,
/area/exoplanet/grass/grove)
"J" = (
/obj/structure/diona/vines,
/obj/structure/pit,
/obj/item/trash/spitwad,
/turf/simulated/floor/exoplanet/grass/grovegravel,
/area/exoplanet/grass/grove)
"K" = (
/obj/structure/bed/stool/chair/folding,
/turf/simulated/floor/exoplanet/grass/grovedirt,
/area/exoplanet/grass/grove)
"L" = (
/obj/structure/barricade/wooden{
	dir = 1
	},
/turf/simulated/floor/exoplanet/grass/grove,
/area/exoplanet/grass/grove)
"M" = (
/obj/effect/shuttle_landmark/groveworld/clearing,
/turf/simulated/floor/exoplanet/grass/grovegravel,
/area/exoplanet/grass/grove)
"N" = (
/obj/structure/trash_pile,
/obj/structure/diona/vines,
/turf/simulated/floor/exoplanet/grass/grovegravel,
/area/exoplanet/grass/grove)
"O" = (
/turf/simulated/floor/exoplanet/water/shallow,
/area/exoplanet/grass/grove)
"P" = (
/obj/structure/flora/clutter,
/turf/simulated/floor/exoplanet/grass/grove,
/area/exoplanet/grass/grove)
"Q" = (
/obj/structure/trash_pile,
/obj/item/stack/material/wood/full,
/turf/simulated/floor/exoplanet/grass/grovegravel,
/area/exoplanet/grass/grove)
"R" = (
/obj/structure/barricade/metal/wired,
/turf/simulated/floor/exoplanet/grass/grovedirt,
/area/exoplanet/grass/grove)
"S" = (
/obj/machinery/floodlight{
	on = 1
	},
/turf/simulated/floor/exoplanet/grass/grove,
/area/exoplanet/grass/grove)
"T" = (
/obj/item/trash/can/adhomian_can,
/turf/simulated/floor/exoplanet/grass/grove,
/area/exoplanet/grass/grove)
"U" = (
/obj/structure/flora/ausbushes/sparsegrass,
/turf/simulated/floor/exoplanet/grass/grove,
/area/exoplanet/grass/grove)
"V" = (
/obj/structure/barricade/wooden{
	dir = 1
	},
/turf/simulated/floor/exoplanet/grass/grovedirt,
/area/exoplanet/grass/grove)
"W" = (
/obj/structure/flora/tree/grove{
	icon_state = "grove_tree6"
	},
/turf/simulated/floor/exoplanet/grass/grove,
/area/exoplanet/grass/grove)
"X" = (
/turf/simulated/floor/exoplanet/grass/grovegravel,
/area/exoplanet/grass/grove)
"Y" = (
/obj/structure/barricade/metal/wired{
	dir = 1
	},
/turf/simulated/floor/exoplanet/grass/grovedirt,
/area/exoplanet/grass/grove)
"Z" = (
/obj/structure/barricade/metal/wired{
	dir = 8
	},
/turf/simulated/floor/exoplanet/grass/grove,
/area/exoplanet/grass/grove)

(1,1,1) = {"
n
P
X
X
w
n
n
n
v
n
n
n
n
n
U
n
n
n
n
n
"}
(2,1,1) = {"
n
G
Q
C
y
w
E
B
Z
n
w
n
n
n
n
n
n
q
n
n
"}
(3,1,1) = {"
n
z
J
N
X
n
n
n
w
X
n
n
w
w
g
o
o
o
o
n
"}
(4,1,1) = {"
n
k
p
X
n
w
w
w
n
n
w
w
w
w
w
w
w
w
o
n
"}
(5,1,1) = {"
n
D
L
n
n
w
X
w
X
X
X
X
X
X
w
w
w
w
R
U
"}
(6,1,1) = {"
n
n
w
w
X
X
X
X
X
X
X
X
X
X
X
X
w
w
w
n
"}
(7,1,1) = {"
n
n
n
w
X
X
X
X
X
X
X
X
X
X
X
X
X
w
w
n
"}
(8,1,1) = {"
n
n
w
X
X
X
X
X
X
X
X
X
X
X
X
X
X
X
i
n
"}
(9,1,1) = {"
w
n
w
w
X
X
X
X
X
X
X
X
X
X
X
X
X
w
i
n
"}
(10,1,1) = {"
n
n
n
w
X
X
X
X
X
X
X
X
X
X
X
X
X
w
S
n
"}
(11,1,1) = {"
n
y
n
X
X
X
X
X
X
X
X
X
X
X
X
X
X
w
i
A
"}
(12,1,1) = {"
n
n
n
w
w
X
X
X
X
X
X
X
X
X
X
X
X
w
i
n
"}
(13,1,1) = {"
n
n
Y
w
w
X
M
X
X
X
X
X
X
X
X
X
X
w
w
n
"}
(14,1,1) = {"
n
T
n
w
w
X
X
X
X
X
X
X
X
X
X
X
X
w
w
n
"}
(15,1,1) = {"
v
w
V
K
w
w
X
X
X
w
X
X
X
X
X
X
X
E
F
n
"}
(16,1,1) = {"
w
O
o
c
x
w
w
X
X
X
X
X
X
w
w
w
X
X
P
n
"}
(17,1,1) = {"
w
O
I
l
w
w
w
w
w
X
w
w
X
X
X
X
X
w
n
w
"}
(18,1,1) = {"
O
h
V
j
w
m
r
w
w
b
n
w
w
w
w
w
w
n
n
W
"}
(19,1,1) = {"
n
f
o
o
H
o
I
a
n
n
n
n
u
n
n
n
n
n
e
n
"}
(20,1,1) = {"
n
n
n
n
n
n
n
n
n
n
n
n
v
n
n
n
n
n
n
n
"}
