//MAP CONVERTED BY dmm2tgm.py THIS HEADER COMMENT PREVENTS RECONVERSION, DO NOT REMOVE
"a" = (
/obj/structure/flora/tree/dead,
/turf/simulated/floor/exoplanet/grass/grovedirt,
/area/exoplanet/grass/grove)
"d" = (
/turf/simulated/floor/exoplanet/grass/grovegravel,
/area/exoplanet/grass/grove)
"e" = (
/obj/item/ore/glass,
/turf/simulated/floor/exoplanet/grass/grove,
/area/exoplanet/grass/grove)
"f" = (
/obj/item/ore/glass,
/turf/simulated/floor/exoplanet/grass/grovegravel,
/area/exoplanet/grass/grove)
"g" = (
/obj/item/projectile/magic/fireball,
/turf/simulated/lava,
/area/exoplanet/grass/grove)
"h" = (
/obj/fire,
/turf/simulated/floor/exoplanet/grass/grovegravel,
/area/exoplanet/grass/grove)
"i" = (
/obj/fire,
/obj/effect/decal/cleanable/liquid_fuel,
/turf/simulated/floor/exoplanet/grass/grovedirt,
/area/exoplanet/grass/grove)
"m" = (
/obj/fire,
/turf/simulated/floor/exoplanet/grass/grovedirt,
/area/exoplanet/grass/grove)
"o" = (
/obj/effect/decal/cleanable/liquid_fuel,
/turf/simulated/floor/exoplanet/grass/grovegravel,
/area/exoplanet/grass/grove)
"p" = (
/turf/simulated/floor/exoplanet/grass/grove,
/area/exoplanet/grass/grove)
"q" = (
/obj/item/ore/phoron,
/turf/simulated/floor/exoplanet/grass/grove,
/area/exoplanet/grass/grove)
"t" = (
/obj/item/ore,
/turf/simulated/floor/exoplanet/grass/grovegravel,
/area/exoplanet/grass/grove)
"u" = (
/obj/item/ore/gold,
/turf/simulated/floor/exoplanet/grass/grove,
/area/exoplanet/grass/grove)
"v" = (
/obj/effect/decal/cleanable/ash,
/turf/simulated/floor/exoplanet/grass/grovedirt,
/area/exoplanet/grass/grove)
"w" = (
/obj/item/ore/phoron,
/turf/simulated/floor/exoplanet/grass/grovedirt,
/area/exoplanet/grass/grove)
"C" = (
/mob/living/simple_animal/hostile/carp/bloater,
/turf/simulated/floor/exoplanet/grass/grovegravel,
/area/exoplanet/grass/grove)
"F" = (
/obj/effect/decal/cleanable/liquid_fuel,
/turf/simulated/floor/exoplanet/grass/grovedirt,
/area/exoplanet/grass/grove)
"G" = (
/turf/simulated/lava,
/area/exoplanet/grass/grove)
"K" = (
/obj/item/ore,
/turf/simulated/floor/exoplanet/grass/grovedirt,
/area/exoplanet/grass/grove)
"M" = (
/obj/item/projectile/magic/fireball,
/turf/simulated/floor/exoplanet/grass/grovedirt,
/area/exoplanet/grass/grove)
"O" = (
/turf/simulated/floor/exoplanet/grass/grovedirt,
/area/exoplanet/grass/grove)
"Q" = (
/obj/item/ore/gold,
/turf/simulated/floor/exoplanet/grass/grovedirt,
/area/exoplanet/grass/grove)
"R" = (
/obj/item/ore/glass,
/turf/simulated/floor/exoplanet/grass/grovedirt,
/area/exoplanet/grass/grove)
"S" = (
/obj/item/ore/gold,
/turf/simulated/floor/exoplanet/grass/grovegravel,
/area/exoplanet/grass/grove)
"U" = (
/obj/effect/decal/cleanable/ash,
/obj/item/ore/glass,
/turf/simulated/floor/exoplanet/grass/grovedirt,
/area/exoplanet/grass/grove)
"W" = (
/obj/effect/decal/cleanable/ash,
/turf/simulated/floor/exoplanet/grass/grovegravel,
/area/exoplanet/grass/grove)
"X" = (
/turf/simulated/mineral/random/higher_chance/phoron,
/area/exoplanet/grass/grove)
"Y" = (
/obj/item/projectile/magic/fireball,
/turf/simulated/floor/exoplanet/grass/grovegravel,
/area/exoplanet/grass/grove)
"Z" = (
/obj/item/ore,
/turf/simulated/floor/exoplanet/grass/grove,
/area/exoplanet/grass/grove)

(1,1,1) = {"
p
p
p
p
p
p
p
p
p
p
p
p
p
d
p
p
p
p
p
p
"}
(2,1,1) = {"
p
O
p
Z
Z
p
O
u
d
p
O
a
w
O
O
O
p
p
d
p
"}
(3,1,1) = {"
p
p
d
d
t
d
F
o
d
d
O
O
O
W
d
O
p
p
p
p
"}
(4,1,1) = {"
p
p
d
a
v
O
F
F
O
v
O
F
F
i
d
O
d
p
O
p
"}
(5,1,1) = {"
d
p
d
m
d
d
o
o
d
d
d
O
O
M
d
O
v
p
e
p
"}
(6,1,1) = {"
e
p
d
O
d
X
X
X
Y
d
h
h
d
K
O
a
O
p
p
O
"}
(7,1,1) = {"
p
u
o
F
o
X
G
X
X
X
X
X
d
v
O
F
O
O
p
p
"}
(8,1,1) = {"
p
O
o
F
o
X
X
X
X
X
G
X
d
F
Q
O
O
O
p
p
"}
(9,1,1) = {"
p
p
d
O
d
d
X
X
C
X
X
X
d
O
R
F
F
F
p
p
"}
(10,1,1) = {"
O
p
p
O
M
d
X
X
X
X
X
X
d
F
f
O
O
O
O
p
"}
(11,1,1) = {"
d
p
O
W
K
W
d
d
X
X
G
X
W
F
d
O
v
O
p
p
"}
(12,1,1) = {"
p
p
a
F
F
o
G
S
X
X
h
h
d
O
g
d
O
p
p
p
"}
(13,1,1) = {"
O
O
O
o
F
o
o
o
o
d
Y
d
d
F
o
F
O
d
p
p
"}
(14,1,1) = {"
p
p
O
d
O
O
O
F
O
O
O
O
F
F
o
F
O
p
u
p
"}
(15,1,1) = {"
p
p
p
f
d
t
m
O
d
d
G
d
o
O
m
O
O
O
p
d
"}
(16,1,1) = {"
p
p
p
p
p
O
O
v
O
F
d
O
F
O
O
O
F
O
p
p
"}
(17,1,1) = {"
p
d
p
d
p
p
a
O
p
F
p
O
O
U
O
O
O
p
p
p
"}
(18,1,1) = {"
p
p
f
p
q
O
O
O
O
p
p
p
Z
p
O
S
p
p
p
p
"}
(19,1,1) = {"
d
p
p
p
p
p
p
p
p
p
d
O
p
p
p
p
p
p
Z
O
"}
(20,1,1) = {"
d
p
p
p
p
p
O
p
O
p
p
p
p
p
p
O
p
p
p
p
"}
