//MAP CONVERTED BY dmm2tgm.py THIS HEADER COMMENT PREVENTS RECONVERSION, DO NOT REMOVE
"a" = (
/obj/structure/diona/vines,
/obj/structure/barricade/wooden{
	dir = 4
	},
/turf/simulated/floor/exoplanet/grass/grovedirt,
/area/space)
"b" = (
/obj/machinery/floodlight{
	dir = 4
	},
/turf/simulated/floor/exoplanet/grass/grovedirt,
/area/space)
"c" = (
/obj/structure/barricade/wooden{
	dir = 1
	},
/turf/simulated/wall/wood,
/area/space)
"e" = (
/obj/structure/flora/tree/grove{
	icon_state = "grove_tree3"
	},
/turf/simulated/floor/exoplanet/grass/grove,
/area/space)
"f" = (
/obj/structure/flora/tree/grove,
/turf/simulated/floor/exoplanet/grass/grovedirt,
/area/space)
"g" = (
/obj/structure/barricade/metal/wired{
	dir = 8
	},
/turf/simulated/floor/exoplanet/grass/grovedirt,
/area/space)
"h" = (
/obj/structure/flora/clutter,
/obj/structure/reagent_dispensers/watertank,
/turf/simulated/floor/exoplanet/water/shallow,
/area/space)
"i" = (
/obj/structure/barricade/metal/wired,
/turf/simulated/floor/exoplanet/grass/grove,
/area/space)
"j" = (
/obj/item/material/twohanded/chainsaw/fueled,
/turf/simulated/floor/exoplanet/grass/grovedirt,
/area/space)
"k" = (
/obj/structure/trash_pile,
/turf/simulated/floor/exoplanet/grass/grovedirt,
/area/space)
"l" = (
/obj/random/mre,
/obj/random/mre,
/obj/random/mre,
/obj/random/mre,
/obj/random/mre,
/obj/structure/closet/crate,
/obj/item/gun/projectile/pistol/adhomai,
/obj/item/reagent_containers/food/snacks/adhomian_can,
/obj/item/reagent_containers/food/drinks/cans/adhomai_milk,
/obj/item/reagent_containers/food/drinks/cans/adhomai_milk,
/obj/item/reagent_containers/food/drinks/bottle/victorygin,
/obj/structure/diona/vines,
/turf/simulated/floor/exoplanet/grass/grovedirt,
/area/space)
"m" = (
/obj/item/stack/material/wood/full,
/turf/simulated/floor/exoplanet/grass/grovedirt,
/area/space)
"n" = (
/turf/simulated/floor/exoplanet/grass/grove,
/area/space)
"o" = (
/turf/simulated/wall/wood,
/area/space)
"p" = (
/obj/item/material/twohanded/pike/pitchfork,
/turf/simulated/floor/exoplanet/grass/grovedirt,
/area/space)
"q" = (
/obj/item/landmine/frag,
/obj/structure/flora/ausbushes/sparsegrass,
/turf/simulated/floor/exoplanet/grass/grovedirt,
/area/space)
"r" = (
/obj/structure/barricade/wooden,
/turf/simulated/wall/wood,
/area/space)
"t" = (
/obj/structure/flora/ausbushes/sparsegrass,
/obj/item/landmine,
/turf/simulated/floor/exoplanet/grass/grove,
/area/space)
"u" = (
/obj/structure/barricade/wooden{
	dir = 4
	},
/turf/simulated/floor/exoplanet/grass/grove,
/area/space)
"v" = (
/obj/item/landmine,
/obj/structure/flora/ausbushes/sparsegrass,
/turf/simulated/floor/exoplanet/grass/grove,
/area/space)
"w" = (
/turf/simulated/floor/exoplanet/grass/grovedirt,
/area/space)
"x" = (
/obj/structure/bed/stool/chair/folding{
	dir = 8
	},
/turf/simulated/floor/exoplanet/grass/grovedirt,
/area/space)
"y" = (
/obj/structure/flora/ausbushes/sparsegrass,
/turf/simulated/floor/exoplanet/grass/grovegravel,
/area/space)
"z" = (
/obj/structure/trash_pile,
/turf/simulated/floor/exoplanet/grass/grovegravel,
/area/space)
"A" = (
/obj/item/landmine,
/obj/structure/flora/ausbushes/sparsegrass,
/turf/simulated/floor/exoplanet/grass/grovedirt,
/area/space)
"B" = (
/obj/structure/barricade/metal/wired{
	dir = 8
	},
/obj/structure/diona/vines,
/turf/simulated/floor/exoplanet/grass/grove,
/area/space)
"C" = (
/obj/structure/diona/vines,
/turf/simulated/floor/exoplanet/grass/grovegravel,
/area/space)
"D" = (
/obj/structure/diona/vines,
/turf/simulated/floor/exoplanet/grass/grove,
/area/space)
"E" = (
/obj/structure/diona/vines,
/turf/simulated/floor/exoplanet/grass/grovedirt,
/area/space)
"F" = (
/obj/structure/barricade/metal/wired,
/obj/structure/diona/vines,
/turf/simulated/floor/exoplanet/grass/grove,
/area/space)
"G" = (
/obj/structure/flora/tree/grove{
	icon_state = "grove_tree5"
	},
/turf/simulated/floor/exoplanet/grass/grovegravel,
/area/space)
"H" = (
/obj/structure/barricade/wooden{
	dir = 4
	},
/obj/item/stack/material/wood/full,
/turf/simulated/floor/exoplanet/grass/grovedirt,
/area/space)
"I" = (
/obj/structure/diona/vines,
/turf/simulated/wall/wood,
/area/space)
"J" = (
/obj/structure/diona/vines,
/obj/structure/pit,
/obj/item/trash/spitwad,
/turf/simulated/floor/exoplanet/grass/grovegravel,
/area/space)
"K" = (
/obj/structure/bed/stool/chair/folding,
/turf/simulated/floor/exoplanet/grass/grovedirt,
/area/space)
"L" = (
/obj/structure/barricade/wooden{
	dir = 1
	},
/turf/simulated/floor/exoplanet/grass/grove,
/area/space)
"M" = (
/obj/effect/shuttle_landmark{
	name = "Used Landing Site"
	},
/turf/simulated/floor/exoplanet/grass/grovegravel,
/area/space)
"N" = (
/obj/structure/trash_pile,
/obj/structure/diona/vines,
/turf/simulated/floor/exoplanet/grass/grovegravel,
/area/space)
"O" = (
/turf/simulated/floor/exoplanet/water/shallow,
/area/space)
"P" = (
/obj/structure/flora/clutter,
/turf/simulated/floor/exoplanet/grass/grove,
/area/space)
"Q" = (
/obj/structure/trash_pile,
/obj/item/stack/material/wood/full,
/turf/simulated/floor/exoplanet/grass/grovegravel,
/area/space)
"R" = (
/obj/structure/barricade/metal/wired,
/turf/simulated/floor/exoplanet/grass/grovedirt,
/area/space)
"S" = (
/obj/machinery/floodlight{
	on = 1
	},
/turf/simulated/floor/exoplanet/grass/grove,
/area/space)
"T" = (
/obj/item/trash/can/adhomian_can,
/turf/simulated/floor/exoplanet/grass/grove,
/area/space)
"U" = (
/obj/structure/flora/ausbushes/sparsegrass,
/turf/simulated/floor/exoplanet/grass/grove,
/area/space)
"V" = (
/obj/structure/barricade/wooden{
	dir = 1
	},
/turf/simulated/floor/exoplanet/grass/grovedirt,
/area/space)
"W" = (
/obj/structure/flora/tree/grove{
	icon_state = "grove_tree6"
	},
/turf/simulated/floor/exoplanet/grass/grove,
/area/space)
"X" = (
/turf/simulated/floor/exoplanet/grass/grovegravel,
/area/space)
"Y" = (
/obj/structure/barricade/metal/wired{
	dir = 1
	},
/turf/simulated/floor/exoplanet/grass/grovedirt,
/area/space)
"Z" = (
/obj/structure/barricade/metal/wired{
	dir = 8
	},
/turf/simulated/floor/exoplanet/grass/grove,
/area/space)

(1,1,1) = {"
n
P
X
X
w
n
n
n
t
n
n
n
n
n
U
n
n
n
n
n
"}
(2,1,1) = {"
n
G
Q
C
y
w
E
B
Z
n
w
n
n
n
n
n
n
q
n
n
"}
(3,1,1) = {"
n
z
J
N
X
n
n
n
w
X
n
n
w
w
g
o
o
o
o
n
"}
(4,1,1) = {"
n
k
p
X
n
w
w
w
n
n
w
w
w
w
w
w
w
w
o
n
"}
(5,1,1) = {"
n
D
L
n
n
w
X
w
X
X
X
X
X
X
w
w
w
w
R
U
"}
(6,1,1) = {"
n
n
w
w
X
X
X
X
X
X
X
X
X
X
X
X
w
w
w
n
"}
(7,1,1) = {"
n
n
n
w
X
X
X
X
X
X
X
X
X
X
X
X
X
w
w
n
"}
(8,1,1) = {"
n
n
w
X
X
X
X
X
X
X
X
X
X
X
X
X
X
X
i
n
"}
(9,1,1) = {"
w
n
w
w
X
X
X
X
X
X
X
X
X
X
X
X
X
w
i
n
"}
(10,1,1) = {"
n
n
n
w
X
X
X
X
X
M
X
X
X
X
X
X
X
w
S
n
"}
(11,1,1) = {"
n
y
n
X
X
X
X
X
X
X
X
X
X
X
X
X
X
w
i
A
"}
(12,1,1) = {"
n
n
n
w
w
X
X
X
X
X
X
X
X
X
X
X
X
w
i
n
"}
(13,1,1) = {"
n
n
Y
w
w
X
X
X
X
X
X
X
X
X
X
X
X
w
w
n
"}
(14,1,1) = {"
n
T
n
w
w
X
X
X
X
X
X
X
X
X
X
X
X
w
w
n
"}
(15,1,1) = {"
v
w
V
K
w
w
X
X
X
w
X
X
X
X
X
X
X
E
F
n
"}
(16,1,1) = {"
w
O
o
c
x
w
w
X
X
X
X
X
X
w
w
w
X
X
P
n
"}
(17,1,1) = {"
w
O
I
l
w
w
w
w
w
X
w
w
X
X
X
X
X
w
n
w
"}
(18,1,1) = {"
O
h
V
j
w
m
r
w
w
b
n
w
w
w
w
w
w
n
n
W
"}
(19,1,1) = {"
n
f
o
o
H
o
I
a
n
n
n
n
u
n
n
n
n
n
e
n
"}
(20,1,1) = {"
n
n
n
n
n
n
n
n
n
n
n
n
v
n
n
n
n
n
n
n
"}
