//MAP CONVERTED BY dmm2tgm.py THIS HEADER COMMENT PREVENTS RECONVERSION, DO NOT REMOVE
"a" = (
/turf/simulated/floor/exoplanet/grass/grovegravel,
/area/space)
"c" = (
/obj/structure/flora/tree/grove{
	icon_state = "grove_tree5"
	},
/turf/simulated/floor/exoplanet/grass/grove,
/area/space)
"e" = (
/obj/structure/flora/rock,
/turf/simulated/floor/exoplanet/grass/grove,
/area/space)
"h" = (
/obj/structure/flora/tree/grove{
	icon_state = "grove_tree4"
	},
/turf/simulated/floor/exoplanet/grass/grove,
/area/space)
"i" = (
/obj/structure/boulder,
/turf/simulated/floor/exoplanet/grass/grove,
/area/space)
"k" = (
/obj/structure/flora/tree/grove,
/turf/simulated/floor/exoplanet/grass/grove,
/area/space)
"m" = (
/obj/structure/flora/ausbushes/ywflowers,
/turf/simulated/floor/exoplanet/grass/grove,
/area/space)
"q" = (
/obj/structure/flora/ausbushes/sparsegrass,
/turf/simulated/floor/exoplanet/grass/grove,
/area/space)
"w" = (
/obj/structure/flora/rock/pile,
/turf/simulated/floor/exoplanet/grass/grove,
/area/space)
"z" = (
/obj/structure/flora/ausbushes/sparsegrass,
/turf/simulated/floor/exoplanet/grass/grovedirt,
/area/space)
"A" = (
/obj/structure/flora/clutter,
/turf/simulated/floor/exoplanet/grass/grove,
/area/space)
"E" = (
/obj/structure/flora/bush/grove{
	icon_state = "grove_bush3"
	},
/turf/simulated/floor/exoplanet/grass/grove,
/area/space)
"F" = (
/obj/effect/spider/cocoon,
/turf/simulated/floor/exoplanet/grass/grove,
/area/space)
"G" = (
/obj/structure/diona/vines,
/turf/simulated/floor/exoplanet/grass/grovedirt,
/area/space)
"I" = (
/obj/effect/shuttle_landmark{
	name = "Clearing"
	},
/turf/simulated/floor/exoplanet/grass/grovegravel,
/area/space)
"T" = (
/obj/structure/diona/vines,
/turf/simulated/floor/exoplanet/grass/grovegravel,
/area/space)
"U" = (
/turf/simulated/floor/exoplanet/grass/grove,
/area/space)
"V" = (
/obj/structure/flora/bush/grove{
	icon_state = "grove_bush4"
	},
/turf/simulated/floor/exoplanet/grass/grove,
/area/space)
"W" = (
/obj/structure/flora/tree/grove{
	icon_state = "grove_tree3"
	},
/obj/effect/spider/cocoon,
/turf/simulated/floor/exoplanet/grass/grove,
/area/space)
"X" = (
/turf/simulated/floor/exoplanet/grass/grovedirt,
/area/space)
"Z" = (
/obj/effect/mist,
/turf/simulated/floor/exoplanet/grass/grovegravel,
/area/space)

(1,1,1) = {"
U
U
U
q
U
U
U
U
U
G
m
U
U
U
U
U
U
U
W
U
V
U
U
U
w
U
U
U
U
U
"}
(2,1,1) = {"
U
U
c
A
U
a
U
U
U
U
U
U
U
U
U
U
U
U
U
U
U
E
U
V
U
U
q
U
U
U
"}
(3,1,1) = {"
U
U
U
m
U
U
U
X
U
X
U
z
U
U
U
m
U
Z
a
a
U
U
U
U
U
U
U
a
U
U
"}
(4,1,1) = {"
U
U
U
U
a
X
a
a
a
a
a
a
X
G
X
X
a
a
a
a
X
a
X
X
G
U
U
U
U
q
"}
(5,1,1) = {"
e
X
G
X
X
a
a
U
a
X
a
U
a
a
a
U
a
U
a
a
a
a
a
X
a
a
T
T
U
U
"}
(6,1,1) = {"
U
a
U
a
a
a
a
a
a
a
a
a
a
a
a
a
a
a
a
U
a
a
a
a
a
X
a
X
U
w
"}
(7,1,1) = {"
U
a
a
Z
a
a
a
a
a
a
a
a
a
a
a
a
a
a
a
a
a
a
a
a
a
a
a
a
X
U
"}
(8,1,1) = {"
U
a
a
a
a
a
a
a
a
a
a
a
a
a
a
a
a
a
a
a
a
a
a
a
a
Z
a
a
U
q
"}
(9,1,1) = {"
X
a
a
a
a
a
a
a
a
a
a
a
a
a
a
a
a
a
a
a
a
a
a
a
a
a
a
X
a
U
"}
(10,1,1) = {"
U
U
a
a
a
a
a
a
a
a
a
a
a
a
a
a
a
a
a
a
a
a
a
a
a
a
a
a
a
U
"}
(11,1,1) = {"
U
a
X
a
a
a
a
a
a
a
a
a
a
a
a
a
a
a
a
a
a
a
a
a
a
a
a
a
a
X
"}
(12,1,1) = {"
U
a
a
a
a
a
a
a
a
a
a
a
a
a
a
a
a
a
a
a
a
a
a
a
a
a
a
a
a
U
"}
(13,1,1) = {"
q
a
a
a
a
a
a
a
a
a
a
a
a
a
a
a
a
a
a
a
a
a
a
a
a
a
a
a
a
U
"}
(14,1,1) = {"
U
X
X
a
a
X
a
a
a
a
a
a
a
a
a
a
a
a
a
a
a
a
a
a
a
a
X
a
X
U
"}
(15,1,1) = {"
U
X
X
X
a
a
X
a
a
a
a
a
a
a
a
a
a
a
a
a
a
a
a
a
a
a
a
a
U
U
"}
(16,1,1) = {"
U
G
a
a
X
a
a
a
a
a
a
a
a
a
I
a
a
a
a
a
a
a
a
a
a
a
a
a
U
a
"}
(17,1,1) = {"
U
U
a
a
a
a
a
a
a
a
a
a
a
a
a
a
a
a
a
a
a
a
a
a
a
a
a
a
U
U
"}
(18,1,1) = {"
U
z
a
a
a
a
a
a
a
a
a
a
a
a
a
a
a
a
a
a
a
a
a
a
a
a
a
a
X
e
"}
(19,1,1) = {"
U
U
a
X
a
a
a
a
a
a
a
a
a
a
a
a
a
a
a
a
a
a
a
a
a
a
a
a
i
U
"}
(20,1,1) = {"
U
U
G
a
a
a
a
a
a
a
a
a
a
a
a
a
a
a
a
a
a
a
a
a
a
a
a
a
X
U
"}
(21,1,1) = {"
U
U
a
a
a
a
a
a
a
a
a
a
a
a
a
a
a
a
a
a
a
a
a
a
a
a
a
a
X
U
"}
(22,1,1) = {"
a
U
a
a
a
a
a
a
a
a
a
a
a
a
a
a
a
a
a
a
a
a
a
a
a
a
a
a
X
U
"}
(23,1,1) = {"
U
U
U
a
a
a
a
a
a
a
a
a
a
a
a
a
a
a
a
a
a
a
a
a
a
a
a
a
X
U
"}
(24,1,1) = {"
U
U
a
a
a
a
a
a
a
a
a
a
a
a
a
a
a
a
a
a
a
a
a
a
a
Z
a
a
U
U
"}
(25,1,1) = {"
e
U
q
X
X
X
a
a
a
a
Z
a
a
X
a
a
a
a
a
a
a
a
a
U
a
a
a
T
a
c
"}
(26,1,1) = {"
U
U
U
X
X
X
U
U
G
a
a
a
a
U
a
a
a
T
U
X
a
a
a
a
T
X
U
a
T
U
"}
(27,1,1) = {"
U
V
U
U
a
U
a
U
U
U
U
X
X
X
U
U
X
X
X
T
a
a
U
a
U
a
X
a
T
U
"}
(28,1,1) = {"
U
U
k
U
U
U
U
U
U
U
U
U
U
U
U
U
U
X
U
U
X
U
U
U
X
U
U
U
U
U
"}
(29,1,1) = {"
U
U
U
q
U
w
U
U
U
m
U
V
U
U
a
U
U
U
U
U
U
U
h
U
U
A
m
V
U
U
"}
(30,1,1) = {"
U
U
U
U
U
U
U
U
U
U
U
U
U
U
U
U
U
U
m
U
U
U
F
U
U
m
U
U
U
U
"}
