//MAP CONVERTED BY dmm2tgm.py THIS HEADER COMMENT PREVENTS RECONVERSION, DO NOT REMOVE
"bf" = (
/obj/item/clothing/accessory/poncho/vaurca,
/turf/simulated/wall/vaurca,
/area/space)
"bx" = (
/obj/effect/decal/cleanable/spiderling_remains,
/turf/simulated/wall/vaurca,
/area/space)
"cC" = (
/obj/item/organ/internal/liver/vaurca,
/turf/simulated/floor/vaurca,
/area/space)
"db" = (
/obj/item/reagent_containers/food/snacks/meat/human,
/obj/item/clothing/accessory/badge/passport/elyra,
/turf/simulated/floor/vaurca,
/area/space)
"fd" = (
/turf/simulated/wall/vaurca,
/area/space)
"fe" = (
/obj/item/reagent_containers/food/snacks/egg,
/obj/effect/spider/cocoon{
	color = "#8B8000"
	},
/turf/simulated/floor/vaurca,
/area/space)
"gq" = (
/obj/item/clothing/head/vaurca_breeder/cthur,
/turf/simulated/wall/vaurca,
/area/space)
"iE" = (
/obj/effect/decal/cleanable/spiderling_remains,
/turf/simulated/floor/exoplanet/grass/grovedirt,
/area/space)
"iJ" = (
/obj/effect/decal/remains/xeno/burned,
/obj/item/neuralbroke,
/turf/simulated/floor/exoplanet/grass/grovegravel,
/area/space)
"je" = (
/obj/item/vaurca/box,
/turf/simulated/floor/vaurca,
/area/space)
"jg" = (
/obj/item/organ/internal/heart/vaurca,
/turf/simulated/floor/vaurca,
/area/space)
"jJ" = (
/obj/item/organ/internal/brain/xeno,
/turf/simulated/floor/vaurca,
/area/space)
"kE" = (
/obj/item/clothing/suit/space/void/vaurca,
/turf/simulated/wall/vaurca,
/area/space)
"kQ" = (
/obj/item/archaeological_find,
/turf/simulated/floor/vaurca,
/area/space)
"kZ" = (
/obj/effect/decal/cleanable/spiderling_remains,
/obj/effect/decal/fake_object/light_source/invisible{
	light_color = "#FF0000"
	},
/turf/simulated/wall/vaurca,
/area/space)
"lg" = (
/obj/item/clothing/head/vaurca_breeder,
/turf/simulated/wall/vaurca,
/area/space)
"lj" = (
/obj/item/grenade/spawnergrenade/vaurca/liidra{
	name = "alien artifact";
	desc = "It pulses with some sort of dark life. Closer inspection would show a faint darkness emenating from it, as if it's surrounded in shadow."
	},
/turf/simulated/floor/vaurca,
/area/space)
"mc" = (
/obj/item/melee/energy/vaurca_zweihander,
/turf/simulated/wall/vaurca,
/area/space)
"mE" = (
/obj/effect/decal/remains/xeno/burned,
/turf/simulated/floor/exoplanet/grass/grovegravel,
/area/space)
"nW" = (
/obj/item/organ/internal/appendix/vaurca,
/obj/item/grenade/spawnergrenade/vaurca{
	desc = "A strange pod with a slight, yellowish glow coming from its interior.";
	name = "alien artifact"
	},
/turf/simulated/floor/vaurca,
/area/space)
"pB" = (
/obj/item/melee/energy/vaurca,
/turf/simulated/wall/vaurca,
/area/space)
"pV" = (
/turf/simulated/wall/phoron,
/area/space)
"qg" = (
/obj/item/ore/phoron,
/obj/item/ore/phoron,
/obj/item/ore/phoron,
/obj/item/ore/phoron,
/turf/simulated/floor/reinforced/phoron,
/area/space)
"qL" = (
/obj/effect/decal/fake_object/light_source/invisible{
	light_color = "#FF0000"
	},
/turf/simulated/wall/vaurca,
/area/space)
"rQ" = (
/obj/effect/decal/remains/xeno/burned,
/turf/simulated/floor/vaurca,
/area/space)
"sk" = (
/obj/item/organ/internal/appendix/vaurca,
/turf/simulated/floor/vaurca,
/area/space)
"sW" = (
/obj/item/storage/box/vaurca,
/turf/simulated/wall/phoron,
/area/space)
"tG" = (
/obj/machinery/door/airlock/vaurca,
/turf/simulated/floor/vaurca,
/area/space)
"tN" = (
/obj/effect/decal/cleanable/ash,
/turf/simulated/floor/exoplanet/grass/grovedirt,
/area/space)
"tZ" = (
/obj/effect/decal/cleanable/spiderling_remains,
/obj/item/neuralbroke,
/turf/simulated/floor/exoplanet/grass/grovegravel,
/area/space)
"uI" = (
/obj/effect/decal/cleanable/spiderling_remains,
/obj/item/neuralbroke,
/turf/simulated/floor/exoplanet/grass/grovedirt,
/area/space)
"vN" = (
/obj/item/ore/phoron,
/obj/item/ore/phoron,
/obj/item/ore/phoron,
/obj/item/ore/phoron,
/obj/item/ore/phoron,
/obj/item/ore/phoron,
/turf/simulated/floor/reinforced/hydrogen,
/area/space)
"wi" = (
/obj/item/organ/internal/eyes/night/vaurca,
/turf/simulated/wall/vaurca,
/area/space)
"xi" = (
/turf/simulated/floor/exoplanet/grass/grovedirt,
/area/space)
"xH" = (
/obj/effect/decal/cleanable/spiderling_remains,
/turf/simulated/floor/exoplanet/grass/grovegravel,
/area/space)
"yu" = (
/obj/item/organ/internal/brain/vaurca,
/turf/simulated/floor/vaurca,
/area/space)
"yW" = (
/turf/simulated/floor/reinforced/carbon_dioxide,
/area/space)
"zN" = (
/obj/effect/decal/cleanable/ash,
/turf/simulated/floor/exoplanet/grass/grovegravel,
/area/space)
"AH" = (
/obj/item/gun/energy/vaurca/typec,
/turf/simulated/wall/vaurca,
/area/space)
"AM" = (
/obj/item/organ/internal/vaurca/filtrationbit,
/turf/simulated/floor/vaurca,
/area/space)
"Cf" = (
/obj/effect/decal/remains/human/burned,
/turf/simulated/floor/exoplanet/grass/grovegravel,
/area/space)
"Dh" = (
/obj/item/organ/internal/vaurca/reservoir,
/turf/simulated/floor/vaurca,
/area/space)
"EF" = (
/obj/item/clothing/head/vaurca_breeder/klax,
/turf/simulated/wall/vaurca,
/area/space)
"EU" = (
/obj/item/grenade/spawnergrenade/vaurca{
	desc = "A strange pod with a slight, yellowish glow coming from its interior.";
	name = "alien artifact"
	},
/turf/simulated/floor/vaurca,
/area/space)
"Fg" = (
/obj/item/ore/phoron,
/obj/item/ore/phoron,
/obj/item/ore/phoron,
/obj/item/ore/phoron,
/obj/item/ore/phoron,
/turf/simulated/floor/reinforced/phoron,
/area/space)
"HR" = (
/obj/item/organ/pariah_brain,
/turf/simulated/floor/vaurca,
/area/space)
"Ij" = (
/obj/effect/decal/cleanable/ash,
/obj/item/neuralbroke,
/turf/simulated/floor/exoplanet/grass/grovegravel,
/area/space)
"IH" = (
/turf/simulated/floor/exoplanet/grass/grove,
/area/space)
"Ja" = (
/obj/item/organ/internal/kidneys/vaurca,
/turf/simulated/floor/vaurca,
/area/space)
"Jn" = (
/obj/item/stack/material/animalhide/human,
/obj/item/archaeological_find,
/turf/simulated/floor/vaurca,
/area/space)
"JO" = (
/obj/item/organ/internal/liver/vaurca/robo,
/turf/simulated/floor/vaurca,
/area/space)
"LI" = (
/obj/item/reagent_containers/food/snacks/egg,
/turf/simulated/wall/vaurca,
/area/space)
"Ma" = (
/obj/item/melee/energy/vaurca,
/turf/simulated/wall/phoron,
/area/space)
"Nf" = (
/obj/item/ore/phoron,
/turf/simulated/floor/reinforced/phoron,
/area/space)
"NK" = (
/obj/effect/decal/cleanable/spiderling_remains,
/obj/effect/decal/cleanable/ash,
/obj/item/neuralbroke,
/turf/simulated/floor/exoplanet/grass/grovedirt,
/area/space)
"NR" = (
/obj/structure/flora/tree/dead,
/turf/simulated/floor/exoplanet/grass/grovedirt,
/area/space)
"On" = (
/obj/item/ore/strangerock,
/turf/simulated/floor/exoplanet/grass/grovegravel,
/area/space)
"OR" = (
/obj/structure/flora/tree/dead,
/turf/simulated/floor/exoplanet/grass/grovegravel,
/area/space)
"OS" = (
/obj/item/clothing/accessory/flagpatch/elyra,
/obj/effect/decal/remains/human,
/turf/simulated/floor/exoplanet/grass/grove,
/area/space)
"Pc" = (
/turf/simulated/floor/exoplanet/grass/grovegravel,
/area/space)
"Pk" = (
/obj/item/clothing/shoes/magboots/vaurca,
/turf/simulated/wall/vaurca,
/area/space)
"Pv" = (
/turf/simulated/floor/vaurca,
/area/space)
"PJ" = (
/obj/item/clothing/head/helmet/space/void/vaurca,
/turf/simulated/wall/vaurca,
/area/space)
"QT" = (
/obj/effect/decal/cleanable/ash,
/obj/item/neuralbroke,
/turf/simulated/floor/exoplanet/grass/grovedirt,
/area/space)
"Si" = (
/obj/item/neuralbroke,
/turf/simulated/floor/exoplanet/grass/grovegravel,
/area/space)
"Ss" = (
/obj/item/melee/vaurca/rock,
/obj/effect/decal/fake_object/light_source/invisible{
	light_color = "#FF0000"
	},
/turf/simulated/floor/reinforced/phoron,
/area/space)
"Th" = (
/turf/simulated/floor/reinforced/phoron,
/area/space)
"Tq" = (
/obj/item/organ/internal/vaurca/neuralsocket,
/turf/simulated/floor/vaurca,
/area/space)
"UV" = (
/obj/item/ore/phoron,
/obj/item/ore/phoron,
/obj/item/ore/phoron,
/obj/item/ore/phoron,
/obj/item/ore/phoron,
/obj/item/ore/phoron,
/obj/item/ore/phoron,
/obj/item/ore/phoron,
/obj/item/ore/phoron,
/turf/simulated/floor/reinforced/phoron,
/area/space)
"VO" = (
/obj/effect/decal/remains/human/burned,
/turf/simulated/floor/exoplanet/grass/grovedirt,
/area/space)
"Wp" = (
/obj/item/ore/phoron,
/turf/simulated/wall/vaurca,
/area/space)
"Wu" = (
/obj/item/organ/internal/vaurca/neuralsocket,
/obj/effect/decal/remains/xeno,
/turf/simulated/floor/exoplanet/grass/grove,
/area/space)
"XR" = (
/obj/item/melee/vaurca/rock,
/turf/simulated/floor/reinforced/carbon_dioxide,
/area/space)
"Ye" = (
/obj/item/melee/vaurca/rock,
/obj/item/ore/phoron,
/obj/item/ore/phoron,
/obj/item/ore/phoron,
/obj/item/ore/phoron,
/obj/item/ore/phoron,
/obj/item/ore/phoron,
/obj/item/ore/phoron,
/obj/item/ore/phoron,
/obj/item/ore/phoron,
/turf/simulated/floor/reinforced/phoron,
/area/space)
"Yl" = (
/obj/item/organ/internal/vaurca/preserve,
/turf/simulated/floor/vaurca,
/area/space)
"Zi" = (
/obj/item/vaurca/box,
/turf/simulated/wall/vaurca,
/area/space)

(1,1,1) = {"
IH
IH
IH
IH
IH
IH
IH
IH
IH
IH
IH
IH
IH
IH
IH
IH
IH
IH
IH
IH
IH
IH
IH
IH
IH
IH
IH
IH
IH
IH
IH
IH
IH
IH
IH
IH
IH
"}
(2,1,1) = {"
IH
IH
IH
IH
IH
IH
IH
IH
IH
IH
IH
IH
IH
xi
IH
IH
IH
IH
IH
IH
IH
IH
IH
IH
IH
IH
IH
IH
IH
IH
IH
IH
IH
IH
IH
IH
IH
"}
(3,1,1) = {"
IH
IH
IH
IH
IH
IH
IH
IH
IH
IH
IH
IH
IH
IH
xi
IH
xi
xi
IH
xi
IH
IH
IH
IH
IH
IH
xi
xi
xi
xi
xi
xi
xi
IH
IH
IH
IH
"}
(4,1,1) = {"
IH
IH
IH
xi
IH
IH
xi
xi
IH
xi
xi
IH
IH
xi
xi
xi
IH
IH
IH
xi
IH
IH
xi
IH
IH
IH
xi
xi
xi
Pc
Pc
xi
xi
IH
IH
IH
IH
"}
(5,1,1) = {"
IH
IH
xi
xi
xi
IH
IH
xi
IH
VO
xi
IH
IH
xi
xi
IH
IH
IH
IH
xi
xi
Pc
IH
xi
NR
xi
Pc
xi
Pc
xi
xi
xi
xi
IH
IH
IH
IH
"}
(6,1,1) = {"
IH
IH
IH
IH
xi
xi
xi
xi
xi
xi
xi
xi
IH
xi
xi
IH
Pc
xi
xi
xi
IH
IH
IH
xi
xi
xi
xi
xi
xi
xi
IH
IH
xi
xi
IH
IH
IH
"}
(7,1,1) = {"
IH
IH
xi
IH
xi
Pc
Pc
Pc
xi
xi
xi
IH
IH
Pc
xi
xi
xi
fd
xi
xi
xi
xi
IH
xi
QT
Cf
Pc
Pc
xi
Pc
Pc
IH
xi
xi
IH
IH
IH
"}
(8,1,1) = {"
IH
IH
IH
xi
xi
OR
xi
fd
Pc
xi
xi
Cf
xi
xi
Pc
xi
fd
Fg
fd
xi
xi
fd
fd
xi
Pc
Pc
xi
xi
fd
xi
xi
Pc
xi
xi
IH
IH
IH
"}
(9,1,1) = {"
IH
IH
xi
xi
Pc
xi
fd
qg
fd
xi
xi
xi
Pc
Pc
xi
xi
xi
fd
xi
Pc
fd
Pc
xi
fd
Pc
Pv
xi
fd
xi
fd
xi
IH
xi
IH
xi
xi
IH
"}
(10,1,1) = {"
IH
IH
xi
xi
xi
xi
Pv
fd
Pv
xi
xi
xi
xi
xi
zN
xi
xi
Pc
Pc
fd
Pc
Pc
Pc
Pc
Pv
Pc
Pv
Pc
xi
fd
xi
xi
xi
xi
xi
IH
IH
"}
(11,1,1) = {"
IH
IH
xi
IH
IH
IH
IH
xi
xi
Pv
xi
xi
fd
fd
xi
xi
xi
Pc
Pc
fd
Pc
Pc
fd
Pv
Pc
Pc
Pc
mE
Pc
fd
xi
xi
Pc
IH
IH
IH
IH
"}
(12,1,1) = {"
IH
IH
IH
IH
IH
IH
IH
xi
xi
Pc
Pv
fd
xi
pV
fd
Pc
xH
fd
Pc
fd
Pc
fd
Th
fd
Pc
wi
bx
Si
Pc
fd
xi
xi
xi
IH
OS
Pc
IH
"}
(13,1,1) = {"
IH
IH
IH
xi
IH
IH
IH
xi
xi
xi
Pc
fd
Pc
Pc
Pc
Pc
fd
yW
fd
kQ
qL
kQ
LI
fe
fd
fe
fe
fd
fd
xi
xi
Pc
xi
IH
IH
IH
IH
"}
(14,1,1) = {"
IH
IH
xi
xi
IH
xi
xi
xi
NK
xi
Pc
Pc
fd
fd
fd
fd
XR
yW
tG
Pv
Pv
Pv
LI
AM
Pv
Pv
Pv
fd
Pc
Pc
iE
xi
xi
IH
Pc
IH
IH
"}
(15,1,1) = {"
IH
IH
IH
IH
IH
IH
xi
xi
xi
xi
xi
mE
Pc
Pc
Pc
On
fd
fd
HR
Pv
Pk
PJ
kE
Pv
LI
fd
db
Pv
fd
zN
xi
xi
xi
xi
xi
IH
IH
"}
(16,1,1) = {"
IH
IH
IH
IH
xi
xi
xi
Pc
Pc
xi
Pc
Pc
Pc
Pc
wi
fd
fd
jg
Pv
pB
cC
Pv
Pv
tG
Pv
mc
Dh
EU
fd
fd
xi
xi
Pc
Pc
IH
IH
IH
"}
(17,1,1) = {"
IH
IH
zN
IH
IH
IH
xi
xi
xi
fd
xi
uI
Pc
fd
lj
Pv
kQ
fd
Pv
bf
Pv
sk
Pv
Pv
Pv
gq
fd
fd
UV
fd
fd
xi
xi
xi
Pc
IH
IH
"}
(18,1,1) = {"
IH
IH
IH
IH
xi
IH
xi
xi
fd
Nf
fd
xi
Pc
qL
yu
Pv
tG
Tq
tG
jg
tG
Pv
JO
Pv
Pv
lg
Ss
fd
bx
Fg
fd
xi
xi
xi
Pc
IH
IH
"}
(19,1,1) = {"
IH
xi
IH
xi
xi
xi
xi
xi
fd
Nf
fd
xi
fd
fd
lj
Pv
kQ
fd
Pv
PJ
jJ
Pv
Pv
Pv
HR
EF
fd
EU
fd
Wp
fd
xi
fd
Pc
IH
Pc
IH
"}
(20,1,1) = {"
IH
IH
IH
xi
xi
NR
xi
xi
xi
fd
fd
fd
Pc
Pc
wi
fd
fd
fd
Pv
kE
Pv
Pv
Ma
Pv
Pv
AH
Ja
Pv
fd
vN
fd
fd
Pc
xi
IH
IH
IH
"}
(21,1,1) = {"
IH
IH
IH
IH
IH
IH
xi
xi
xi
Pc
Pc
Pc
Pc
Pc
Pc
zN
fd
jg
Pv
fd
Pk
tG
Jn
Pv
Pv
fd
Pv
sW
fd
fd
Pc
xi
xi
xi
xi
IH
IH
"}
(22,1,1) = {"
IH
IH
IH
IH
IH
xi
IH
xi
xi
Pc
xi
xi
Pc
Pc
Pc
Pc
fd
kQ
Pv
Pv
fd
Pv
fd
fd
HR
Pv
Pv
je
fd
Pc
Pv
Pc
IH
xi
xi
IH
IH
"}
(23,1,1) = {"
IH
xi
IH
IH
xi
IH
IH
xi
xi
xi
xi
Pc
zN
Pc
Pc
fd
Pc
kZ
fd
Pv
Zi
Yl
Pv
fd
fd
qL
fd
fd
Pc
Pc
xi
rQ
xi
Pv
xi
IH
IH
"}
(24,1,1) = {"
IH
IH
IH
IH
xi
IH
xi
xi
Pc
xi
xi
Pc
xi
Pc
fd
Pc
Pc
Pc
tG
Pv
fd
fd
Pv
fd
Pc
Pc
Pc
fd
xi
xi
Pc
IH
Pv
NR
xi
IH
IH
"}
(25,1,1) = {"
IH
IH
IH
IH
xi
xi
xi
xi
xi
xi
xi
Pc
xi
fd
Pc
Pc
xi
Pc
fd
HR
Pv
Pv
tG
nW
fd
Pc
Pc
Pc
fd
xi
Ij
IH
xi
xi
xi
IH
IH
"}
(26,1,1) = {"
IH
Wu
IH
IH
IH
xi
xi
xi
fd
xi
Pc
Pc
xi
fd
fd
xi
Pc
Pc
Pc
fd
fd
Pv
Pv
fd
Pc
Pc
xi
xi
fd
xi
Pc
IH
Pc
IH
xi
IH
IH
"}
(27,1,1) = {"
IH
IH
IH
xi
xi
IH
xi
fd
Fg
fd
Pv
Pc
Pv
fd
Ye
fd
xi
Cf
mE
tZ
Pc
fd
wi
Pc
Pc
fd
xi
Pc
fd
xi
xi
Pc
IH
IH
IH
IH
IH
"}
(28,1,1) = {"
IH
IH
IH
Pc
xi
xi
xi
xi
fd
xi
Pc
Pv
xi
xi
fd
xi
xi
xi
xi
xi
fd
Pc
Pc
Pc
xi
fd
xi
xi
fd
xi
xi
IH
IH
xi
xi
IH
IH
"}
(29,1,1) = {"
IH
IH
IH
xi
Pc
xi
xi
Pc
Pc
Pc
Pc
xi
Pc
xi
xi
xi
xi
fd
fd
fd
Pc
xi
tN
xi
xi
xi
fd
fd
xi
xi
xi
IH
IH
xi
xi
IH
IH
"}
(30,1,1) = {"
IH
IH
IH
xi
xi
xi
iJ
xi
xi
xi
xi
xi
xi
xi
xi
Pc
fd
xi
xi
xi
xi
xi
xi
On
xi
xi
Pc
xi
iE
xi
xi
IH
xi
IH
xi
IH
IH
"}
(31,1,1) = {"
IH
IH
IH
IH
IH
Pc
xi
IH
IH
xi
OR
xi
xi
xi
xi
Pc
xi
xi
xi
xi
Pc
xi
IH
IH
IH
IH
xi
xi
IH
xi
IH
IH
IH
IH
IH
IH
IH
"}
(32,1,1) = {"
IH
IH
IH
IH
Pc
IH
xi
IH
xi
xi
xi
xi
xi
Pc
xi
xi
xi
xi
xi
Pc
xi
xi
xi
xi
xi
OR
IH
IH
IH
xi
IH
xi
xi
IH
IH
IH
IH
"}
(33,1,1) = {"
IH
IH
xi
IH
Pc
xi
IH
Pc
xi
xi
xi
xi
xi
xi
xi
xi
xi
xi
xi
IH
xi
xi
IH
IH
IH
IH
IH
xi
xi
IH
xi
Pc
IH
IH
IH
IH
IH
"}
(34,1,1) = {"
IH
IH
IH
xi
xi
Pc
Pc
IH
IH
IH
xi
xi
Pc
xi
xi
IH
IH
IH
IH
IH
IH
IH
IH
IH
IH
xi
xi
IH
IH
IH
IH
IH
IH
xi
IH
IH
IH
"}
(35,1,1) = {"
IH
IH
xi
OR
xi
IH
IH
IH
IH
IH
IH
IH
IH
IH
IH
IH
xi
IH
IH
IH
xi
xi
xi
xi
IH
xi
xi
IH
IH
IH
IH
xi
IH
IH
IH
IH
IH
"}
(36,1,1) = {"
IH
IH
IH
xi
IH
IH
IH
IH
xi
IH
IH
IH
IH
IH
IH
IH
IH
IH
IH
IH
IH
IH
IH
IH
IH
IH
IH
IH
IH
IH
IH
IH
IH
IH
IH
IH
IH
"}
(37,1,1) = {"
IH
IH
IH
IH
IH
IH
IH
IH
IH
IH
IH
IH
IH
IH
IH
IH
IH
IH
IH
IH
Pc
IH
IH
IH
IH
IH
IH
IH
IH
IH
IH
IH
IH
IH
IH
IH
IH
"}
