//MAP CONVERTED BY dmm2tgm.py THIS HEADER COMMENT PREVENTS RECONVERSION, DO NOT REMOVE
"a" = (
/turf/simulated/floor/exoplanet/grass/grove,
/area/exoplanet/grass/grove)
"b" = (
/obj/structure/flora/ausbushes/sunnybush,
/turf/simulated/floor/exoplanet/grass/grove,
/area/exoplanet/grass/grove)
"h" = (
/turf/simulated/floor/exoplanet/grass/grovedirt,
/area/exoplanet/grass/grove)
"n" = (
/obj/structure/flora/ausbushes/ppflowers,
/turf/simulated/floor/exoplanet/grass/grovedirt,
/area/exoplanet/grass/grove)
"r" = (
/obj/structure/pit/closed/grave,
/obj/structure/gravemarker/random,
/obj/item/device/flashlight/lantern{
	on = 1
	},
/turf/simulated/floor/exoplanet/grass/grove,
/area/exoplanet/grass/grove)
"v" = (
/obj/structure/flora/ausbushes/ywflowers,
/turf/simulated/floor/exoplanet/grass/grove,
/area/exoplanet/grass/grove)
"w" = (
/obj/structure/flora/ausbushes/brflowers,
/turf/simulated/floor/exoplanet/grass/grove,
/area/exoplanet/grass/grove)
"y" = (
/obj/structure/flora/ausbushes/ppflowers,
/turf/simulated/floor/exoplanet/grass/grove,
/area/exoplanet/grass/grove)
"A" = (
/obj/structure/flora/bush/grove,
/turf/simulated/floor/exoplanet/grass/grove,
/area/exoplanet/grass/grove)
"C" = (
/obj/structure/noose,
/turf/simulated/floor/exoplanet/grass/grove,
/area/exoplanet/grass/grove)
"I" = (
/obj/effect/decal/remains/human/burned,
/obj/structure/flora/ausbushes/ppflowers,
/obj/item/clothing/head/poppy_crown{
	pixel_y = 5
	},
/turf/simulated/floor/exoplanet/grass/grove,
/area/exoplanet/grass/grove)
"L" = (
/obj/structure/flora/tree/jungle,
/obj/structure/flora/ausbushes/ppflowers,
/turf/simulated/floor/exoplanet/grass/grove,
/area/exoplanet/grass/grove)

(1,1,1) = {"
a
a
a
a
a
a
a
a
v
a
"}
(2,1,1) = {"
a
n
v
a
a
A
w
a
a
a
"}
(3,1,1) = {"
a
b
a
y
w
a
a
a
v
a
"}
(4,1,1) = {"
a
a
w
a
a
y
a
a
h
a
"}
(5,1,1) = {"
v
a
a
r
a
a
a
a
y
a
"}
(6,1,1) = {"
a
a
a
L
a
a
a
v
a
a
"}
(7,1,1) = {"
a
a
a
C
I
v
a
a
A
a
"}
(8,1,1) = {"
a
a
w
a
a
a
y
a
a
a
"}
(9,1,1) = {"
y
A
h
v
a
a
a
a
y
a
"}
(10,1,1) = {"
a
a
a
a
a
v
a
a
a
v
"}
