//MAP CONVERTED BY dmm2tgm.py THIS HEADER COMMENT PREVENTS RECONVERSION, DO NOT REMOVE
"a" = (
/obj/structure/flora/bush/grove{
	icon_state = "grove_bush4"
	},
/turf/simulated/floor/exoplanet/grass/grove,
/area/exoplanet/grass/grove)
"c" = (
/obj/structure/flora/bush/grove{
	icon_state = "grove_bush4"
	},
/turf/simulated/floor/exoplanet/grass/grovedirt,
/area/exoplanet/grass/grove)
"g" = (
/obj/structure/flora/tree/grove,
/turf/simulated/floor/exoplanet/grass/grove,
/area/exoplanet/grass/grove)
"h" = (
/turf/simulated/floor/exoplanet/grass/grovegravel,
/area/exoplanet/grass/grove)
"l" = (
/obj/structure/flora/ausbushes/stalkybush,
/obj/structure/flora/clutter,
/turf/simulated/floor/exoplanet/water/shallow,
/area/exoplanet/grass/grove)
"m" = (
/obj/structure/flora/ausbushes/stalkybush,
/turf/simulated/floor/exoplanet/water/shallow,
/area/exoplanet/grass/grove)
"o" = (
/turf/simulated/floor/exoplanet/water/shallow,
/area/exoplanet/grass/grove)
"q" = (
/obj/structure/flora/tree/grove{
	icon_state = "grove_tree6"
	},
/turf/simulated/floor/exoplanet/grass/grove,
/area/exoplanet/grass/grove)
"x" = (
/obj/structure/flora/bush/grove{
	icon_state = "grove_bush4"
	},
/turf/simulated/floor/exoplanet/grass/grovegravel,
/area/exoplanet/grass/grove)
"D" = (
/obj/structure/flora/tree/grove{
	icon_state = "grove_tree4"
	},
/turf/simulated/floor/exoplanet/grass/grove,
/area/exoplanet/grass/grove)
"F" = (
/turf/simulated/floor/exoplanet/grass/grovedirt,
/area/exoplanet/grass/grove)
"G" = (
/turf/simulated/floor/exoplanet/grass/grove,
/area/exoplanet/grass/grove)
"M" = (
/obj/structure/flora/ausbushes/grassybush,
/turf/simulated/floor/exoplanet/grass/grove,
/area/exoplanet/grass/grove)
"O" = (
/obj/structure/flora/ausbushes/stalkybush,
/turf/simulated/floor/exoplanet/grass/grovegravel,
/area/exoplanet/grass/grove)
"T" = (
/obj/structure/flora/bush/grove{
	icon_state = "grove_bush3"
	},
/turf/simulated/floor/exoplanet/grass/grovedirt,
/area/exoplanet/grass/grove)
"W" = (
/obj/structure/flora/clutter,
/turf/simulated/floor/exoplanet/grass/grovegravel,
/area/exoplanet/grass/grove)

(1,1,1) = {"
G
G
g
F
G
G
F
F
F
G
F
G
G
G
M
G
h
h
h
G
"}
(2,1,1) = {"
G
F
h
F
T
F
h
h
h
h
h
F
a
F
F
F
h
m
h
G
"}
(3,1,1) = {"
G
F
F
m
o
h
W
h
h
m
h
h
h
h
h
h
h
h
F
G
"}
(4,1,1) = {"
G
F
h
h
h
h
F
F
F
F
T
F
h
l
h
F
h
c
G
q
"}
(5,1,1) = {"
a
G
h
O
h
G
D
F
G
G
M
G
h
x
h
G
G
G
G
G
"}
