//MAP CONVERTED BY dmm2tgm.py THIS HEADER COMMENT PREVENTS RECONVERSION, DO NOT REMOVE
"j" = (
/turf/simulated/floor/airless/ceiling,
/area/template_noop)
"k" = (
/obj/effect/floor_decal/industrial/warning/dust,
/turf/simulated/floor/airless/ceiling,
/area/template_noop)
"l" = (
/obj/effect/landmark/clear,
/obj/effect/landmark/clear,
/obj/effect/landmark/clear,
/turf/template_noop,
/area/template_noop)
"o" = (
/turf/simulated/mineral,
/area/template_noop)
"r" = (
/obj/effect/landmark/clear,
/turf/template_noop,
/area/template_noop)
"s" = (
/mob/living/simple_animal/hostile/retaliate/minedrone,
/turf/simulated/floor/airless/ceiling,
/area/template_noop)
"t" = (
/obj/effect/floor_decal/industrial/warning/dust{
	dir = 8
	},
/mob/living/simple_animal/hostile/retaliate/minedrone,
/turf/simulated/floor/airless/ceiling,
/area/template_noop)
"u" = (
/obj/effect/floor_decal/industrial/warning/dust,
/obj/effect/floor_decal/industrial/loading/yellow,
/turf/simulated/floor/airless/ceiling,
/area/template_noop)
"v" = (
/obj/structure/ore_box,
/obj/effect/floor_decal/industrial/outline/yellow,
/turf/simulated/floor/airless/ceiling,
/area/template_noop)
"z" = (
/obj/effect/floor_decal/industrial/warning/dust,
/obj/item/storage/bag/ore,
/obj/structure/table/reinforced/steel,
/turf/simulated/floor/airless/ceiling,
/area/template_noop)
"A" = (
/obj/effect/landmark/clear,
/obj/effect/landmark/clear,
/turf/template_noop,
/area/template_noop)
"B" = (
/obj/structure/closet/crate,
/obj/item/ore/osmium,
/obj/item/ore/osmium,
/obj/item/ore/osmium,
/obj/item/ore/coal,
/obj/item/ore/coal,
/obj/item/ore/silver,
/obj/item/ore/silver,
/obj/item/ore/silver,
/obj/item/ore/silver,
/turf/simulated/floor/airless/ceiling,
/area/template_noop)
"C" = (
/obj/effect/floor_decal/industrial/warning/dust{
	dir = 10
	},
/turf/simulated/floor/airless/ceiling,
/area/template_noop)
"D" = (
/obj/effect/floor_decal/industrial/warning/dust{
	dir = 4
	},
/obj/item/clothing/accessory/storage/overalls/mining,
/obj/structure/table/reinforced/steel,
/turf/simulated/floor/airless/ceiling,
/area/template_noop)
"H" = (
/obj/effect/floor_decal/industrial/warning/dust{
	dir = 1
	},
/turf/simulated/floor/airless/ceiling,
/area/template_noop)
"L" = (
/obj/effect/floor_decal/industrial/warning/dust{
	dir = 9
	},
/turf/simulated/floor/airless/ceiling,
/area/template_noop)
"N" = (
/obj/effect/floor_decal/industrial/warning/dust{
	dir = 8
	},
/turf/simulated/floor/airless/ceiling,
/area/template_noop)
"O" = (
/obj/effect/floor_decal/industrial/warning/dust{
	dir = 4
	},
/turf/simulated/floor/airless/ceiling,
/area/template_noop)
"P" = (
/obj/effect/floor_decal/industrial/warning/dust{
	dir = 6
	},
/turf/simulated/floor/airless/ceiling,
/area/template_noop)
"R" = (
/obj/effect/floor_decal/industrial/warning/dust,
/obj/item/rfd/mining,
/obj/structure/table/reinforced/steel,
/turf/simulated/floor/airless/ceiling,
/area/template_noop)
"T" = (
/obj/effect/floor_decal/industrial/warning/dust{
	dir = 1
	},
/obj/item/device/flashlight/lantern,
/obj/structure/table/reinforced/steel,
/turf/simulated/floor/airless/ceiling,
/area/template_noop)
"U" = (
/obj/machinery/mech_recharger,
/obj/effect/floor_decal/industrial/outline/yellow,
/obj/structure/mech_wreckage/powerloader,
/turf/simulated/floor/airless/ceiling,
/area/template_noop)
"V" = (
/obj/machinery/mech_recharger,
/obj/effect/floor_decal/industrial/outline/yellow,
/turf/simulated/floor/airless/ceiling,
/area/template_noop)
"X" = (
/obj/effect/floor_decal/industrial/warning/dust{
	dir = 5
	},
/obj/item/pickaxe/jackhammer,
/obj/structure/table/reinforced/steel,
/turf/simulated/floor/airless/ceiling,
/area/template_noop)
"Y" = (
/obj/structure/closet/crate,
/obj/item/ore/diamond,
/obj/item/ore/diamond,
/obj/item/ore/diamond,
/turf/simulated/floor/airless/ceiling,
/area/template_noop)

(1,1,1) = {"
A
A
A
r
r
r
r
r
r
r
r
r
r
r
r
r
r
r
r
r
r
r
r
r
r
r
r
r
r
r
r
r
"}
(2,1,1) = {"
A
A
A
r
r
r
r
r
r
r
r
r
r
r
r
r
r
r
r
r
r
r
r
r
r
r
r
r
r
r
r
r
"}
(3,1,1) = {"
A
A
A
r
r
r
r
r
r
r
r
r
r
r
r
r
r
r
r
r
r
r
r
r
r
r
r
r
r
r
r
r
"}
(4,1,1) = {"
A
A
A
r
r
r
o
o
o
r
r
r
r
r
r
r
r
r
r
r
r
r
r
r
r
r
r
r
r
r
r
r
"}
(5,1,1) = {"
r
r
r
o
o
o
o
o
o
o
o
o
o
o
r
r
o
o
r
r
r
r
r
r
r
r
r
r
r
r
r
r
"}
(6,1,1) = {"
r
r
r
o
o
o
o
o
o
o
o
o
o
o
o
o
o
o
r
r
r
r
o
o
r
r
r
r
r
r
r
r
"}
(7,1,1) = {"
r
r
r
r
o
o
o
o
o
o
o
o
o
o
o
o
o
o
o
o
o
o
o
o
o
r
r
r
r
r
r
r
"}
(8,1,1) = {"
r
r
r
r
o
o
o
o
o
o
o
r
r
r
r
r
o
o
o
o
o
o
o
o
o
r
r
r
r
r
r
r
"}
(9,1,1) = {"
r
r
r
r
o
o
o
r
r
r
r
r
r
r
r
r
o
o
o
o
o
o
o
o
r
r
r
r
r
r
r
r
"}
(10,1,1) = {"
r
r
r
r
o
o
o
r
r
r
r
r
r
r
r
r
o
o
o
o
o
o
o
o
r
r
r
r
r
r
r
r
"}
(11,1,1) = {"
r
r
r
r
o
o
o
r
r
r
r
r
r
r
r
r
A
r
r
r
o
o
o
o
o
r
r
r
r
r
r
r
"}
(12,1,1) = {"
r
r
r
r
o
o
r
r
r
r
L
N
t
N
N
C
A
r
r
r
o
o
o
o
o
r
r
r
r
r
r
r
"}
(13,1,1) = {"
r
r
r
r
o
o
r
r
r
r
H
v
j
j
j
R
A
r
r
r
o
o
o
o
r
r
r
r
r
r
r
r
"}
(14,1,1) = {"
r
r
r
r
o
o
r
r
r
r
H
v
j
j
j
z
A
r
r
r
o
o
o
r
r
r
r
r
r
r
r
r
"}
(15,1,1) = {"
r
r
r
r
o
o
r
r
r
r
H
j
j
j
j
k
l
A
A
A
r
r
r
r
r
r
r
r
r
r
r
r
"}
(16,1,1) = {"
r
r
r
r
o
o
o
o
r
r
H
j
j
j
j
k
A
r
r
r
r
r
r
r
r
r
r
r
r
r
r
r
"}
(17,1,1) = {"
r
r
r
r
r
o
o
o
r
r
H
B
j
s
j
k
A
r
r
r
r
r
r
r
r
r
r
r
r
r
r
r
"}
(18,1,1) = {"
r
r
r
r
r
o
o
o
r
r
H
Y
j
j
j
k
A
r
r
r
r
r
r
r
r
r
r
r
r
r
r
r
"}
(19,1,1) = {"
r
r
r
r
r
o
o
o
r
r
H
j
j
j
j
k
r
r
r
r
r
r
r
r
r
r
r
r
r
r
r
r
"}
(20,1,1) = {"
r
r
r
r
A
o
o
o
r
r
H
j
j
j
U
u
r
r
r
r
r
r
r
r
r
r
r
r
r
r
r
r
"}
(21,1,1) = {"
r
r
r
r
o
o
o
o
o
r
T
j
s
j
V
u
r
r
r
r
r
r
r
r
r
r
r
r
r
r
r
r
"}
(22,1,1) = {"
r
r
r
o
o
o
o
o
o
r
X
D
O
O
O
P
r
r
r
r
r
r
r
r
r
r
r
r
r
r
r
r
"}
(23,1,1) = {"
r
r
r
o
o
o
o
o
o
A
r
r
r
r
r
r
r
r
r
r
r
r
r
r
r
r
r
r
r
r
r
r
"}
(24,1,1) = {"
r
r
r
o
o
o
o
o
o
A
r
r
r
r
r
r
r
r
r
r
r
r
r
r
r
r
r
r
r
r
r
r
"}
(25,1,1) = {"
r
r
r
o
o
o
o
o
o
A
r
r
r
r
r
r
r
r
r
r
r
r
r
r
r
r
r
r
r
r
r
r
"}
(26,1,1) = {"
r
r
r
o
o
o
o
o
o
o
o
o
o
r
r
o
o
o
o
o
o
o
o
o
r
r
r
r
r
r
r
r
"}
(27,1,1) = {"
r
r
r
o
o
o
o
o
o
o
o
o
o
o
o
o
o
o
o
o
o
o
o
r
r
r
r
r
r
r
r
r
"}
(28,1,1) = {"
r
r
A
r
r
r
o
o
o
o
o
o
o
o
o
o
o
o
o
r
r
r
r
r
r
r
r
r
r
r
r
r
"}
(29,1,1) = {"
r
r
A
r
r
r
o
o
o
r
r
r
r
r
r
r
r
r
r
r
r
r
r
r
r
r
r
r
r
r
r
r
"}
(30,1,1) = {"
r
r
A
r
r
r
r
r
r
r
r
r
r
r
r
r
r
r
r
r
r
r
r
A
r
r
r
r
r
r
r
r
"}
(31,1,1) = {"
r
r
A
r
r
r
r
r
r
r
r
r
r
r
r
r
r
r
r
r
r
r
r
A
r
r
r
r
r
r
r
r
"}
(32,1,1) = {"
r
r
A
r
r
r
r
r
r
r
r
r
r
r
r
r
r
r
r
r
r
r
r
A
r
r
r
r
r
r
r
r
"}
