"a" = (/turf/unsimulated/wall/riveted,/area/city/mendell)
"b" = (/turf/simulated/floor/wood,/area/city/mendell)
"f" = (/turf/simulated/floor/shuttle/black,/area/shuttle/city)
"g" = (/turf/unsimulated/wall/fakepdoor,/area/city/mendell)
"j" = (/obj/effect/floor_decal{desc = "The distant cityscape of Mendell City."; icon = 'icons/effects/1152x544.dmi'; icon_state = "cityscale_scrolling"; name = "Mendell City"},/turf/simulated/floor/plating{desc = "Mendell City at a distance."; name = "distant cityscape"},/area/city/mendell)
"k" = (/obj/machinery/computer/shuttle_control,/turf/simulated/floor/shuttle/black,/area/shuttle/city)
"l" = (/obj/effect/floor_decal/scc_full,/turf/simulated/floor/wood,/area/city/mendell)
"m" = (/obj/effect/map_effect/wingrille_spawn/reinforced/crescent,/turf/simulated/floor/shuttle/black,/area/shuttle/city)
"q" = (/obj/effect/floor_decal{desc = "The distant cityscape of Mendell City."; icon = 'icons/effects/1152x544.dmi'; icon_state = "cityscape_bg"; name = "Mendell City"},/turf/simulated/floor/plating{desc = "Mendell City at a distance."; name = "distant cityscape"},/area/city/mendell)
"r" = (/turf/unsimulated/wall/fakeairlock,/area/shuttle/city)
"t" = (/obj/item/clothing/suit/armor/carrier/heavy/scc,/obj/item/clothing/accessory/armband/scc,/obj/item/clothing/accessory/leg_guard/heavy/scc,/obj/item/clothing/accessory/arm_guard/heavy/scc,/obj/item/clothing/head/helmet/merc/scc,/turf/simulated/floor/wood,/area/city/mendell)
"v" = (/turf/simulated/floor/plating{desc = "Mendell City at a distance."; name = "distant cityscape"},/area/city/mendell)
"x" = (/turf/simulated/floor/plating,/area/city/mendell)
"C" = (/obj/effect/map_effect/wingrille_spawn/reinforced/crescent,/turf/simulated/floor/plating,/area/city/mendell)
"P" = (/turf/simulated/floor/shuttle/dark_blue,/area/shuttle/city)
"Q" = (/obj/effect/map_effect/wingrille_spawn/reinforced/crescent,/turf/simulated/floor/plating,/area/shuttle/city)
"W" = (/turf/simulated/floor/marble/dark,/area/city/mendell)
"Z" = (/turf/simulated/wall/shuttle/scc,/area/shuttle/city)

(1,1,1) = {"
aaaaaaaaaaaaaaaaaaaaaaaaaaaaaaaaaaaaaaaaaaaaaaaaaaaaaaaaaaaaaaaaaaaaaaaaaaaaaaaaaaaaaaaaaaaaaaaaaaaaaaaaaaaaaa
avvvvvvvvvvvvvvvvvvvvvvvvvvvvvvvvvvvvvvvvvvvvvvvvvvvvvvvvvvvvvvvvvvvvvvvvvvvvvvvvvvvvvvvvvvvvvvvvvvvvvvvvvvvva
avvvvvvvvvvvvvvvvvvvvvvvvvvvvvvvvvvvvvvvvvvvvvvvvvvvvvvvvvvvvvvvvvvvvvvvvvvvvvvvvvvvvvvvvvvvvvvvvvvvvvvvvvvvva
avvvvvvvvvvvvvvvvvvvvvvvvvvvvvvvvvvvvvvvvvvvvvvvvvvvvvvvvvvvvvvvvvvvvvvvvvvvvvvvvvvvvvvvvvvvvvvvvvvvvvvvvvvvva
avvvvvvvvvvvvvvvvvvvvvvvvvvvvvvvvvvvvvvvvvvvvvvvvvvvvvvvvvvvvvvvvvvvvvvvvvvvvvvvvvvvvvvvvvvvvvvvvvvvvvvvvvvvva
avvvvvvvvvvvvvvvvvvvvvvvvvvvvvvvvvvvvvvvvvvvvvvvvvvvvvvvvvvvvvvvvvvvvvvvvvvvvvvvvvvvvvvvvvvvvvvvvvvvvvvvvvvvva
avvvvvvvvvvvvvvvvvvvvvvvvvvvvvvvvvvvvvvvvvvvvvvvvvvvvvvvvvvvvvvvvvvvvvvvvvvvvvvvvvvvvvvvvvvvvvvvvvvvvvvvvvvvva
avvvvvvvvvvvvvvvvvvvvvvvvvvvvvvvvvvvvvvvvvvvvvvvvvvvvvvvvvvvvvvvvvvvvvvvvvvvvvvvvvvvvvvvvvvvvvvvvvvvvvvvvvvvva
avvvvvvvvvvvvvvvvvvvvvvvvvvvvvvvvvvvvvvvvvvvvvvvvvvvvvvvvvvvvvvvvvvvvvvvvvvvvvvvvvvvvvvvvvvvvvvvvvvvvvvvvvvvva
avvvvvvvvvvvvvvvvvvvvvvvvvvvvvvvvvvvvvvvvvvvvvvvvvvvvvvvvvvvvvvvvvvvvvvvvvvvvvvvvvvvvvvvvvvvvvvvvvvvvvvvvvvvva
avvvvvvvvvvvvvvvvvvvvvvvvvvvvvvvvvvvvvvvvvvvvvvvvvvvvvvvvvvvvvvvvvvvvvvvvvvvvvvvvvvvvvvvvvvvvvvvvvvvvvvvvvvvva
avvvvvvvvvvvvvvvvvvvvvvvvvvvvvvvvvvvvvvvvvvvvvvvvvvvvvvvvvvvvvvvvvvvvvvvvvvvvvvvvvvvvvvvvvvvvvvvvvvvvvvvvvvvva
avvvvvvvvvvvvvvvvvvvvvvvvvvvvvvvvvvvvvvvvvvvvvvvvvvvvvvvvvvvvvvvvvvvvvvvvvvvvvvvvvvvvvvvvvvvvvvvvvvvvvvvvvvvva
avvvvvvvvvvvvvvvvvvvvvvvvvvvvvvvvvvvvvvvvvvvvvvvvvvvvvvvvvvvvvvvvvvvvvvvvvvvvvvvvvvvvvvvvvvvvvvvvvvvvvvvvvvvva
avvvvvvvvvvvvvvvvvvvvvvvvvvvvvvvvvvvvvvvvvvvvvvvvvvvvvvvvvvvvvvvvvvvvvvvvvvvvvvvvvvvvvvvvvvvvvvvvvvvvvvvvvvvva
avvvvvvvvvvvvvvvvvvvvvvvvvvvvvvvvvvvvvvvvvvvvvvvvvvvvvvvvvvvvvvvvvvvvvvvvvvvvvvvvvvvvvvvvvvvvvvvvvvvvvvvvvvvva
avvvvvvvvvvvvvvvvvvvvvvvvvvvvvvvvvvvvvvvvvvvvvvvvvvvvvvvvvvvvvvvvvvvvvvvvvvvvvvvvvvvvvvvvvvvvvvvvvvvvvvvvvvvva
aqvvvvvvvvvvvvvvvvvvvvvvvvvvvvvvvvvvvqvvvvvvvvvvvvvvvvvvvvvvvvvvvvvvvvvvvqvvvvvvvvvvvvvvvvvvvvvvvvvvvvvvvvvvva
aaaaaaaaaaaWWWWWWWWWWWWWWWWWWWWWWWWWWWWWWWWWWWWWWWWWWWWWWWWWWWWWWWWWWWWWWWWWWWWWWWWWWWWWWWWWWWWWWWaaaaaaaaaaaa
aaaaaaaaaaaWWWWWWWWWWWWWWWWWWWWWWWWWWWWWWWWWWWWWWWWWWWWWWWWWWWWWWWWWWWWWWWWWWWWWWWWWWWWWWWWWWWWWWWaaaaaaaaaaaa
aaaaaaaaaaaWWWWWWWWWWWWWWWWWWWWWWWWWWWWWWWWWWWWWWWWWWWWWWWWWWWWWWWWWWWWWWWWWWWWWWWWWWWWWWWWWWWWWWWaaaaaaaaaaaa
aaaaaaaaaaaWWWWWWWWWWWWWWWWWWWWWWWWWWWWWWWWWWWWWWWWWWWWWWWWWWWWWWWWWWWWWWWWWWWWWWWWWWWWWWWWWWWWWWWaaaaaaaaaaaa
aaaaaaaaaaaWWWWWWWWWWWWWWWWWWWWWWWWWWWWWWWWWWWWWWWWWWWWWWWWWWWWWWWWWWWWWWWWWWWWWWWWWWWWWWWWWWWWWWWaaaaaaaaaaaa
aaaaaaaaaaaWWWWWWWWWWWWWWWWWWWWWWWWWWWWWWWWWWWWWWWWWWWWWWWWWWWWWWWWWWWWWWWWWWWWWWWWWWWWWWWWWWWWWWWaaaaaaaaaaaa
aaaaaaaaaaaWWWWWWWWWWWWWWWWWWWWWWWWWWWWWWWWWWWWWWWWWWWWWWWWWWWWWWWWWWWWWWWWWWWWWWWWWWWWWWWWWWWWWWWaaaaaaaaaaaa
aaaaaaaaaaaWWWWWWWWWWWWWWWWWWWWWWWWWWWWWWWWWWWWWWWWWWWWWWWWWWWWWWWWWWWWWWWWWWWWWWWWWWWWWWWWWWWWWWWaaaaaaaaaaaa
aaaaaaaaaaaWWWWWWWWWWWWWWWWWWWWWWWWWWWWWWWWWWWWWWWWWWWWWWWWWWWWWWWWWWWWWWWWWWWWWWWWWWWWWWWWWWWWWWWaaaaaaaaaaaa
aaaaaaaaaaaWWWWWWWWWWWWWWWWWWWWWWWWWWWWWWWWWWWWWWWWWWWWWWWWWWWWWWWWWWWWWWWWWWWWWWWWWWWWWWWWWWWWWWWaaaaaaaaaaaa
aaaaaaaaaaaWWWWWWWWWWWWWWWWWWWWWWWWWWWWWWWWWWWWWWWWWWWWWWWWWWWWWWWWWWWWWWWWWWWWWWWWWWWWWWWWWWWWWWWaaaaaaaaaaaa
aaaaaaaaaaaWWWWWWWWWWWWWWWWWWWWWWWWWWWWWWWWWWWWWWWWWWWWWWWWWWWWWWWWWWWWWWWWWWWWWWWWWWWWWWWWWWWWWWWaaaaaaaaaaaa
aaaaaaaaaaaWWWWWWWWWWWWWWWWWWWWWWWWWWWWWWWWWWWWWWWWWWWWWWWWWWWWWWWWWWWWWWWWWWWWWWWWWWWWWWWWWWWWWWWaaaaaaaaaaaa
aaaaaaaaaaaWWWWWWWWWWWWWWWWWWWWWWWWWWWWWWWWWWWWWWWWWWWWWWWWWWWWWWWWWWWWWWWWWWWWWWWWWWWWWWWWWWWWWWWaaaaaaaaaaaa
aaaaaaaaaaaWWWWWWWWWWWWWWWWWWWWWWWWWWWWWWWWWWWWWWWWWWWWWWWWWWWWWWWWWWWWWWWWWWWWWWWWWWWWWWWWWWWWWWWaaaaaaaaaaaa
aaaaaaaaaaaaaaaaaaaaaaaaaaaaaaaaaaaaaaaaaaaaaaaaaaaaaaaaaaaaaaaaaaaaaaaaaaaaaaaaaaaaaaaaaaaaaaaaaaaaaaaaaaaaaa
aavvvvvvvvvvvvvvvvvvvvvvvvvvvvvvvvvvvvaaaaaaaaaaaaaaaaaaaaaaaaaaaaaaaaaaavvvvvvvvvvvvvvvvvvvvvvvvvvvvvvvvvvvva
aavvvvvvvvvvvvvvvvvvvvvvvvvvvvvvvvvvvvaaaaaaaaaaaaaaaaaaaaaaaaaaaaaaaaaaavvvvvvvvvvvvvvvvvvvvvvvvvvvvvvvvvvvva
aavvvvvvvvvvvvvvvvvvvvvvvvvvvvvvvvvvvvaaaaaaaaaaaaaaaaaaaaaaaaaaaaaaaaaaavvvvvvvvvvvvvvvvvvvvvvvvvvvvvvvvvvvva
aavvvvvvvvvvvvvvvvvvvvvvvvvvvvvvvvvvvvaaaabbbbbbbbbbbbbbbbbbbbbbbbbbbaaaavvvvvvvvvvvvvvvvvvvvvvvvvvvvvvvvvvvva
aavvvvvvvvvvvvvvvvvvvvvvvvvvvvvvvvvvvvaaaabbbbbbbbbbbbbbbbbbbbbbbbbbbaaaavvvvvvvvvvvvvvvvvvvvvvvvvvvvvvvvvvvva
aavvvvvvvvvvvvvvvvvvvvvvvvvvvvvvvvvvvvaaaabbbbbbbbbbbbbbbbbbbbbbbbbbbaaaavvvvvvvvvvvvvvvvvvvvvvvvvvvvvvvvvvvva
aavvvvvvvvvvvvvvvvvvvvvvvvvvvvvvvvvvvvaaaabbbbbbbbbbbbbbbbbbbbbbbbbbbaaaavvvvvvvvvvvvvvvvvvvvvvvvvvvvvvvvvvvva
aavvvvvvvvvvvvvvvvvvvvvvvvvvvvvvvvvvvvaaaabbbbbbbbbbbbbbbbbbbbbbbbbbbaaaavvvvvvvvvvvvvvvvvvvvvvvvvvvvvvvvvvvva
aavvvvvvvvvvvvvvvvvvvvvvvvvvvvvvvvvvvvaaaabbbbbbbbbbbbbbbbbbbbbbbbbbbaaaavvvvvvvvvvvvvvvvvvvvvvvvvvvvvvvvvvvva
aavvvvvvvvvvvvvvvvvvvvvvvvvvvvvvvvvvvvaaaabbbbbbbbbbbbbbbbbbbbbbbbbbbaaaavvvvvvvvvvvvvvvvvvvvvvvvvvvvvvvvvvvva
aavvvvvvvvvvvvvvvvvvvvvvvvvvvvvvvvvvvvaaaabbbbbbbbbbbbbbbbbbbbbbbbbbbaaaavvvvvvvvvvvvvvvvvvvvvvvvvvvvvvvvvvvva
aavvvvvvvvvvvvvvvvvvvvvvvvvvvvvvvvvvvvaaaabbbbbbbbbbbbbbbbbbbbbbbbbbbaaaavvvvvvvvvvvvvvvvvvvvvvvvvvvvvvvvvvvva
aavvvvvvvvvvvvvvvvvvvvvvvvvvvvvvvvvvvvaaaabbbbbbbbbbbbbbbbbbbbbbbbbbbaaaavvvvvvvvvvvvvvvvvvvvvvvvvvvvvvvvvvvva
aavvvvvvvvvvvvvvvvvvvvvvvvvvvvvvvvvvvvaaaabbbbbbbbbbbbbbbbbbbbbbbbbbbaaaavvvvvvvvvvvvvvvvvvvvvvvvvvvvvvvvvvvva
aavvvvvvvvvvvvvvvvvvvvvvvvvvvvvvvvvvvvaaaabbbbbbbbbbbbbbbbbbbbbbbbbbbaaaavvvvvvvvvvvvvvvvvvvvvvvvvvvvvvvvvvvva
aavvvvvvvvvvvvvvvvvvvvvvvvvvvvvvvvvvvvaaaabbbbbbbbbbbbbbbbbbbbbbbbbbbaaaavvvvvvvvvvvvvvvvvvvvvvvvvvvvvvvvvvvva
aaqvvvvvvvvvvvvvvvvvvvvvvvvvvvvvvvvvvvaaaabbbbbbbbbbbbbbbbbbbbbbbbbbbaaaajvvvvvvvvvvvvvvvvvvvvvvvvvvvvvvvvvvva
aaaaaaaaaaaaaaaaaaaaaaxxxxxaaaaaaaaaaaaaaabbbbbbbbbbbbbbbbbbbbbbbbbbbaaaaxxxxxxxxxxxxxxxxxxxxxxxxxxxxxxxxxxxxa
agxxxxxxxxxxxxxxxxxxatbbbbbbabbbbbbbbbbbbbbbbbbbbbbbbbbbbbbbbbbbbbbbbaaaaxxxxxxxxxxxxxxxxxxxxxxxxxxxxxxxxxxxxa
agZQQZQQQZQQQZQQQZZxabbbbbbbabbbbbbbbbbbbbbbbbbbbbbbbbbbbbbbbbbbbbbbbaaaaxxxxxxxxxxxxxxxxxxxxxxxxxxxxxxxxxxxxa
agZfkZfffZfffZffffZxabbbbbbbabbbbbbbbbbbbbbbbbbbbbbbbbbbbbbbbbbbbbbbbaaaaxxxxxxxxxxxxxxxxxxxxxxxxxxxxxxxxxxxxa
agZffZfffZfffZffffZxabbbbbbbabbbbbbbbbbbbbbbbbbbbbbbbbbbbbbbbbbbbbbbbaaaaxxxxxxxxxxxxxxxxxxxxxxxxxxxxxxxxxxxxa
agZrZZfffZfffZffffZxablbbbbbabbbbbbbbbbbbbbbbbbbbbbbbbbbbbbbbbbbbbbbbaaaaxxxxxxxxxxxxxxxxxxxxxxxxxxxxxxxxxxxxa
agZffmfffQfffQffffZxabbbbbbbabbbbbbbbbbbbbbbbbbbbbbbbbbbbbbbbbbbbbbbbaaaaxxxxxxxxxxxxxxxxxxxxxxxxxxxxxxxxxxxxa
agZffmfffQfffQffffZCaaababaaabbbbbbbbbbbbbbbbbbbbbbbbbbbbbbbbbbbbbbbbaaaaxxxxxxxxxxxxxxxxxxxxxxxxxxxxxxxxxxxxa
agrPPPPPPPPPPPPPPPPxbbbbbbbbbbbbbbbbbbbbbbbbbbbbbbbbbbbbbbbbbbbbbbbbbaaaaxxxxxxxxxxxxxxxxxxxxxxxxxxxxxxxxxxxxa
agrPPPPPPPPPPPPPPPPxbbbbbbbbbbbbbbbbbbbbbbbbbbbbbbbbbbbbbbbbbbbbbbbbbaaaaxxxxxxxxxxxxxxxxxxxxxxxxxxxxxxxxxxxxa
agZPPPPPPPPPPPPPPPPxbbbbbbbbbbbbbbbbbbbbbbbbbbbbbbbbbbbbbbbbbbbbbbbbbaaaaxxxxxxxxxxxxxxxxxxxxxxxxxxxxxxxxxxxxa
agZZZZZZZZZZZZZZZZZCabbbbbbbbbbbbbbbbbbbbbbbbbbbbbbbbbbbbbbbbbbbbbbbbaaaaxxxxxxxxxxxxxxxxxxxxxxxxxxxxxxxxxxxxa
agxxxxxxxxxxxxxxxxxxabbbbbbbbbbbbbbbbbbbbbbbbbbbbbbbbbbbbbbbbbbbbbbbbaaaaxxxxxxxxxxxxxxxxxxxxxxxxxxxxxxxxxxxxa
aaaaaaaaaaaaaaaaaaaaaaaaaaaaaaaaaaaaaaaaaaaaaaaaaaaaaaaaaaaaaaaaaaaaaaaaaaaaaaaaaaaaaaaaaaaaaaaaaaaaaaaaaaaaaa
"}
