//MAP CONVERTED BY dmm2tgm.py THIS HEADER COMMENT PREVENTS RECONVERSION, DO NOT REMOVE
"ac" = (
/obj/structure/window/reinforced{
	dir = 4
	},
/obj/structure/window/reinforced,
/obj/structure/computerframe,
/turf/simulated/floor/shuttle/dark_blue/airless,
/area/crashed_sol_shuttle_01/main)
"aK" = (
/obj/structure/closet/secure_closet/engineering_electrical{
	req_access = null
	},
/obj/effect/decal/cleanable/dirt,
/turf/simulated/floor/shuttle/dark_blue/airless,
/area/crashed_sol_shuttle_01/main)
"bj" = (
/obj/structure/bed/stool/chair/office/bridge/generic{
	dir = 4
	},
/turf/simulated/floor/shuttle/dark_blue/airless,
/area/crashed_sol_shuttle_01/main)
"dB" = (
/turf/simulated/wall/shuttle/dark/cardinal,
/area/crashed_sol_shuttle_01/main)
"dO" = (
/obj/structure/window/reinforced,
/obj/structure/bed/stool/chair/office/bridge{
	dir = 4
	},
/turf/simulated/floor/shuttle/dark_blue/airless,
/area/crashed_sol_shuttle_01/main)
"dX" = (
/obj/machinery/fabricator/autolathe,
/obj/machinery/light/colored/red{
	dir = 8
	},
/turf/simulated/floor/shuttle/dark_blue/airless,
/area/crashed_sol_shuttle_01/main)
"fo" = (
/obj/structure/closet/walllocker/emerglocker,
/turf/simulated/wall/shuttle/dark/cardinal,
/area/crashed_sol_shuttle_01/armory)
"fT" = (
/obj/machinery/light/colored/red,
/obj/effect/decal/cleanable/dirt,
/turf/simulated/floor/shuttle/dark_blue/airless,
/area/crashed_sol_shuttle_01/main)
"fW" = (
/obj/structure/window/reinforced{
	dir = 1
	},
/obj/random/junk,
/turf/simulated/floor/shuttle/dark_blue/airless,
/area/crashed_sol_shuttle_01/main)
"ga" = (
/obj/structure/window/reinforced{
	dir = 8
	},
/obj/structure/window/reinforced{
	dir = 1
	},
/obj/structure/computerframe,
/turf/simulated/floor/shuttle/dark_blue/airless,
/area/crashed_sol_shuttle_01/main)
"hk" = (
/obj/structure/grille,
/obj/structure/window/reinforced{
	dir = 1
	},
/obj/structure/window/reinforced{
	dir = 4
	},
/obj/structure/window/reinforced,
/turf/simulated/floor/airless,
/area/crashed_sol_shuttle_01/main)
"hT" = (
/obj/effect/decal/cleanable/blood,
/turf/simulated/floor/shuttle/dark_blue/airless,
/area/crashed_sol_shuttle_01/main)
"il" = (
/obj/structure/window/reinforced{
	dir = 1
	},
/obj/structure/window/reinforced{
	dir = 4
	},
/obj/structure/computerframe,
/turf/simulated/floor/shuttle/dark_blue/airless,
/area/crashed_sol_shuttle_01/main)
"iB" = (
/obj/structure/sign/directions/medical{
	dir = 8;
	pixel_y = 4
	},
/obj/structure/sign/directions/engineering{
	dir = 8;
	pixel_y = -4
	},
/turf/simulated/wall/shuttle/dark/cardinal,
/area/crashed_sol_shuttle_01/main)
"jj" = (
/obj/structure/window/reinforced,
/obj/structure/bed/stool/chair/office/bridge,
/turf/simulated/floor/shuttle/dark_blue/airless,
/area/crashed_sol_shuttle_01/main)
"jt" = (
/obj/structure/closet/crate/secure/loot,
/obj/effect/decal/cleanable/dirt,
/turf/simulated/floor/shuttle/dark_blue/airless,
/area/crashed_sol_shuttle_01/main)
"kr" = (
/obj/structure/sign/directions/security{
	dir = 4;
	pixel_y = 4
	},
/obj/structure/sign/directions/civ{
	dir = 4;
	pixel_y = -4
	},
/turf/simulated/wall/shuttle/dark/cardinal,
/area/crashed_sol_shuttle_01/main)
"lc" = (
/obj/structure/closet/walllocker/emerglocker,
/turf/simulated/wall/shuttle/dark/cardinal,
/area/crashed_sol_shuttle_01/main)
"lG" = (
/obj/structure/window/reinforced{
	dir = 1
	},
/obj/structure/window/reinforced{
	dir = 8
	},
/obj/structure/computerframe,
/turf/simulated/floor/shuttle/dark_blue/airless,
/area/crashed_sol_shuttle_01/main)
"mi" = (
/obj/structure/sign/securearea,
/turf/simulated/wall/shuttle/dark/cardinal,
/area/crashed_sol_shuttle_01/main)
"mD" = (
/obj/structure/bed/stool/chair/office/bridge/pilot{
	dir = 8
	},
/obj/effect/decal/cleanable/dirt,
/turf/simulated/floor/shuttle/dark_blue/airless,
/area/crashed_sol_shuttle_01/main)
"oz" = (
/obj/machinery/door/airlock/highsecurity{
	req_access = list(150);
	dir = 1
	},
/turf/simulated/floor/shuttle/black,
/area/crashed_sol_shuttle_01/armory)
"qD" = (
/obj/structure/extinguisher_cabinet,
/turf/simulated/wall/shuttle/dark/cardinal,
/area/crashed_sol_shuttle_01/main)
"qH" = (
/obj/structure/window/reinforced{
	dir = 8
	},
/obj/structure/window/reinforced,
/obj/structure/computerframe,
/turf/simulated/floor/shuttle/dark_blue/airless,
/area/crashed_sol_shuttle_01/main)
"qQ" = (
/obj/machinery/door/window{
	dir = 1
	},
/obj/effect/decal/cleanable/blood,
/obj/effect/decal/cleanable/dirt,
/turf/simulated/floor/shuttle/dark_blue/airless,
/area/crashed_sol_shuttle_01/main)
"qV" = (
/obj/machinery/door/airlock/hatch{
	dir = 1
	},
/obj/effect/decal/cleanable/dirt,
/turf/simulated/floor/shuttle/dark_blue/airless,
/area/crashed_sol_shuttle_01/main)
"rf" = (
/obj/random/powercell,
/obj/effect/decal/cleanable/blood/oil,
/turf/simulated/floor/shuttle/dark_blue/airless,
/area/crashed_sol_shuttle_01/main)
"rA" = (
/obj/effect/decal/cleanable/cobweb,
/obj/structure/computerframe,
/obj/effect/decal/cleanable/dirt,
/turf/simulated/floor/shuttle/dark_blue/airless,
/area/crashed_sol_shuttle_01/main)
"rK" = (
/obj/structure/closet/sol/navy,
/obj/effect/decal/cleanable/dirt,
/turf/simulated/floor/shuttle/black,
/area/crashed_sol_shuttle_01/armory)
"sa" = (
/obj/random/toolbox,
/obj/effect/decal/cleanable/dirt,
/turf/simulated/floor/shuttle/dark_blue/airless,
/area/crashed_sol_shuttle_01/main)
"su" = (
/obj/structure/computerframe,
/obj/effect/decal/cleanable/dirt,
/turf/simulated/floor/shuttle/dark_blue/airless,
/area/crashed_sol_shuttle_01/main)
"sK" = (
/obj/structure/grille/broken,
/obj/structure/window/reinforced,
/obj/item/material/shard,
/turf/simulated/floor/airless,
/area/crashed_sol_shuttle_01/main)
"tC" = (
/obj/structure/mech_wreckage,
/obj/machinery/mech_recharger,
/obj/effect/floor_decal/industrial/warning/full,
/turf/simulated/floor/shuttle/dark_blue/airless,
/area/crashed_sol_shuttle_01/main)
"tD" = (
/obj/structure/bed/stool/chair/office/bridge/pilot{
	dir = 4
	},
/obj/item/clothing/accessory/sol_pin,
/obj/effect/decal/cleanable/dirt,
/turf/simulated/floor/shuttle/dark_blue/airless,
/area/crashed_sol_shuttle_01/main)
"uf" = (
/obj/structure/extinguisher_cabinet{
	dir = 8
	},
/turf/simulated/wall/shuttle/dark/cardinal,
/area/crashed_sol_shuttle_01/main)
"vf" = (
/obj/effect/floor_decal/industrial/warning,
/obj/effect/decal/cleanable/dirt,
/turf/simulated/floor/shuttle/dark_blue/airless,
/area/crashed_sol_shuttle_01/main)
"vQ" = (
/turf/simulated/floor/airless,
/area/crashed_sol_shuttle_01/main)
"wb" = (
/obj/machinery/light/colored/red{
	dir = 1
	},
/obj/effect/decal/cleanable/dirt,
/turf/simulated/floor/shuttle/dark_blue/airless,
/area/crashed_sol_shuttle_01/main)
"wR" = (
/obj/effect/decal/cleanable/dirt,
/obj/effect/floor_decal/industrial/warning{
	dir = 1
	},
/turf/simulated/floor/shuttle/dark_blue/airless,
/area/crashed_sol_shuttle_01/main)
"wV" = (
/obj/structure/table/rack,
/obj/random/tool,
/obj/random/voidsuit/no_nanotrasen,
/turf/simulated/floor/shuttle/dark_blue/airless,
/area/crashed_sol_shuttle_01/main)
"xv" = (
/obj/structure/window/reinforced{
	dir = 1
	},
/turf/simulated/floor/shuttle/dark_blue/airless,
/area/crashed_sol_shuttle_01/main)
"yk" = (
/obj/structure/sign/directions/com{
	dir = 1
	},
/turf/simulated/wall/shuttle/dark/cardinal,
/area/crashed_sol_shuttle_01/main)
"yr" = (
/obj/effect/decal/cleanable/dirt,
/obj/effect/floor_decal/asteroid,
/turf/simulated/floor/shuttle/dark_blue/airless,
/area/crashed_sol_shuttle_01/main)
"yX" = (
/obj/structure/window/reinforced,
/obj/structure/window/reinforced{
	dir = 4
	},
/obj/structure/computerframe,
/turf/simulated/floor/shuttle/dark_blue/airless,
/area/crashed_sol_shuttle_01/main)
"zm" = (
/obj/structure/railing/mapped{
	dir = 8
	},
/turf/simulated/floor/tiled/ramp/airless,
/area/crashed_sol_shuttle_01/main)
"zJ" = (
/obj/effect/landmark/clear,
/turf/template_noop,
/area/crashed_sol_shuttle_01/main)
"Ah" = (
/obj/effect/decal/cleanable/dirt,
/obj/effect/floor_decal/industrial/warning/full,
/obj/machinery/porta_turret/net,
/turf/simulated/floor/shuttle/black,
/area/crashed_sol_shuttle_01/armory)
"Ak" = (
/obj/effect/decal/cleanable/dirt,
/obj/structure/table/rack,
/obj/item/stack/material/steel{
	amount = 50;
	pixel_x = -2
	},
/obj/item/stack/material/glass/full,
/obj/item/material/shard,
/turf/simulated/floor/shuttle/dark_blue/airless,
/area/crashed_sol_shuttle_01/main)
"BJ" = (
/obj/effect/decal/cleanable/blood,
/obj/effect/decal/cleanable/dirt,
/turf/simulated/floor/shuttle/dark_blue/airless,
/area/crashed_sol_shuttle_01/main)
"Ck" = (
/obj/effect/floor_decal/asteroid,
/turf/template_noop,
/area/template_noop)
"DB" = (
/obj/machinery/door/airlock/hatch{
	dir = 1
	},
/turf/simulated/floor/shuttle/dark_blue/airless,
/area/crashed_sol_shuttle_01/main)
"Ex" = (
/obj/structure/sign/flag/sol,
/turf/simulated/wall/shuttle/dark/cardinal,
/area/crashed_sol_shuttle_01/main)
"GJ" = (
/obj/structure/window/reinforced{
	dir = 1
	},
/obj/structure/table/reinforced/steel,
/obj/item/gun/projectile/pistol/sol,
/turf/simulated/floor/shuttle/dark_blue/airless,
/area/crashed_sol_shuttle_01/main)
"Hv" = (
/obj/effect/decal/cleanable/dirt,
/turf/template_noop,
/area/template_noop)
"HL" = (
/turf/simulated/wall/shuttle/dark/cardinal,
/area/crashed_sol_shuttle_01/armory)
"Iw" = (
/turf/simulated/floor/shuttle/dark_blue/airless,
/area/crashed_sol_shuttle_01/main)
"II" = (
/obj/structure/window/reinforced{
	dir = 1
	},
/obj/structure/table/reinforced/steel,
/obj/item/paper/crumpled/bloody,
/turf/simulated/floor/shuttle/dark_blue/airless,
/area/crashed_sol_shuttle_01/main)
"JP" = (
/obj/structure/railing/mapped{
	dir = 4
	},
/turf/simulated/floor/tiled/ramp/airless,
/area/crashed_sol_shuttle_01/main)
"Lc" = (
/obj/structure/computerframe,
/obj/effect/decal/cleanable/dirt,
/obj/item/material/shard,
/turf/simulated/floor/shuttle/dark_blue/airless,
/area/crashed_sol_shuttle_01/main)
"Mx" = (
/obj/structure/window/reinforced{
	dir = 1
	},
/obj/structure/table/reinforced/steel,
/obj/item/stamp/sol{
	pixel_x = -4;
	pixel_y = 2
	},
/turf/simulated/floor/shuttle/dark_blue/airless,
/area/crashed_sol_shuttle_01/main)
"Oi" = (
/obj/structure/window/reinforced{
	dir = 4
	},
/obj/structure/window/reinforced{
	dir = 1
	},
/obj/structure/computerframe,
/turf/simulated/floor/shuttle/dark_blue/airless,
/area/crashed_sol_shuttle_01/main)
"Oz" = (
/obj/effect/landmark/clear,
/turf/template_noop,
/area/template_noop)
"QY" = (
/obj/structure/window/reinforced{
	dir = 1
	},
/obj/structure/table/reinforced/steel,
/obj/item/clothing/head/sol/dress/officer,
/turf/simulated/floor/shuttle/dark_blue/airless,
/area/crashed_sol_shuttle_01/main)
"Rg" = (
/obj/structure/computerframe,
/turf/simulated/floor/shuttle/dark_blue/airless,
/area/crashed_sol_shuttle_01/main)
"Sc" = (
/obj/structure/closet/secure_closet/engineering_welding{
	req_access = null
	},
/turf/simulated/floor/shuttle/dark_blue/airless,
/area/crashed_sol_shuttle_01/main)
"Tj" = (
/obj/effect/decal/cleanable/dirt,
/turf/simulated/floor/shuttle/black,
/area/crashed_sol_shuttle_01/armory)
"Tp" = (
/obj/effect/decal/cleanable/dirt,
/obj/effect/decal/cleanable/dirt,
/turf/simulated/floor/shuttle/dark_blue/airless,
/area/crashed_sol_shuttle_01/main)
"TT" = (
/obj/structure/window/reinforced,
/obj/structure/window/reinforced{
	dir = 8
	},
/obj/structure/computerframe,
/turf/simulated/floor/shuttle/dark_blue/airless,
/area/crashed_sol_shuttle_01/main)
"Ut" = (
/obj/structure/table/reinforced/steel,
/obj/structure/window/reinforced{
	dir = 8
	},
/obj/structure/window/reinforced{
	dir = 1
	},
/obj/machinery/door/window{
	dir = 4;
	req_access = list(150)
	},
/obj/item/clothing/suit/space/void/sol,
/obj/item/clothing/head/helmet/space/void/sol,
/turf/simulated/floor/shuttle/black,
/area/crashed_sol_shuttle_01/armory)
"Uz" = (
/obj/item/material/shard,
/turf/simulated/floor/shuttle/dark_blue/airless,
/area/crashed_sol_shuttle_01/main)
"UF" = (
/obj/effect/decal/cleanable/dirt,
/turf/simulated/floor/shuttle/dark_blue/airless,
/area/crashed_sol_shuttle_01/main)
"VP" = (
/turf/template_noop,
/area/template_noop)
"Xs" = (
/obj/structure/table/reinforced/steel,
/obj/structure/window/reinforced{
	dir = 8
	},
/obj/structure/window/reinforced,
/obj/machinery/door/window{
	dir = 4;
	req_access = list(150)
	},
/obj/item/clothing/accessory/storage/bayonet,
/turf/simulated/floor/shuttle/black,
/area/crashed_sol_shuttle_01/armory)
"XI" = (
/obj/structure/bed/stool/chair/office/bridge/generic,
/obj/effect/decal/cleanable/dirt,
/obj/item/clothing/under/rank/sol,
/turf/simulated/floor/shuttle/dark_blue/airless,
/area/crashed_sol_shuttle_01/main)
"Yb" = (
/obj/effect/floor_decal/industrial/warning/full,
/obj/structure/railing/mapped,
/obj/machinery/porta_turret_construct/dark,
/turf/simulated/floor/shuttle/dark_blue/airless,
/area/crashed_sol_shuttle_01/main)
"Zd" = (
/obj/machinery/light/colored/red,
/turf/simulated/floor/shuttle/dark_blue/airless,
/area/crashed_sol_shuttle_01/main)

(1,1,1) = {"
VP
VP
VP
VP
VP
VP
Ck
VP
VP
VP
VP
VP
VP
Oz
Oz
Oz
Oz
VP
VP
VP
VP
VP
VP
VP
VP
VP
"}
(2,1,1) = {"
VP
VP
Oz
Oz
Oz
VP
VP
VP
VP
VP
Oz
Oz
Oz
Oz
Oz
Oz
VP
VP
VP
VP
VP
VP
VP
VP
VP
VP
"}
(3,1,1) = {"
VP
VP
VP
Oz
Oz
Oz
dB
dB
dB
zJ
zJ
zJ
zJ
zJ
zJ
dB
dB
dB
dB
Oz
Oz
Oz
VP
VP
VP
VP
"}
(4,1,1) = {"
VP
VP
VP
dB
dB
dB
dB
dB
yr
Yb
zJ
zJ
zJ
UF
Tp
yr
Uz
dB
vQ
dB
dB
Oz
Oz
VP
VP
VP
"}
(5,1,1) = {"
VP
VP
dB
dB
dB
lG
qH
Ex
vf
zm
wR
zJ
zJ
zJ
UF
UF
sa
dB
Sc
dX
Ak
dB
Oz
Oz
Oz
VP
"}
(6,1,1) = {"
VP
dB
rA
ga
TT
Mx
dO
mi
UF
dB
dB
zJ
zJ
zJ
dB
Iw
BJ
dB
wV
Iw
UF
aK
Oz
Oz
VP
VP
"}
(7,1,1) = {"
VP
Lc
mD
GJ
XI
fW
Iw
qV
UF
iB
Iw
zJ
zJ
jt
dB
zJ
UF
DB
Iw
Iw
rf
tC
Oz
Oz
VP
VP
"}
(8,1,1) = {"
sK
su
Iw
UF
UF
qQ
Zd
yk
wb
lc
yr
UF
zJ
zJ
qD
UF
fT
HL
HL
fo
HL
HL
Oz
Oz
Oz
VP
"}
(9,1,1) = {"
hk
Rg
tD
QY
bj
xv
UF
qV
UF
kr
zJ
hT
zJ
zJ
dB
UF
UF
HL
rK
Ut
Xs
HL
Oz
Oz
Oz
Oz
"}
(10,1,1) = {"
dB
dB
Rg
Oi
ac
II
jj
mi
UF
dB
zJ
zJ
UF
dB
zJ
zJ
yr
HL
Tj
Tj
Tj
HL
Oz
Oz
Oz
Oz
"}
(11,1,1) = {"
VP
dB
dB
dB
dB
il
yX
Ex
vf
JP
wR
zJ
zJ
zJ
zJ
zJ
UF
oz
Tj
Tj
Ah
HL
Oz
Oz
Oz
Oz
"}
(12,1,1) = {"
VP
Oz
dB
dB
dB
dB
dB
dB
UF
Yb
zJ
zJ
zJ
zJ
zJ
zJ
zJ
HL
Tj
Tj
Tj
HL
dB
Oz
Oz
VP
"}
(13,1,1) = {"
Oz
Oz
Oz
Oz
Oz
dB
dB
dB
uf
zJ
zJ
zJ
zJ
zJ
zJ
zJ
dB
HL
HL
HL
HL
HL
Oz
Oz
Oz
VP
"}
(14,1,1) = {"
Oz
Oz
Oz
VP
VP
VP
VP
VP
VP
VP
Oz
Oz
Oz
Oz
Oz
Oz
Oz
Oz
Hv
VP
Oz
Oz
Oz
VP
VP
VP
"}
(15,1,1) = {"
VP
VP
VP
VP
VP
VP
VP
VP
VP
VP
VP
VP
VP
VP
VP
VP
Oz
Oz
Oz
VP
VP
VP
VP
VP
VP
VP
"}
