//MAP CONVERTED BY dmm2tgm.py THIS HEADER COMMENT PREVENTS RECONVERSION, DO NOT REMOVE
"aH" = (
/obj/effect/decal/cleanable/blood,
/turf/simulated/floor/tiled/white,
/area/konyang/rural_clinic)
"bK" = (
/obj/effect/map_effect/window_spawner/full/wood,
/turf/space,
/area/konyang/rural_clinic)
"cd" = (
/obj/effect/floor_decal/corner/green/diagonal{
	dir = 4
	},
/obj/effect/floor_decal/corner/green/diagonal{
	dir = 4
	},
/turf/simulated/floor/tiled/white,
/area/konyang/rural_clinic)
"cj" = (
/obj/effect/landmark/corpse/konyang_villager,
/turf/template_noop,
/area/space)
"et" = (
/obj/machinery/optable,
/obj/effect/floor_decal/corner/green/diagonal{
	dir = 4
	},
/obj/effect/landmark/corpse/konyang_villager,
/turf/simulated/floor/tiled/white,
/area/konyang/rural_clinic)
"eE" = (
/obj/effect/floor_decal/corner/green/diagonal{
	dir = 4
	},
/obj/effect/floor_decal/corner/green/diagonal{
	dir = 4
	},
/obj/effect/decal/cleanable/blood/drip,
/turf/simulated/floor/tiled/white,
/area/konyang/rural_clinic)
"fO" = (
/mob/living/simple_animal/hostile/ipc_zombie,
/obj/effect/decal/cleanable/blood,
/turf/simulated/floor/tiled/white,
/area/konyang/rural_clinic)
"gj" = (
/obj/machinery/door/urban{
	dir = 4
	},
/turf/simulated/floor/tiled/white,
/area/konyang/rural_clinic)
"gs" = (
/obj/effect/floor_decal/corner/green/diagonal{
	dir = 4
	},
/obj/effect/floor_decal/corner/green/diagonal{
	dir = 4
	},
/obj/machinery/light{
	dir = 1;
	pixel_y = 3
	},
/turf/simulated/floor/tiled/white,
/area/konyang/rural_clinic)
"gD" = (
/obj/effect/floor_decal/corner/green/diagonal{
	dir = 4
	},
/obj/effect/decal/cleanable/blood,
/turf/simulated/floor/tiled/white,
/area/konyang/rural_clinic)
"iW" = (
/obj/machinery/door/urban{
	dir = 1
	},
/turf/simulated/floor/tiled/white,
/area/konyang/rural_clinic)
"jy" = (
/obj/item/material/shard,
/obj/item/material/shard,
/obj/structure/table/standard,
/turf/simulated/floor/tiled/white,
/area/konyang/rural_clinic)
"jS" = (
/obj/structure/table/standard,
/obj/item/storage/box/fancy/tray,
/turf/simulated/floor/tiled/white,
/area/konyang/rural_clinic)
"md" = (
/obj/effect/floor_decal/corner/green/diagonal{
	dir = 4
	},
/obj/effect/floor_decal/corner/green/diagonal{
	dir = 4
	},
/obj/item/stack/rods,
/turf/simulated/floor/tiled/white,
/area/konyang/rural_clinic)
"mU" = (
/obj/machinery/door/urban{
	dir = 4
	},
/obj/effect/floor_decal/corner/green/diagonal{
	dir = 4
	},
/turf/simulated/floor/tiled/white,
/area/konyang/rural_clinic)
"oE" = (
/obj/machinery/light{
	dir = 1;
	pixel_y = 3
	},
/obj/effect/floor_decal/corner/green/diagonal{
	dir = 4
	},
/turf/simulated/floor/tiled/white,
/area/konyang/rural_clinic)
"oI" = (
/obj/effect/decal/cleanable/blood/gibs/robot,
/obj/effect/decal/cleanable/blood/oil,
/turf/simulated/floor/tiled/white,
/area/konyang/rural_clinic)
"pl" = (
/obj/effect/floor_decal/corner/green/diagonal{
	dir = 4
	},
/obj/structure/bed/roller,
/turf/simulated/floor/tiled/white,
/area/konyang/rural_clinic)
"pn" = (
/obj/structure/bed/roller,
/turf/simulated/floor/tiled/white,
/area/konyang/rural_clinic)
"pq" = (
/obj/structure/table/rack/retail_shelf,
/obj/item/storage/firstaid/adv{
	pixel_x = 8
	},
/turf/simulated/floor/tiled/white,
/area/konyang/rural_clinic)
"pV" = (
/obj/machinery/light{
	dir = 8;
	pixel_y = 0;
	pixel_x = -4
	},
/turf/simulated/floor/tiled/white,
/area/konyang/rural_clinic)
"qj" = (
/obj/structure/window_frame/wood,
/obj/item/material/shard,
/turf/space,
/area/konyang/rural_clinic)
"qt" = (
/obj/structure/window/reinforced{
	dir = 8
	},
/obj/structure/table/standard,
/turf/simulated/floor/tiled/white,
/area/konyang/rural_clinic)
"qz" = (
/obj/structure/table/rack/retail_shelf,
/obj/item/device/healthanalyzer{
	pixel_y = -1
	},
/obj/item/device/healthanalyzer{
	pixel_y = 6
	},
/turf/simulated/floor/tiled/white,
/area/konyang/rural_clinic)
"qH" = (
/obj/structure/bed/padded,
/obj/item/bedsheet/medical,
/obj/structure/curtain/open/medical,
/turf/simulated/floor/tiled/white,
/area/konyang/rural_clinic)
"qM" = (
/obj/effect/decal/cleanable/blood,
/obj/effect/landmark/corpse/konyang_cop,
/turf/simulated/floor/tiled/white,
/area/konyang/rural_clinic)
"rP" = (
/obj/effect/decal/cleanable/blood/drip,
/turf/simulated/floor/tiled/white,
/area/konyang/rural_clinic)
"te" = (
/obj/effect/floor_decal/corner/green/diagonal{
	dir = 4
	},
/obj/effect/floor_decal/corner/green/diagonal{
	dir = 4
	},
/obj/machinery/light{
	pixel_y = 0
	},
/turf/simulated/floor/tiled/white,
/area/konyang/rural_clinic)
"vO" = (
/obj/effect/floor_decal/corner/green/diagonal{
	dir = 4
	},
/obj/structure/closet/crate/freezer,
/obj/item/reagent_containers/blood/OMinus,
/obj/item/reagent_containers/blood/OMinus,
/turf/simulated/floor/tiled/white,
/area/konyang/rural_clinic)
"wc" = (
/obj/structure/table/rack/retail_shelf,
/obj/item/storage/pill_bottle/inaprovaline{
	pixel_y = 9;
	pixel_x = -5
	},
/obj/item/storage/pill_bottle/inaprovaline{
	pixel_y = 0
	},
/obj/item/storage/pill_bottle/inaprovaline{
	pixel_y = -5;
	pixel_x = 8
	},
/turf/simulated/floor/tiled/white,
/area/konyang/rural_clinic)
"wn" = (
/obj/structure/sink{
	dir = 4;
	pixel_x = 12
	},
/turf/simulated/floor/tiled/white,
/area/konyang/rural_clinic)
"wJ" = (
/obj/structure/table/rack/retail_shelf,
/obj/item/storage/firstaid/adv{
	pixel_x = -4;
	pixel_y = -4
	},
/obj/item/stack/nanopaste{
	pixel_y = 0;
	pixel_x = 10
	},
/obj/item/stack/nanopaste{
	pixel_x = 10
	},
/turf/simulated/floor/tiled/white,
/area/konyang/rural_clinic)
"xw" = (
/obj/effect/map_effect/window_spawner/full/wood,
/turf/simulated/floor/tiled/white,
/area/konyang/rural_clinic)
"xB" = (
/mob/living/simple_animal/hostile/ipc_zombie,
/obj/item/stack/rods,
/turf/simulated/floor/tiled/white,
/area/konyang/rural_clinic)
"yv" = (
/obj/effect/floor_decal/corner/green/diagonal{
	dir = 4
	},
/obj/item/stack/medical/splint/full,
/turf/simulated/floor/tiled/white,
/area/konyang/rural_clinic)
"yZ" = (
/obj/structure/window_frame/wood,
/obj/item/material/shard,
/turf/simulated/wall/wood,
/area/konyang/rural_clinic)
"zu" = (
/obj/effect/floor_decal/corner/green/diagonal{
	dir = 4
	},
/turf/simulated/floor/tiled/white,
/area/konyang/rural_clinic)
"Bf" = (
/obj/effect/landmark/corpse/konyang_villager,
/turf/simulated/floor/tiled/white,
/area/konyang/rural_clinic)
"Cc" = (
/obj/effect/floor_decal/corner/green/diagonal{
	dir = 4
	},
/obj/item/stack/medical/bruise_pack/full{
	pixel_y = -2
	},
/turf/simulated/floor/tiled/white,
/area/konyang/rural_clinic)
"DB" = (
/obj/machinery/door/urban{
	dir = 1
	},
/obj/effect/floor_decal/corner/green/diagonal{
	dir = 4
	},
/turf/simulated/floor/tiled/white,
/area/konyang/rural_clinic)
"DO" = (
/obj/item/material/shard,
/obj/effect/landmark/corpse/konyang_villager,
/turf/simulated/floor/tiled/white,
/area/konyang/rural_clinic)
"Gg" = (
/obj/effect/floor_decal/corner/green/diagonal{
	dir = 4
	},
/obj/item/material/shard,
/obj/effect/decal/cleanable/blood,
/obj/machinery/iv_drip,
/turf/simulated/floor/tiled/white,
/area/konyang/rural_clinic)
"GS" = (
/turf/simulated/wall/wood,
/area/konyang/rural_clinic)
"GT" = (
/obj/effect/floor_decal/corner/green/diagonal{
	dir = 4
	},
/obj/effect/decal/cleanable/blood/oil,
/obj/machinery/iv_drip,
/turf/simulated/floor/tiled/white,
/area/konyang/rural_clinic)
"IF" = (
/obj/structure/table/rack/retail_shelf,
/obj/item/stack/medical/advanced/bruise_pack/full{
	pixel_y = 9
	},
/obj/item/stack/medical/advanced/bruise_pack/full{
	pixel_y = 0;
	pixel_x = 6
	},
/turf/simulated/floor/tiled/white,
/area/konyang/rural_clinic)
"JK" = (
/obj/structure/table/rack/retail_shelf,
/obj/item/storage/firstaid/regular{
	pixel_y = 8;
	pixel_x = -4
	},
/obj/item/storage/firstaid/regular{
	pixel_y = -5;
	pixel_x = 5
	},
/turf/simulated/floor/tiled/white,
/area/konyang/rural_clinic)
"JY" = (
/obj/machinery/iv_drip,
/turf/simulated/floor/tiled/white,
/area/konyang/rural_clinic)
"KC" = (
/obj/effect/floor_decal/corner/green/diagonal{
	dir = 4
	},
/mob/living/simple_animal/hostile/ipc_zombie,
/obj/effect/decal/cleanable/blood/drip,
/turf/simulated/floor/tiled/white,
/area/konyang/rural_clinic)
"NZ" = (
/obj/structure/table/rack/retail_shelf,
/obj/item/stack/medical/advanced/bruise_pack/full{
	pixel_y = -7;
	pixel_x = 6
	},
/obj/item/auto_cpr{
	pixel_x = -6;
	pixel_y = -1
	},
/turf/simulated/floor/tiled/white,
/area/konyang/rural_clinic)
"Oz" = (
/obj/effect/floor_decal/corner/green/diagonal{
	dir = 4
	},
/obj/item/material/shard,
/obj/item/stack/rods,
/obj/effect/decal/cleanable/blood,
/turf/simulated/floor/tiled/white,
/area/konyang/rural_clinic)
"Pi" = (
/mob/living/simple_animal/hostile/ipc_zombie,
/turf/template_noop,
/area/space)
"Qv" = (
/obj/effect/floor_decal/corner/green/diagonal{
	dir = 4
	},
/obj/effect/decal/cleanable/blood,
/obj/effect/landmark/corpse/konyang_clinic_worker,
/turf/simulated/floor/tiled/white,
/area/konyang/rural_clinic)
"Qx" = (
/obj/effect/floor_decal/corner/green/diagonal{
	dir = 4
	},
/obj/effect/decal/cleanable/blood/drip,
/obj/effect/decal/cleanable/blood,
/obj/effect/landmark/corpse/konyang_clinic_worker,
/turf/simulated/floor/tiled/white,
/area/konyang/rural_clinic)
"Sg" = (
/obj/effect/floor_decal/corner/green/diagonal{
	dir = 4
	},
/obj/item/reagent_containers/hypospray,
/turf/simulated/floor/tiled/white,
/area/konyang/rural_clinic)
"SG" = (
/obj/structure/table/rack/retail_shelf,
/obj/item/stack/medical/ointment/full{
	pixel_x = 8;
	pixel_y = 4
	},
/obj/item/stack/medical/ointment/full{
	pixel_x = 4;
	pixel_y = -7
	},
/obj/item/stack/medical/ointment/full{
	pixel_x = -3;
	pixel_y = 2
	},
/turf/simulated/floor/tiled/white,
/area/konyang/rural_clinic)
"TB" = (
/obj/structure/table/standard,
/obj/item/reagent_containers/spray/cleaner{
	desc = "Someone has crossed out the Space from Space Cleaner and written in Surgery. 'Do not remove under punishment of death!!!' is scrawled on the back.";
	icon_state = "sterilesprayblue";
	name = "surgery cleaner"
	},
/turf/simulated/floor/tiled/white,
/area/konyang/rural_clinic)
"Vq" = (
/turf/simulated/floor/tiled/white,
/area/konyang/rural_clinic)
"WB" = (
/obj/effect/floor_decal/corner/green/diagonal{
	dir = 4
	},
/obj/structure/sink{
	dir = 4;
	pixel_x = 12
	},
/turf/simulated/floor/tiled/white,
/area/konyang/rural_clinic)
"Xb" = (
/obj/effect/floor_decal/corner/green/diagonal{
	dir = 4
	},
/obj/item/stack/rods,
/turf/simulated/floor/tiled/white,
/area/konyang/rural_clinic)
"Xe" = (
/turf/template_noop,
/area/space)
"XG" = (
/obj/effect/floor_decal/corner/green/diagonal{
	dir = 4
	},
/obj/item/material/shard,
/turf/simulated/floor/tiled/white,
/area/konyang/rural_clinic)
"ZK" = (
/obj/effect/floor_decal/corner/green/diagonal{
	dir = 4
	},
/obj/effect/decal/cleanable/blood/splatter,
/turf/simulated/floor/tiled/white,
/area/konyang/rural_clinic)

(1,1,1) = {"
Xe
Xe
Xe
Xe
Xe
Xe
Xe
Xe
Xe
Xe
Xe
Xe
Xe
Xe
Xe
Xe
Xe
Xe
Xe
Xe
Xe
Xe
Xe
Xe
Xe
Xe
Xe
Xe
Xe
Xe
"}
(2,1,1) = {"
Xe
Xe
Xe
Xe
Xe
Xe
Xe
Xe
Xe
Xe
Xe
Xe
Xe
Xe
Xe
Xe
Xe
Xe
Xe
Xe
Xe
Xe
Xe
Xe
Xe
Xe
Xe
Xe
Xe
Xe
"}
(3,1,1) = {"
Xe
Xe
Xe
Xe
Xe
Xe
Xe
Xe
Xe
Xe
Xe
Xe
Xe
Xe
Xe
Xe
Xe
Xe
Xe
Xe
Xe
Xe
Xe
Xe
Xe
Xe
Xe
Xe
Xe
Xe
"}
(4,1,1) = {"
Xe
Xe
Xe
Xe
Xe
Xe
Xe
Xe
Xe
Xe
Xe
Xe
Xe
Xe
Xe
Xe
Xe
Xe
Xe
Xe
Xe
Xe
Xe
Xe
Xe
Xe
Xe
Xe
Xe
Xe
"}
(5,1,1) = {"
Xe
Xe
Xe
Xe
Xe
Xe
Xe
Xe
Xe
Xe
Xe
Xe
Xe
Xe
Xe
Xe
Xe
Xe
Xe
Xe
Xe
Xe
Xe
Xe
Xe
Xe
Xe
Xe
Xe
Xe
"}
(6,1,1) = {"
Xe
Xe
Xe
Xe
Xe
Xe
Xe
Xe
Xe
Xe
Xe
Xe
Xe
Xe
Xe
Xe
Xe
Xe
Xe
Xe
Xe
Xe
Xe
Xe
Xe
Xe
Xe
Xe
Xe
Xe
"}
(7,1,1) = {"
Xe
Xe
Xe
Xe
Xe
Xe
Xe
Xe
Xe
Xe
Xe
Xe
Xe
Xe
Xe
Xe
Xe
Xe
Xe
Xe
Xe
Xe
Xe
Xe
Xe
Xe
Xe
Xe
Xe
Xe
"}
(8,1,1) = {"
Xe
Xe
Xe
Xe
Xe
Xe
Pi
Xe
Xe
Xe
Xe
Xe
Xe
Xe
Xe
Xe
Xe
Xe
Xe
Xe
Xe
Xe
Xe
Xe
Xe
Xe
Xe
Xe
Xe
Xe
"}
(9,1,1) = {"
Xe
Xe
Xe
Xe
Xe
Xe
Xe
Xe
Xe
Xe
Xe
Xe
Xe
Xe
Xe
Xe
Xe
Xe
Xe
Xe
Xe
Xe
Xe
Xe
Xe
Xe
Xe
Xe
Xe
Xe
"}
(10,1,1) = {"
Xe
Xe
Xe
Xe
Xe
Xe
Xe
Xe
Xe
Xe
Xe
Xe
Xe
Xe
Xe
Xe
Xe
Xe
Xe
Xe
Xe
Xe
Xe
Xe
Xe
Xe
Xe
Xe
Xe
Xe
"}
(11,1,1) = {"
Xe
Xe
Xe
Xe
Xe
Xe
Xe
Xe
Xe
Xe
Xe
Xe
cj
Xe
Xe
Xe
Xe
Xe
Xe
Xe
Xe
Xe
Xe
Xe
Xe
Xe
Xe
Xe
Xe
Xe
"}
(12,1,1) = {"
Xe
Xe
Xe
Xe
Xe
Xe
Xe
Xe
Xe
Xe
Xe
Xe
Xe
Xe
Pi
Xe
Xe
Xe
Xe
Xe
Xe
Xe
Xe
Xe
Xe
Xe
Xe
Xe
Xe
Xe
"}
(13,1,1) = {"
Xe
Xe
Xe
Xe
GS
GS
GS
GS
GS
bK
bK
yZ
GS
gj
GS
gj
GS
Xe
Xe
Xe
Xe
Xe
Xe
Xe
Xe
Xe
Xe
Xe
Xe
Xe
"}
(14,1,1) = {"
Xe
Xe
Xe
Xe
GS
qH
zu
qH
GS
zu
rP
Vq
xw
Vq
fO
Vq
GS
Xe
Xe
Xe
Xe
Xe
Xe
Xe
Xe
Xe
Xe
Xe
Xe
Xe
"}
(15,1,1) = {"
Xe
Xe
Xe
Xe
GS
zu
eE
zu
DB
cd
Oz
zu
xw
rP
Bf
aH
GS
Xe
Xe
Xe
Xe
Xe
Xe
Xe
Xe
Xe
Xe
Xe
Xe
Xe
"}
(16,1,1) = {"
Xe
Xe
Xe
Xe
GS
qH
zu
qH
GS
pl
DO
rP
iW
Vq
oI
Vq
GS
Xe
cj
Xe
Xe
Xe
Xe
Xe
Xe
Xe
Xe
Xe
Xe
Xe
"}
(17,1,1) = {"
Xe
Xe
Xe
Xe
GS
GS
GS
GS
GS
zu
GT
zu
GS
qt
jy
qt
GS
Xe
Xe
Xe
Xe
Xe
Xe
Xe
Xe
Xe
Xe
Xe
Xe
Xe
"}
(18,1,1) = {"
Xe
Xe
Xe
Xe
GS
JY
et
pV
GS
pl
xB
oI
gD
qM
XG
Vq
GS
Xe
Xe
Xe
Xe
Xe
Xe
Xe
Xe
Xe
Xe
Xe
Xe
Xe
"}
(19,1,1) = {"
Xe
Xe
Xe
Xe
GS
oE
eE
Qx
DB
cd
zu
zu
md
Gg
cd
Xb
qj
Xe
Xe
Xe
Xe
Xe
Xe
Xe
Xe
Xe
Xe
Xe
Xe
Xe
"}
(20,1,1) = {"
Xe
Xe
Xe
Xe
GS
jS
WB
TB
GS
ZK
pn
pn
zu
wn
ZK
Vq
bK
Xe
Pi
Xe
Xe
Xe
Xe
Xe
Xe
Xe
Xe
Xe
Xe
Xe
"}
(21,1,1) = {"
Xe
Xe
Xe
Xe
GS
GS
GS
GS
GS
mU
GS
GS
mU
GS
GS
GS
GS
Xe
Xe
Xe
Xe
Xe
Xe
Xe
Xe
Xe
Xe
Xe
Xe
Xe
"}
(22,1,1) = {"
Xe
Xe
Xe
Xe
Xe
Xe
Xe
GS
gD
zu
KC
zu
Qv
zu
GS
Xe
Xe
Xe
Xe
Xe
Xe
Xe
Xe
Xe
Xe
Xe
Xe
Xe
Xe
Xe
"}
(23,1,1) = {"
Xe
Xe
Xe
Xe
Xe
Xe
Xe
GS
zu
qz
NZ
wJ
SG
Cc
GS
Xe
Xe
Xe
Xe
Xe
Xe
Xe
Xe
Xe
Xe
Xe
Xe
Xe
Xe
Xe
"}
(24,1,1) = {"
Xe
Xe
Xe
Xe
Xe
Xe
Xe
GS
gs
gD
Sg
gD
Cc
te
GS
Xe
Xe
Xe
Xe
Xe
Xe
Xe
Xe
Xe
Xe
Xe
Xe
Xe
Xe
Xe
"}
(25,1,1) = {"
Xe
Xe
Xe
Xe
Xe
Xe
Xe
GS
yv
JK
wc
pq
IF
vO
GS
Xe
Xe
Xe
Xe
Xe
Xe
Xe
Xe
Xe
Xe
Xe
Xe
Xe
Xe
Xe
"}
(26,1,1) = {"
Xe
Xe
Xe
Xe
Xe
Xe
Xe
GS
GS
GS
GS
GS
GS
GS
GS
Xe
Xe
Xe
Xe
Xe
Xe
Xe
Xe
Xe
Xe
Xe
Xe
Xe
Xe
Xe
"}
(27,1,1) = {"
Xe
Xe
Xe
Xe
Xe
Xe
Xe
Xe
Xe
Xe
Xe
Xe
Xe
Xe
Xe
Xe
Xe
Xe
Xe
Xe
Xe
Xe
Xe
Xe
Xe
Xe
Xe
Xe
Xe
Xe
"}
(28,1,1) = {"
Xe
Xe
Xe
Xe
Xe
Xe
Xe
Xe
Xe
Xe
Xe
Xe
Xe
Xe
Xe
Xe
Xe
Xe
Xe
Xe
Xe
Xe
Xe
Xe
Xe
Xe
Xe
Xe
Xe
Xe
"}
(29,1,1) = {"
Xe
Xe
Xe
Xe
Xe
Xe
Xe
Xe
Xe
Xe
Xe
Xe
Xe
Xe
Xe
Xe
Xe
Xe
Xe
Xe
Xe
Xe
Xe
Xe
Xe
Xe
Xe
Xe
Xe
Xe
"}
(30,1,1) = {"
Xe
Xe
Xe
Xe
Xe
Xe
Xe
Xe
Xe
Xe
Xe
Xe
Xe
Xe
Xe
Xe
Xe
Xe
Xe
Xe
Xe
Xe
Xe
Xe
Xe
Xe
Xe
Xe
Xe
Xe
"}
