"ao" = (/obj/random/glowstick,/turf/simulated/floor/tiled/airless,/area/exoplanet/barren/asteroid)
"aA" = (/obj/machinery/light/small/red{dir = 4},/turf/simulated/floor/airless,/area/exoplanet/barren/asteroid)
"aD" = (/obj/effect/decal/cleanable/blood/splatter,/obj/item/ammo_casing/c10mm{projectile_type = null},/turf/simulated/floor/airless,/area/exoplanet/barren/asteroid)
"aP" = (/obj/structure/table/wood,/obj/item/reagent_containers/food/drinks/drinkingglass,/obj/item/reagent_containers/food/drinks/drinkingglass,/obj/item/reagent_containers/food/drinks/drinkingglass,/turf/simulated/floor/tiled/asteroid/airless,/area/exoplanet/barren/asteroid)
"bU" = (/obj/item/ammo_casing/c10mm{projectile_type = null},/obj/item/ammo_casing/c10mm{projectile_type = null},/turf/simulated/floor/airless,/area/exoplanet/barren/asteroid)
"dy" = (/obj/effect/decal/cleanable/blood/splatter,/turf/simulated/floor/airless,/area/exoplanet/barren/asteroid)
"dA" = (/obj/machinery/portable_atmospherics/canister/air/airlock,/obj/machinery/atmospherics/portables_connector{dir = 4},/turf/simulated/floor/plating,/area/exoplanet/barren/asteroid)
"eH" = (/mob/living/simple_animal/hostile/viscerator,/turf/simulated/floor/airless,/area/exoplanet/barren/asteroid)
"eO" = (/obj/random/junk,/obj/item/stack/cable_coil/cut,/turf/simulated/floor/airless,/area/exoplanet/barren/asteroid)
"fl" = (/obj/random/keg,/turf/unsimulated/floor/asteroid/ash,/area/exoplanet/barren/asteroid)
"fB" = (/obj/item/mecha_equipment/mounted_system/combat/taser,/turf/simulated/floor/tiled/asteroid/airless,/area/exoplanet/barren/asteroid)
"fJ" = (/obj/random/voidsuit/no_nanotrasen,/turf/simulated/floor/airless,/area/exoplanet/barren/asteroid)
"gn" = (/obj/structure/grille/broken,/obj/item/material/shard,/turf/simulated/floor/plating,/area/exoplanet/barren/asteroid)
"gy" = (/obj/structure/table/rack,/obj/random/contraband,/obj/random/contraband,/turf/simulated/floor/airless,/area/exoplanet/barren/asteroid)
"gC" = (/obj/machinery/light/small/red{dir = 1},/turf/simulated/floor/airless,/area/exoplanet/barren/asteroid)
"hi" = (/obj/structure/cable{d1 = 4; d2 = 8; icon_state = "4-8"},/obj/effect/gibspawner/robot,/turf/simulated/floor/tiled/airless,/area/exoplanet/barren/asteroid)
"hQ" = (/obj/structure/mech_wreckage/powerloader,/turf/simulated/floor/tiled/asteroid/airless,/area/exoplanet/barren/asteroid)
"iG" = (/obj/effect/decal/cleanable/blood/gibs/robot/limb,/obj/effect/decal/cleanable/blood/oil/streak,/turf/simulated/floor/airless,/area/exoplanet/barren/asteroid)
"ja" = (/obj/effect/floor_decal/industrial/warning{dir = 5},/turf/simulated/floor/airless,/area/exoplanet/barren/asteroid)
"jL" = (/obj/structure/closet/toolcloset,/turf/simulated/floor/tiled/airless,/area/exoplanet/barren/asteroid)
"jQ" = (/obj/machinery/atmospherics/valve{dir = 4},/turf/simulated/floor/plating,/area/exoplanet/barren/asteroid)
"kr" = (/obj/effect/landmark/corpse/miner,/obj/effect/decal/cleanable/blood/splatter,/turf/simulated/floor/airless,/area/exoplanet/barren/asteroid)
"kZ" = (/obj/random/melee,/turf/simulated/floor/tiled/asteroid/airless,/area/exoplanet/barren/asteroid)
"lX" = (/obj/effect/map_effect/wingrille_spawn/full,/turf/simulated/wall,/area/exoplanet/barren/asteroid)
"ms" = (/obj/random/melee,/turf/unsimulated/floor/asteroid/ash,/area/exoplanet/barren/asteroid)
"nQ" = (/turf/simulated/mineral,/area/exoplanet/barren/asteroid)
"oz" = (/obj/effect/floor_decal/industrial/warning,/turf/simulated/floor/airless,/area/exoplanet/barren/asteroid)
"oE" = (/turf/simulated/wall{can_open = 1},/area/exoplanet/barren/asteroid)
"oK" = (/obj/item/gun/projectile/pirate,/turf/simulated/floor/tiled/asteroid/airless,/area/exoplanet/barren/asteroid)
"oW" = (/obj/item/ammo_magazine/c38,/obj/item/ammo_casing/shotgun/pellet,/obj/item/gun/projectile/revolver/lemat,/turf/unsimulated/floor/asteroid/ash,/area/exoplanet/barren/asteroid)
"pa" = (/obj/effect/floor_decal/industrial/warning{dir = 10},/turf/simulated/floor/airless,/area/exoplanet/barren/asteroid)
"ps" = (/obj/random/junk,/turf/simulated/floor/tiled/asteroid/airless,/area/exoplanet/barren/asteroid)
"pG" = (/obj/effect/decal/cleanable/blood/tracks/footprints,/turf/simulated/floor/tiled/asteroid/airless,/area/exoplanet/barren/asteroid)
"qQ" = (/obj/structure/table/rack,/obj/structure/closet/crate/drop/grey{icon_state = "dropcrate-grey-open"; opened = 1},/turf/simulated/floor/airless,/area/exoplanet/barren/asteroid)
"rm" = (/obj/structure/grille,/turf/simulated/floor/airless,/area/exoplanet/barren/asteroid)
"ru" = (/turf/simulated/floor/tiled/asteroid/airless,/area/exoplanet/barren/asteroid)
"rG" = (/obj/item/ammo_casing/c10mm{projectile_type = null},/turf/simulated/floor/tiled/asteroid/airless,/area/exoplanet/barren/asteroid)
"sx" = (/obj/random/medical,/turf/simulated/floor/airless,/area/exoplanet/barren/asteroid)
"td" = (/obj/structure/bed/stool/bar/wood,/turf/simulated/floor/tiled/asteroid/airless,/area/exoplanet/barren/asteroid)
"tq" = (/obj/random/junk,/obj/random/finances,/turf/unsimulated/floor/asteroid/ash,/area/exoplanet/barren/asteroid)
"tU" = (/obj/structure/reagent_dispensers/keg/beerkeg,/turf/unsimulated/floor/asteroid/ash,/area/exoplanet/barren/asteroid)
"ui" = (/turf/unsimulated/floor/asteroid/ash,/area/exoplanet/barren/asteroid)
"vi" = (/obj/machinery/light{dir = 1},/turf/simulated/floor/tiled/asteroid/airless,/area/exoplanet/barren/asteroid)
"vP" = (/obj/structure/trash_pile,/turf/unsimulated/floor/asteroid/ash,/area/exoplanet/barren/asteroid)
"vT" = (/obj/machinery/light{dir = 1; icon_state = "tube1"},/turf/simulated/floor/tiled/asteroid/airless,/area/exoplanet/barren/asteroid)
"Aw" = (/obj/structure/table/wood,/obj/item/reagent_containers/food/drinks/bottle/small/beer,/obj/item/reagent_containers/food/drinks/bottle/small/beer,/obj/item/reagent_containers/food/drinks/bottle/small/beer,/obj/item/reagent_containers/food/drinks/bottle/small/beer,/turf/simulated/floor/tiled/asteroid/airless,/area/exoplanet/barren/asteroid)
"AK" = (/obj/effect/floor_decal/industrial/warning{dir = 8},/turf/simulated/floor/airless,/area/exoplanet/barren/asteroid)
"Bv" = (/obj/random/document/junk,/obj/item/trash/cigbutt/cigarbutt,/turf/unsimulated/floor/asteroid/ash,/area/exoplanet/barren/asteroid)
"Cg" = (/obj/machinery/atmospherics/pipe/simple/hidden{dir = 4},/turf/simulated/floor/plating,/area/exoplanet/barren/asteroid)
"CP" = (/obj/item/material/shard,/turf/unsimulated/floor/asteroid/ash,/area/exoplanet/barren/asteroid)
"Da" = (/obj/item/ammo_casing/c10mm{projectile_type = null},/obj/item/ammo_casing/c10mm{projectile_type = null},/obj/item/ammo_casing/c10mm{projectile_type = null},/turf/simulated/floor/tiled/asteroid/airless,/area/exoplanet/barren/asteroid)
"EH" = (/obj/effect/decal/cleanable/blood/gibs,/obj/item/material/shard,/turf/simulated/floor/tiled/asteroid/airless,/area/exoplanet/barren/asteroid)
"EZ" = (/obj/effect/decal/cleanable/blood/gibs/body,/turf/simulated/floor/airless,/area/exoplanet/barren/asteroid)
"Fm" = (/obj/random/glowstick,/turf/simulated/floor/airless,/area/exoplanet/barren/asteroid)
"FC" = (/turf/simulated/wall,/area/exoplanet/barren/asteroid)
"FG" = (/obj/effect/gibspawner/human,/obj/item/gun/projectile/shotgun/improvised/sawn,/turf/unsimulated/floor/asteroid/ash,/area/exoplanet/barren/asteroid)
"GD" = (/obj/structure/cable{dir = 8},/obj/item/trash/broken_electronics,/turf/simulated/floor/tiled/airless,/area/exoplanet/barren/asteroid)
"Hp" = (/turf/simulated/wall/shuttle/dark,/area/exoplanet/barren/asteroid)
"Hu" = (/obj/structure/table/rack,/obj/structure/trash_pile,/turf/simulated/floor/airless,/area/exoplanet/barren/asteroid)
"HZ" = (/obj/structure/droppod_door,/turf/simulated/floor/airless,/area/exoplanet/barren/asteroid)
"If" = (/obj/effect/decal/cleanable/blood/drip,/obj/item/ammo_casing/c10mm{projectile_type = null},/turf/simulated/floor/airless,/area/exoplanet/barren/asteroid)
"Iy" = (/obj/effect/decal/cleanable/blood/drip,/obj/item/ammo_casing/shotgun/pellet{projectile_type = null},/turf/simulated/floor/airless,/area/exoplanet/barren/asteroid)
"Iz" = (/obj/structure/bed/stool/chair/shuttle{dir = 4},/turf/simulated/floor/tiled/airless,/area/exoplanet/barren/asteroid)
"ID" = (/obj/structure/cable{d1 = 4; d2 = 8; icon_state = "4-8"},/turf/simulated/floor/tiled/airless,/area/exoplanet/barren/asteroid)
"Ji" = (/obj/machinery/chemical_dispenser/bar_alc/full{dir = 4; pixel_x = -4},/turf/simulated/floor/tiled/asteroid/airless,/area/exoplanet/barren/asteroid)
"Jj" = (/obj/random/firstaid,/turf/simulated/floor/tiled/asteroid/airless,/area/exoplanet/barren/asteroid)
"Jq" = (/obj/effect/floor_decal/industrial/warning{dir = 4},/turf/simulated/floor/airless,/area/exoplanet/barren/asteroid)
"JC" = (/obj/item/ammo_casing/shotgun/pellet{projectile_type = null},/turf/simulated/floor/airless,/area/exoplanet/barren/asteroid)
"Kf" = (/obj/effect/floor_decal/industrial/warning{dir = 1},/turf/simulated/floor/airless,/area/space)
"Ks" = (/obj/random/vendor,/turf/simulated/floor/tiled/asteroid/airless,/area/exoplanet/barren/asteroid)
"KL" = (/obj/structure/table/wood,/obj/random/medical,/obj/random/random_flag,/turf/simulated/floor/tiled/asteroid/airless,/area/exoplanet/barren/asteroid)
"Ll" = (/obj/structure/grille/broken,/turf/simulated/floor/airless,/area/exoplanet/barren/asteroid)
"LY" = (/obj/effect/gibspawner/robot,/turf/simulated/floor/airless,/area/exoplanet/barren/asteroid)
"Mw" = (/obj/machinery/light/small/red,/turf/simulated/floor/airless,/area/exoplanet/barren/asteroid)
"Na" = (/obj/item/trash/syndi_cakes,/turf/unsimulated/floor/asteroid/ash,/area/exoplanet/barren/asteroid)
"Nf" = (/obj/random/toolbox,/turf/simulated/floor/tiled/airless,/area/exoplanet/barren/asteroid)
"NB" = (/obj/structure/table/rack,/obj/structure/closet/crate/loot,/turf/simulated/floor/airless,/area/exoplanet/barren/asteroid)
"Oz" = (/turf/simulated/floor/airless,/area/exoplanet/barren/asteroid)
"OU" = (/obj/effect/map_effect/airlock/long/square/engine/reversed,/turf/simulated/wall,/area/exoplanet/barren/asteroid)
"OY" = (/obj/structure/closet/crate/trashcart,/turf/simulated/floor/airless,/area/exoplanet/barren/asteroid)
"Pg" = (/obj/item/ammo_casing/shotgun/pellet{projectile_type = null},/turf/simulated/floor/tiled/asteroid/airless,/area/exoplanet/barren/asteroid)
"Pz" = (/obj/item/material/shard,/turf/simulated/floor/tiled/asteroid/airless,/area/exoplanet/barren/asteroid)
"Qi" = (/obj/effect/gibspawner/robot,/turf/unsimulated/floor/asteroid/ash,/area/exoplanet/barren/asteroid)
"QR" = (/obj/effect/gibspawner/robot,/turf/simulated/wall,/area/exoplanet/barren/asteroid)
"Rw" = (/obj/random/junk,/turf/simulated/floor/tiled/airless,/area/exoplanet/barren/asteroid)
"RP" = (/obj/effect/decal/cleanable/blood/gibs/limb,/turf/simulated/floor/airless,/area/exoplanet/barren/asteroid)
"RX" = (/mob/living/simple_animal/hostile/rogue_drone,/turf/unsimulated/floor/asteroid/ash,/area/exoplanet/barren/asteroid)
"RZ" = (/obj/effect/decal/cleanable/blood/oil,/turf/simulated/floor/tiled/asteroid/airless,/area/exoplanet/barren/asteroid)
"St" = (/obj/structure/grille/broken,/turf/simulated/floor/plating,/area/exoplanet/barren/asteroid)
"Sw" = (/obj/structure/grille,/turf/simulated/floor/plating,/area/exoplanet/barren/asteroid)
"Sx" = (/obj/random/junk,/turf/simulated/floor/airless,/area/exoplanet/barren/asteroid)
"Tg" = (/obj/effect/landmark/corpse/commander,/obj/effect/decal/cleanable/blood,/obj/item/gun/projectile/revolver/mateba,/obj/item/ammo_casing/a454{projectile_type = null},/turf/unsimulated/floor/asteroid/ash,/area/exoplanet/barren/asteroid)
"TO" = (/obj/machinery/floodlight,/turf/unsimulated/floor/asteroid/ash,/area/exoplanet/barren/asteroid)
"Ve" = (/obj/structure/cable{dir = 4},/obj/item/broken_device,/turf/simulated/floor/tiled/airless,/area/exoplanet/barren/asteroid)
"Vn" = (/mob/living/simple_animal/hostile/rogue_drone,/turf/simulated/floor/tiled/asteroid/airless,/area/exoplanet/barren/asteroid)
"VD" = (/obj/machinery/atmospherics/pipe/simple/hidden{dir = 10},/turf/simulated/floor/plating,/area/exoplanet/barren/asteroid)
"WH" = (/obj/structure/bed/stool/chair/shuttle,/turf/simulated/floor/tiled/airless,/area/exoplanet/barren/asteroid)
"XX" = (/turf/simulated/floor/tiled/airless,/area/exoplanet/barren/asteroid)
"Yn" = (/obj/effect/floor_decal/industrial/warning{dir = 6},/turf/simulated/floor/airless,/area/exoplanet/barren/asteroid)
"YL" = (/obj/item/ammo_casing/shotgun/pellet{projectile_type = null},/turf/unsimulated/floor/asteroid/ash,/area/exoplanet/barren/asteroid)
"Zj" = (/obj/effect/gibspawner/human,/turf/simulated/floor/tiled/asteroid/airless,/area/exoplanet/barren/asteroid)
"Zy" = (/obj/effect/decal/cleanable/blood/oil/streak,/turf/simulated/floor/tiled/asteroid/airless,/area/exoplanet/barren/asteroid)
"ZB" = (/obj/effect/decal/cleanable/blood/gibs/robot,/obj/effect/decal/cleanable/blood/oil/streak,/turf/simulated/floor/airless,/area/exoplanet/barren/asteroid)
"ZD" = (/obj/effect/gibspawner/human,/turf/unsimulated/floor/asteroid/ash,/area/exoplanet/barren/asteroid)
"ZG" = (/obj/structure/table/wood,/obj/item/reagent_containers/food/drinks/bottle/small/ale,/obj/item/reagent_containers/food/drinks/bottle/small/ale,/turf/simulated/floor/tiled/asteroid/airless,/area/exoplanet/barren/asteroid)

(1,1,1) = {"
uiuiuiuiuiuiuiuiuiuiYLuiuiuiuiuiuiuiuiuiuiuiuiuiuiuiuiuiuiuiuiui
uiuiuiuiuiuiuiuiuiuiFGYLuiuinQnQnQnQnQuinQuiuiuiuiuiuiuiuiuiuiui
uiuiuiuiuiuiuiuinQnQuiuinQnQnQnQnQnQnQnQuinQnQuiuiuiuiuiuiuiuiui
uiuiuiuiuiuiuinQFCFCoEoEFCFCFCFCFCnQnQuinQnQnQuiuiuiuiuiuiuiuiui
uiuiuiuiuiuinQFCFCAKOzOzJqOYHuOzFCnQnQuinQnQnQnQCPuiuiuiuiuiuiui
uiuiuiuiuinQFCFCgCpaozozYnOzNBaAFCnQnQnQnQnQnQuiuiuiuiuiuiuiuiui
uiuiuiuinQFCFCOzOzOzSxOzOzSxHuOzFCflflflnQFCFCgnFCStStFClXFCFCui
uiuiuinQFCFCOzSxOzNBOzeHHuOzNBOzFCBvTgtqnQFCJiPzvTruruvirupsFCui
uiuiuinQFCOzSxOzdyqQkrLYHuSxNBOzFCFCoEFCFCFCaPZGAwKLrupsruKsFCui
uiuinQnQFCOzOzSxRPEZdyZBiGbUOzaDIfSxRPdyIyoErGtdtdtdPgZjoKruStui
uiuinQnQQROzOzeHOzOzOzOzbUJCsxIfOzdyMwIyRPoEEHpGpGpGVnruPgKsFCui
uiuiuinQFCOzOzOzgyaAFCFCFCFCFCFCFCFCFCFCFCFCDakZZjrGJjrufBpsFCui
uiuiuinQFCKfjaOzHuSxFCnQnQnQnQnQnQnQnQuiuiFCdAjQCgVDZyZyRZhQSwui
uiRXuiuioEOzJqOzNBOzFCnQoWvPnQnQnQnQuiuiuiFCFClXFCFCOzFClXStStui
uiZDmsuioEOzJqOzHuOzoEuiNatUnQnQnQuiuiuiuiuiuiuiFCfJOzFCuiuiuiui
uiuiuinQFCozYnOzNBOzFCnQnQnQnQuiuiuiuiuiuiuiuiuiFCOzOzFCuiuiuiui
uinQnQnQFCFCFCFCFCFCFCnQnQnQnQuiuiuiuiuiuiuiTOuiOUFCOzFCuiRXuiui
uiuinQnQnQnQnQnQnQnQnQnQuiuiuiuiuiuiuiuiuiuiuiuiuiuiuiuiuiuiuiui
uiuinQnQnQnQuinQuiuiuiuiuiuiuiuiuiuiuiuiuiuiuiuiuiuiuiuiuiuiuiui
uinQnQuiuiuiuiuiuiuiuiuiuiuiuiuiuiuiuiuiuiuiuiuiuiuiuiuiuiuiuiui
uiuiuiuiuiuiuiuiuiuiuiuiuiuiuiuiuiuiuiuiuiQiuiuiuiuiuiuiuiuiuiui
uiuiuiuiuiuiuiuiuiuiuiHpHpHpHpLlLluiuiuiuiuiuiuiuiuiuiuiuiuiuiui
uiuiuiuiuiuiuiuiuiuiuiHpWHWHIzOzOzOzuiuiuiuiuiuiuiuiuiuiuiuiuiui
uiuiuiuiuiuiuiuiuiuiuiLlXXXXXXFmfJOzLluiuiuiuiuiuiuiuiuiuiuiuiui
uiuiuiuiuiuiuiuiuiuiuiLlXXaoXXRwXXjLHpuiuiuiuiuiuiuiuiuiuiuiuiui
uiuiuiuiuiuiuiuiuiuiuiLlGDeOIDhiIDVeHpuiuiuiuiuiuiuiuiuiuiuiuiui
uiuiuiuiuiuiuiuiuiuiuirmNfXXRwOzXXXXHpuiuiuiuiuiuiuiuiuiuiuiuiui
uiuiuiuiuiuiuiuiuiuiuiHpjLXXXXSxOzXXHpuiuiuiuiuiuiuiuiuiuiuiuiui
uiuiuiuiuiuiuiuiuiuiuiHpHpHZHZHZHpLlHpuiuiuiuiuiuiuiuiuiuiuiuiui
uiuiuiuiuiuiuiuiuiuiuiuiuiuiuiuiuiuiuiuiuiuiuiuiuiuiuiuiuiuiuiui
uiuiuiuiuiuiuiuiuiuiuiuiuiuiuiuiuiuiuiuiuiuiuiuiuiuiuiuiuiuiuiui
uiuiuiuiuiuiuiuiuiuiuiuiuiuiuiuiuiuiuiuiuiuiuiuiuiuiuiuiuiuiuiui
"}
