//MAP CONVERTED BY dmm2tgm.py THIS HEADER COMMENT PREVENTS RECONVERSION, DO NOT REMOVE
"j" = (
/turf/simulated/floor/airless/ceiling,
/area/exoplanet/barren/asteroid)
"k" = (
/obj/effect/floor_decal/industrial/warning/dust,
/turf/simulated/floor/airless/ceiling,
/area/exoplanet/barren/asteroid)
"o" = (
/turf/simulated/mineral,
/area/exoplanet/barren/asteroid)
"r" = (
/turf/unsimulated/floor/asteroid/ash,
/area/exoplanet/barren/asteroid)
"s" = (
/mob/living/simple_animal/hostile/retaliate/minedrone,
/turf/simulated/floor/airless/ceiling,
/area/exoplanet/barren/asteroid)
"t" = (
/obj/effect/floor_decal/industrial/warning/dust{
	dir = 8
	},
/mob/living/simple_animal/hostile/retaliate/minedrone,
/turf/simulated/floor/airless/ceiling,
/area/exoplanet/barren/asteroid)
"u" = (
/obj/effect/floor_decal/industrial/warning/dust,
/obj/effect/floor_decal/industrial/loading/yellow,
/turf/simulated/floor/airless/ceiling,
/area/exoplanet/barren/asteroid)
"v" = (
/obj/structure/ore_box,
/obj/effect/floor_decal/industrial/outline/yellow,
/turf/simulated/floor/airless/ceiling,
/area/exoplanet/barren/asteroid)
"z" = (
/obj/effect/floor_decal/industrial/warning/dust,
/obj/structure/table/reinforced,
/obj/item/storage/bag/ore,
/turf/simulated/floor/airless/ceiling,
/area/exoplanet/barren/asteroid)
"B" = (
/obj/structure/closet/crate,
/obj/item/ore/hydrogen,
/obj/item/ore/hydrogen,
/obj/item/ore/hydrogen,
/obj/item/ore/hydrogen,
/obj/item/ore/osmium,
/obj/item/ore/osmium,
/obj/item/ore/osmium,
/obj/item/ore/coal,
/obj/item/ore/coal,
/turf/simulated/floor/airless/ceiling,
/area/exoplanet/barren/asteroid)
"C" = (
/obj/effect/floor_decal/industrial/warning/dust{
	dir = 10
	},
/turf/simulated/floor/airless/ceiling,
/area/exoplanet/barren/asteroid)
"D" = (
/obj/effect/floor_decal/industrial/warning/dust{
	dir = 4
	},
/obj/structure/table/reinforced,
/obj/item/clothing/accessory/storage/overalls/mining,
/turf/simulated/floor/airless/ceiling,
/area/exoplanet/barren/asteroid)
"H" = (
/obj/effect/floor_decal/industrial/warning/dust{
	dir = 1
	},
/turf/simulated/floor/airless/ceiling,
/area/exoplanet/barren/asteroid)
"L" = (
/obj/effect/floor_decal/industrial/warning/dust{
	dir = 9
	},
/turf/simulated/floor/airless/ceiling,
/area/exoplanet/barren/asteroid)
"N" = (
/obj/effect/floor_decal/industrial/warning/dust{
	dir = 8
	},
/turf/simulated/floor/airless/ceiling,
/area/exoplanet/barren/asteroid)
"O" = (
/obj/effect/floor_decal/industrial/warning/dust{
	dir = 4
	},
/turf/simulated/floor/airless/ceiling,
/area/exoplanet/barren/asteroid)
"P" = (
/obj/effect/floor_decal/industrial/warning/dust{
	dir = 6
	},
/turf/simulated/floor/airless/ceiling,
/area/exoplanet/barren/asteroid)
"R" = (
/obj/effect/floor_decal/industrial/warning/dust,
/obj/structure/table/reinforced,
/obj/item/rfd/mining,
/turf/simulated/floor/airless/ceiling,
/area/exoplanet/barren/asteroid)
"T" = (
/obj/effect/floor_decal/industrial/warning/dust{
	dir = 1
	},
/obj/structure/table/reinforced,
/obj/item/device/flashlight/lantern,
/turf/simulated/floor/airless/ceiling,
/area/exoplanet/barren/asteroid)
"U" = (
/obj/machinery/mech_recharger,
/obj/effect/floor_decal/industrial/outline/yellow,
/obj/structure/mech_wreckage/powerloader,
/turf/simulated/floor/airless/ceiling,
/area/exoplanet/barren/asteroid)
"V" = (
/obj/machinery/mech_recharger,
/obj/effect/floor_decal/industrial/outline/yellow,
/turf/simulated/floor/airless/ceiling,
/area/exoplanet/barren/asteroid)
"X" = (
/obj/effect/floor_decal/industrial/warning/dust{
	dir = 5
	},
/obj/structure/table/reinforced,
/obj/item/pickaxe/jackhammer,
/turf/simulated/floor/airless/ceiling,
/area/exoplanet/barren/asteroid)
"Y" = (
/obj/structure/closet/crate,
/obj/item/ore/diamond,
/obj/item/ore/diamond,
/obj/item/ore/diamond,
/turf/simulated/floor/airless/ceiling,
/area/exoplanet/barren/asteroid)

(1,1,1) = {"
r
r
r
r
r
r
r
r
r
r
r
r
r
r
r
r
r
r
r
r
r
r
r
r
r
r
r
r
r
r
r
r
"}
(2,1,1) = {"
r
r
r
r
r
r
r
r
r
r
r
r
r
r
r
r
r
r
r
r
r
r
r
r
r
r
r
r
r
r
r
r
"}
(3,1,1) = {"
r
r
r
r
r
r
r
r
r
r
r
r
r
r
r
r
r
r
r
r
r
r
r
r
r
r
r
r
r
r
r
r
"}
(4,1,1) = {"
r
r
r
r
r
r
r
r
r
r
r
r
r
r
r
r
r
r
r
r
r
r
r
r
r
r
r
r
r
r
r
r
"}
(5,1,1) = {"
r
r
r
o
o
o
o
o
o
o
o
o
o
o
r
r
o
o
r
r
r
r
r
r
r
r
r
r
r
r
r
r
"}
(6,1,1) = {"
r
r
r
o
o
o
o
o
o
o
o
o
o
o
o
o
o
o
r
r
r
r
o
o
o
r
r
r
r
r
r
r
"}
(7,1,1) = {"
r
r
r
r
o
o
o
o
o
o
o
o
o
o
o
o
o
o
o
o
r
r
o
o
o
r
r
r
r
r
r
r
"}
(8,1,1) = {"
r
r
r
r
o
o
o
o
o
o
o
r
r
r
r
r
o
o
o
o
o
o
o
o
o
r
r
r
r
r
r
r
"}
(9,1,1) = {"
r
r
r
r
o
o
o
r
r
r
r
r
r
r
r
r
o
o
o
o
o
o
o
r
r
r
r
r
r
r
r
r
"}
(10,1,1) = {"
r
r
r
r
o
o
o
r
r
r
r
r
r
r
r
r
o
o
o
o
o
o
o
r
r
r
r
r
r
r
r
r
"}
(11,1,1) = {"
r
r
r
r
o
o
o
r
r
r
r
r
r
r
r
r
r
r
r
r
o
o
o
o
o
r
r
r
r
r
r
r
"}
(12,1,1) = {"
r
r
r
r
o
o
r
r
r
r
L
N
t
N
N
C
r
r
r
r
o
o
o
r
r
r
r
r
r
r
r
r
"}
(13,1,1) = {"
r
r
r
r
o
o
r
r
r
r
H
v
j
j
j
R
r
r
r
r
o
o
o
r
r
r
r
r
r
r
r
r
"}
(14,1,1) = {"
r
r
r
r
o
o
r
r
r
r
H
v
j
j
j
z
r
r
r
r
o
o
o
r
r
r
r
r
r
r
r
r
"}
(15,1,1) = {"
r
r
r
r
o
o
r
r
r
r
H
j
j
j
j
k
r
r
r
r
r
r
r
r
r
r
r
r
r
r
r
r
"}
(16,1,1) = {"
r
r
r
r
o
o
o
o
r
r
H
j
j
j
j
k
r
r
r
r
r
r
r
r
r
r
r
r
r
r
r
r
"}
(17,1,1) = {"
r
r
r
r
r
o
o
o
r
r
H
B
j
s
j
k
r
r
r
r
r
r
r
r
r
r
r
r
r
r
r
r
"}
(18,1,1) = {"
r
r
r
r
r
o
o
o
r
r
H
Y
j
j
j
k
r
r
r
r
r
r
r
r
r
r
r
r
r
r
r
r
"}
(19,1,1) = {"
r
r
r
r
r
o
o
o
r
r
H
j
j
j
j
k
r
r
r
r
r
r
r
r
r
r
r
r
r
r
r
r
"}
(20,1,1) = {"
r
r
r
r
r
o
o
o
r
r
H
j
j
j
U
u
r
r
r
r
r
r
r
r
r
r
r
r
r
r
r
r
"}
(21,1,1) = {"
r
r
r
r
r
o
o
o
o
r
T
j
s
j
V
u
r
r
r
r
r
r
r
r
r
r
r
r
r
r
r
r
"}
(22,1,1) = {"
r
r
r
o
o
o
o
o
o
r
X
D
O
O
O
P
r
r
r
r
r
r
r
r
r
r
r
r
r
r
r
r
"}
(23,1,1) = {"
r
r
r
o
o
o
o
o
o
r
r
r
r
r
r
r
r
r
r
r
r
r
r
r
r
r
r
r
r
r
r
r
"}
(24,1,1) = {"
r
r
r
o
o
o
o
o
o
r
r
r
r
r
r
r
r
r
r
r
r
r
r
r
r
r
r
r
r
r
r
r
"}
(25,1,1) = {"
r
r
r
o
o
o
o
o
o
r
r
r
r
r
r
r
r
r
r
r
r
r
r
r
r
r
r
r
r
r
r
r
"}
(26,1,1) = {"
r
r
r
o
o
o
o
o
o
o
o
o
o
r
r
o
o
o
o
o
o
o
o
r
r
r
r
r
r
r
r
r
"}
(27,1,1) = {"
r
r
r
o
o
o
o
o
o
o
o
o
o
o
o
o
o
o
o
o
o
o
o
r
r
r
r
r
r
r
r
r
"}
(28,1,1) = {"
r
r
r
r
r
r
o
o
o
o
o
o
o
o
o
o
o
o
o
r
r
r
r
r
r
r
r
r
r
r
r
r
"}
(29,1,1) = {"
r
r
r
r
r
r
o
o
o
r
r
r
r
r
r
r
r
r
r
r
r
r
r
r
r
r
r
r
r
r
r
r
"}
(30,1,1) = {"
r
r
r
r
r
r
r
r
r
r
r
r
r
r
r
r
r
r
r
r
r
r
r
r
r
r
r
r
r
r
r
r
"}
(31,1,1) = {"
r
r
r
r
r
r
r
r
r
r
r
r
r
r
r
r
r
r
r
r
r
r
r
r
r
r
r
r
r
r
r
r
"}
(32,1,1) = {"
r
r
r
r
r
r
r
r
r
r
r
r
r
r
r
r
r
r
r
r
r
r
r
r
r
r
r
r
r
r
r
r
"}
