"ac" = (/turf/simulated/floor/tiled/white,/area/exoplanet/barren/asteroid)
"as" = (/obj/machinery/body_scanconsole{dir = 8},/obj/effect/floor_decal/corner/green{dir = 10},/turf/simulated/floor/tiled/white,/area/exoplanet/barren/asteroid)
"aD" = (/obj/machinery/recharge_station,/turf/simulated/floor/tiled/dark,/area/exoplanet/barren/asteroid)
"aQ" = (/obj/machinery/door/airlock/hatch,/obj/machinery/door/blast/regular{id = "crashed"},/turf/simulated/floor/tiled/dark,/area/exoplanet/barren/asteroid)
"bg" = (/obj/effect/floor_decal/corner/green{dir = 10},/obj/machinery/light{icon_state = "tube1"},/turf/simulated/floor/tiled/white,/area/exoplanet/barren/asteroid)
"bl" = (/mob/living/simple_animal/hostile/carp/asteroid,/turf/unsimulated/floor/asteroid/ash,/area/exoplanet/barren/asteroid)
"by" = (/obj/structure/bed/stool/chair/shuttle{dir = 8},/turf/simulated/floor/tiled/dark,/area/exoplanet/barren/asteroid)
"ew" = (/obj/structure/closet/walllocker/emerglocker/east,/turf/simulated/floor/tiled/dark,/area/exoplanet/barren/asteroid)
"eA" = (/obj/structure/closet/secure_closet/guncabinet,/obj/item/ammo_magazine/mc9mm,/obj/item/ammo_magazine/mc9mm/empty,/obj/item/ammo_magazine/mc9mm/empty,/obj/item/ammo_magazine/mc9mm/empty,/turf/simulated/floor/tiled/dark,/area/exoplanet/barren/asteroid)
"eQ" = (/turf/simulated/wall/shuttle/raider,/area/exoplanet/barren/asteroid)
"fd" = (/obj/effect/floor_decal/industrial/hatch/red,/obj/structure/closet/walllocker/medical/secure{name = "blood locker"; pixel_x = 32},/obj/item/reagent_containers/blood/ripped,/turf/simulated/floor/tiled/white,/area/exoplanet/barren/asteroid)
"ga" = (/obj/machinery/light/small,/obj/structure/table/rack,/obj/random/belt,/turf/simulated/floor/tiled/dark,/area/exoplanet/barren/asteroid)
"gd" = (/obj/effect/floor_decal/corner/green{dir = 6},/turf/simulated/floor/tiled/white,/area/exoplanet/barren/asteroid)
"go" = (/obj/machinery/light/small{dir = 4},/obj/structure/bed/stool/chair/shuttle{dir = 8},/turf/simulated/floor/tiled/dark,/area/exoplanet/barren/asteroid)
"gB" = (/obj/effect/gibspawner/human,/obj/effect/gibspawner/human,/obj/item/clothing/suit/space/syndicate/black,/turf/unsimulated/floor/asteroid/ash,/area/exoplanet/barren/asteroid)
"gF" = (/obj/machinery/artifact_analyser,/turf/simulated/floor/tiled/dark,/area/exoplanet/barren/asteroid)
"gT" = (/turf/unsimulated/floor/asteroid/ash/rocky,/turf/simulated/wall/shuttle/dark/corner{dir = 6},/area/exoplanet/barren/asteroid)
"hh" = (/obj/structure/closet/crate/secure/gear,/obj/item/anomaly_core,/turf/simulated/floor/tiled/dark,/area/exoplanet/barren/asteroid)
"hj" = (/obj/machinery/cryopod{dir = 4},/turf/simulated/floor/tiled/dark,/area/exoplanet/barren/asteroid)
"hF" = (/obj/machinery/recharger/wallcharger{pixel_x = -32; pixel_y = 2},/obj/structure/table/reinforced,/obj/random/loot,/turf/simulated/floor/tiled/dark,/area/exoplanet/barren/asteroid)
"hJ" = (/obj/machinery/light/small{dir = 1},/obj/structure/table/rack,/obj/item/clothing/suit/storage/vest/heavy,/turf/simulated/floor/tiled/dark,/area/exoplanet/barren/asteroid)
"jf" = (/obj/structure/table/standard,/obj/random/firstaid,/turf/simulated/floor/tiled/white,/area/exoplanet/barren/asteroid)
"jt" = (/obj/machinery/door/airlock/hatch,/turf/simulated/floor/tiled/dark,/area/exoplanet/barren/asteroid)
"jU" = (/obj/machinery/power/rtg/advanced,/obj/structure/cable/yellow{d2 = 8; icon_state = "0-8"},/turf/simulated/floor/tiled/dark,/area/exoplanet/barren/asteroid)
"kl" = (/obj/machinery/recharger/wallcharger{pixel_x = 32; pixel_y = 2},/obj/structure/table/reinforced,/obj/item/device/binoculars,/turf/simulated/floor/tiled/dark,/area/exoplanet/barren/asteroid)
"ly" = (/turf/simulated/floor/tiled/dark,/area/exoplanet/barren/asteroid)
"lz" = (/obj/structure/computerframe,/turf/simulated/floor/tiled/dark,/area/exoplanet/barren/asteroid)
"lF" = (/obj/structure/table/standard,/obj/random/medical,/obj/machinery/light{dir = 4; icon_state = "tube1"},/turf/simulated/floor/tiled/white,/area/exoplanet/barren/asteroid)
"lR" = (/obj/structure/closet/crate/loot,/turf/simulated/floor/tiled/dark,/area/exoplanet/barren/asteroid)
"mB" = (/obj/structure/cable/yellow{d1 = 1; d2 = 2; icon_state = "1-2"},/obj/structure/cable/yellow{d1 = 1; d2 = 4; icon_state = "1-4"},/turf/simulated/floor/tiled/dark,/area/exoplanet/barren/asteroid)
"mX" = (/obj/structure/dispenser/oxygen,/turf/simulated/floor/tiled/dark,/area/exoplanet/barren/asteroid)
"nr" = (/obj/machinery/light/small{dir = 8},/obj/structure/bed/stool/chair/shuttle{dir = 4},/turf/simulated/floor/tiled/dark,/area/exoplanet/barren/asteroid)
"nT" = (/obj/machinery/power/apc{coverlocked = 0; dir = 1; environ = 0; equipment = 0; lighting = 0; locked = 0; name = "north bump"; operating = 0; pixel_y = 24},/obj/structure/cable/yellow{d2 = 2; icon_state = "0-2"},/turf/simulated/floor/tiled/dark,/area/exoplanet/barren/asteroid)
"om" = (/turf/unsimulated/floor/asteroid/ash/rocky,/turf/simulated/wall/shuttle/dark/corner{dir = 5},/area/exoplanet/barren/asteroid)
"oI" = (/obj/effect/floor_decal/corner/green{dir = 9},/obj/effect/floor_decal/corner/green{dir = 5},/turf/simulated/floor/tiled/white,/area/exoplanet/barren/asteroid)
"oU" = (/obj/machinery/light/small,/turf/simulated/floor/tiled/dark,/area/exoplanet/barren/asteroid)
"pJ" = (/turf/unsimulated/floor/asteroid/ash/rocky,/area/exoplanet/barren/asteroid)
"qe" = (/obj/machinery/suit_storage_unit/standard_unit,/turf/simulated/floor/tiled/dark,/area/exoplanet/barren/asteroid)
"qQ" = (/obj/machinery/light/small{dir = 8},/turf/simulated/floor/tiled/dark,/area/exoplanet/barren/asteroid)
"rG" = (/obj/structure/shuttle/engine/heater,/obj/structure/window/reinforced{dir = 1},/turf/simulated/floor/plating,/area/exoplanet/barren/asteroid)
"tN" = (/obj/machinery/light{dir = 1; icon_state = "tube1"},/turf/simulated/floor/tiled/dark,/area/exoplanet/barren/asteroid)
"vD" = (/obj/effect/gibspawner/human,/obj/effect/gibspawner/human,/obj/item/clothing/suit/space/syndicate/black,/turf/unsimulated/floor/asteroid/ash/rocky,/area/exoplanet/barren/asteroid)
"vW" = (/obj/structure/table/rack,/obj/item/storage/toolbox/electrical,/obj/machinery/light/small,/turf/simulated/floor/tiled/dark,/area/exoplanet/barren/asteroid)
"vY" = (/obj/structure/table/rack,/turf/simulated/floor/tiled/dark,/area/exoplanet/barren/asteroid)
"wn" = (/obj/machinery/porta_turret/xray{emagged = 1},/turf/simulated/floor/tiled/dark,/area/exoplanet/barren/asteroid)
"xf" = (/obj/structure/table/reinforced,/obj/machinery/light/small{dir = 4},/obj/random/coin,/turf/simulated/floor/tiled/dark,/area/exoplanet/barren/asteroid)
"xF" = (/obj/structure/closet/crate/large,/obj/item/archaeological_find,/turf/simulated/floor/tiled/dark,/area/exoplanet/barren/asteroid)
"xQ" = (/obj/structure/mech_wreckage/powerloader,/obj/machinery/mech_recharger,/turf/simulated/floor/tiled/dark,/area/exoplanet/barren/asteroid)
"yo" = (/obj/effect/floor_decal/corner/green{dir = 4},/turf/simulated/floor/tiled/white,/area/exoplanet/barren/asteroid)
"Ba" = (/turf/unsimulated/floor/asteroid/ash/rocky,/turf/simulated/wall/shuttle/dark/corner{dir = 9},/area/exoplanet/barren/asteroid)
"Bj" = (/obj/structure/table/rack,/obj/item/clothing/head/helmet,/turf/simulated/floor/tiled/dark,/area/exoplanet/barren/asteroid)
"Bt" = (/obj/machinery/sleeper,/turf/simulated/floor/tiled/white,/area/exoplanet/barren/asteroid)
"BM" = (/obj/structure/shuttle/engine/propulsion{icon_state = "propulsion_l"},/turf/simulated/floor/plating,/area/exoplanet/barren/asteroid)
"BO" = (/obj/effect/floor_decal/corner/green{dir = 9},/turf/simulated/floor/tiled/white,/area/exoplanet/barren/asteroid)
"CF" = (/obj/structure/closet/secure_closet/guncabinet,/obj/item/gun/energy/blaster/carbine,/turf/simulated/floor/tiled/dark,/area/exoplanet/barren/asteroid)
"Ey" = (/obj/item/clothing/head/helmet/space/syndicate/black,/obj/effect/gibspawner/human,/turf/unsimulated/floor/asteroid/ash,/area/exoplanet/barren/asteroid)
"FG" = (/obj/effect/floor_decal/corner/green{dir = 6},/obj/effect/floor_decal/corner/green{dir = 5},/obj/machinery/iv_drip,/turf/simulated/floor/tiled/white,/area/exoplanet/barren/asteroid)
"FX" = (/turf/unsimulated/floor/asteroid/ash,/area/exoplanet/barren/asteroid)
"GL" = (/obj/structure/table/rack,/obj/item/melee/baton,/turf/simulated/floor/tiled/dark,/area/exoplanet/barren/asteroid)
"HJ" = (/obj/machinery/door/airlock/hatch,/turf/simulated/floor/holofloor/tiled/dark,/area/exoplanet/barren/asteroid)
"Iu" = (/obj/structure/table/rack,/obj/random/backpack,/turf/simulated/floor/tiled/dark,/area/exoplanet/barren/asteroid)
"Iz" = (/obj/structure/closet/secure_closet/guncabinet,/obj/item/gun/projectile/pistol/sol,/turf/simulated/floor/tiled/dark,/area/exoplanet/barren/asteroid)
"IM" = (/obj/effect/floor_decal/corner/green{dir = 9},/obj/machinery/light{dir = 8; icon_state = "tube1"},/turf/simulated/floor/tiled/white,/area/exoplanet/barren/asteroid)
"IO" = (/obj/machinery/light/small{dir = 1},/obj/structure/table/rack,/turf/simulated/floor/tiled/dark,/area/exoplanet/barren/asteroid)
"Je" = (/obj/machinery/light/small{dir = 1},/turf/simulated/floor/tiled/dark,/area/exoplanet/barren/asteroid)
"Jy" = (/obj/effect/floor_decal/corner/green{dir = 9},/obj/machinery/bodyscanner{dir = 4},/turf/simulated/floor/tiled/white,/area/exoplanet/barren/asteroid)
"JG" = (/obj/structure/table/rack,/obj/item/storage/toolbox/syndicate,/turf/simulated/floor/tiled/dark,/area/exoplanet/barren/asteroid)
"JY" = (/obj/structure/table/standard,/obj/item/robot_parts/chest/hephaestus,/turf/simulated/floor/tiled/dark,/area/exoplanet/barren/asteroid)
"Kc" = (/obj/machinery/light{icon_state = "tube1"},/turf/simulated/floor/tiled/dark,/area/exoplanet/barren/asteroid)
"Kd" = (/obj/machinery/mech_recharger,/turf/simulated/floor/tiled/dark,/area/exoplanet/barren/asteroid)
"LN" = (/obj/structure/closet/crate/freezer/rations,/turf/simulated/floor/tiled/dark,/area/exoplanet/barren/asteroid)
"LX" = (/obj/item/clothing/head/helmet/space/syndicate/black,/obj/effect/gibspawner/human,/turf/unsimulated/floor/asteroid/ash/rocky,/area/exoplanet/barren/asteroid)
"Ml" = (/turf/simulated/mineral,/area/exoplanet/barren/asteroid)
"Mt" = (/obj/structure/grille,/obj/structure/window/reinforced,/obj/structure/window/reinforced{dir = 8},/obj/structure/window/reinforced{dir = 4},/obj/structure/window/reinforced{dir = 1},/turf/simulated/floor/plating,/area/exoplanet/barren/asteroid)
"Nc" = (/mob/living/simple_animal/hostile/carp/asteroid,/turf/unsimulated/floor/asteroid/ash/rocky,/area/exoplanet/barren/asteroid)
"Nw" = (/obj/machinery/power/rtg/advanced,/obj/machinery/light/small,/obj/structure/cable/yellow,/turf/simulated/floor/tiled/dark,/area/exoplanet/barren/asteroid)
"NA" = (/obj/machinery/light/small{dir = 4},/turf/simulated/floor/tiled/dark,/area/exoplanet/barren/asteroid)
"Qj" = (/obj/structure/shuttle/engine/propulsion{icon_state = "propulsion_r"},/turf/simulated/floor/plating,/area/exoplanet/barren/asteroid)
"QJ" = (/obj/structure/table/reinforced,/obj/item/gun/energy/retro,/obj/machinery/light/small{dir = 8},/turf/simulated/floor/tiled/dark,/area/exoplanet/barren/asteroid)
"QK" = (/obj/structure/closet/walllocker/medical/secure{pixel_x = -32; req_access = list(150)},/obj/item/stack/medical/splint,/obj/item/stack/medical/ointment,/obj/item/stack/medical/ointment,/obj/item/stack/medical/bruise_pack,/obj/item/stack/medical/bruise_pack,/obj/item/stack/medical/bruise_pack,/turf/simulated/floor/tiled/dark,/area/exoplanet/barren/asteroid)
"QQ" = (/obj/machinery/door/airlock/hatch{icon_state = "door_locked"; id_tag = "engine_access_hatch"; locked = 1; req_access = list(11)},/turf/simulated/floor/tiled/dark,/area/exoplanet/barren/asteroid)
"QX" = (/obj/structure/shuttle/engine/propulsion,/turf/simulated/floor/plating,/area/exoplanet/barren/asteroid)
"St" = (/turf/unsimulated/floor/asteroid/ash/rocky,/turf/simulated/wall/shuttle/dark/corner{dir = 10},/area/exoplanet/barren/asteroid)
"SY" = (/obj/machinery/artifact,/obj/machinery/artifact_scanpad,/turf/simulated/floor/tiled/dark,/area/exoplanet/barren/asteroid)
"Tb" = (/obj/structure/table/rack,/obj/machinery/light/small{dir = 1},/obj/item/stack/material/phoron{amount = 5},/turf/simulated/floor/tiled/dark,/area/exoplanet/barren/asteroid)
"Tj" = (/obj/structure/table/standard,/turf/simulated/floor/tiled/dark,/area/exoplanet/barren/asteroid)
"TR" = (/obj/structure/bed/stool/chair/shuttle{dir = 4},/turf/simulated/floor/tiled/dark,/area/exoplanet/barren/asteroid)
"Uw" = (/obj/effect/gibspawner/human,/obj/effect/gibspawner/human,/obj/item/clothing/suit/space/syndicate/black,/obj/item/clothing/head/helmet/space/syndicate/black,/turf/unsimulated/floor/asteroid/ash,/area/exoplanet/barren/asteroid)
"Vf" = (/obj/machinery/door/airlock/hatch{icon_state = "door_locked"; id_tag = "engine_access_hatch"; locked = 1; req_access = list(11)},/turf/simulated/floor/holofloor/tiled/dark,/area/exoplanet/barren/asteroid)
"Yu" = (/obj/machinery/button/remote/blast_door{id = "crashed"; pixel_x = 32},/obj/structure/bed/stool/chair/office/bridge,/turf/simulated/floor/tiled/dark,/area/exoplanet/barren/asteroid)
"YW" = (/obj/structure/table/rack,/obj/item/clothing/suit/space/syndicate/black,/obj/item/clothing/head/helmet/space/syndicate/black,/turf/simulated/floor/tiled/dark,/area/exoplanet/barren/asteroid)

(1,1,1) = {"
FXFXFXFXFXFXFXFXFXFXFXFXFXFXFXFXFXFXFXFXFXFXFXFXFX
FXFXFXFXFXFXFXFXFXFXFXFXFXFXFXFXFXFXFXFXFXFXFXFXFX
FXFXFXFXFXFXblFXFXFXFXpJpJpJpJFXFXFXFXFXFXFXFXFXFX
FXFXFXMlMlFXFXFXFXFXpJBaMtomFXpJFXFXFXFXMlMlFXFXFX
FXFXMlMlMlMlMlFXFXpJBaeQlzeQompJFXFXMlMlMlMlMlFXFX
FXMlMlMlMlMlMlFXpJpJeQeQYueQeQpJpJFXMlMlMlMlMlFXFX
FXMlMlMlMlMlMlFXpJFXeQhFlykleQpJFXFXFXMlMlMlMlFXFX
FXMlMlMlMlMlMlFXpJpJeQQJlyxfeQpJNcFXFXFXMlMlFXFXFX
FXFXMlMlMlMlFXpJFXBaeQlzlylzeQomFXpJFXFXFXFXFXFXFX
FXFXMlMlMlMlFXpJBaeQeQeQHJeQeQeQompJpJFXblFXFXFXFX
FXFXMlMlMlFXpJBaeQeQeQTRlybyeQeQeQomgBEyFXFXMlFXFX
FXFXFXFXFXFXpJeQeQqeeQnrlygoeQqeeQeQpJFXUwMlMlMlFX
FXFXFXFXFXFXpJQQlylyeQTRlybyeQlylyVfpJFXFXMlMlFXFX
FXFXFXFXFXFXpJQQlyNAeQQKlyeweQqQlyVfLXFXFXFXMlFXFX
FXFXblFXFXFXpJeQmXlyjtlylylyjtlymXeQpJvDFXFXFXFXFX
FXFXFXFXFXpJBaeQYWlyeQLNgaLNeQlyYWeQomFXNcFXFXFXFX
FXFXFXFXpJBaeQeQeQHJeQeQeQeQeQjteQeQeQompJFXFXFXFX
FXpJFXpJBaeQeQaDaDlyeQlyJelyeQoIBtFGeQeQompJpJFXFX
pJBaeQeQeQeQJYlylyNAeQlylylyeQIMacyojfeQeQeQeQomFX
pJeQeQtNIueQTjlylylyjtlylylyjtBOacaclFeQTbnTeQeQpJ
FXeQhjlylyHJlylylylyeQlylylyeQBOacacgdjtlymBjUeQFX
pJeQhjlylyeQvWJGxQKdeQlRoUlReQJyasbgfdeQlymBjUeQpJ
pJeQhjlylyeQeQeQeQeQeQeQeQeQeQeQeQeQeQeQlymBjUeQFX
FXeQhjlylyeQBjeAhJIzeQlyJelyeQhhIOvYxFeQlymBjUeQpJ
pJeQeQKclyaQlylylylyeQlylylyeQlylylylyaQlyNweQeQpJ
FXSteQeQeQeQoUlylylyaQlylylyaQlylylyoUeQeQeQeQgTFX
pJpJFXpJSteQeQCFvYwneQlylylyeQGLSYgFeQeQgTpJFXpJpJ
FXpJFXpJFXSteQeQeQeQeQrGrGrGeQeQeQeQeQgTpJFXFXFXFX
FXFXFXFXpJpJpJpJpJFXStBMQXQjgTFXpJpJpJFXFXFXFXFXFX
FXFXFXFXFXFXpJpJFXpJpJpJpJpJpJpJFXFXpJFXFXFXFXFXFX
"}
