"ag" = (/obj/effect/decal/cleanable/dirt,/obj/effect/decal/cleanable/dirt,/turf/unsimulated/floor{icon = 'icons/turf/shuttle.dmi'; icon_state = "floor9"},/area/exoplanet/barren/asteroid)
"ct" = (/obj/structure/window/reinforced{dir = 1},/obj/structure/table/reinforced/steel,/obj/item/clothing/accessory/badge/passcard/sol{desc = "A passcard issued to citizens of the Alliance of Sovereign Solarian Nations. This one depicts a woman from Mars, born on March 27th, 2365."},/turf/unsimulated/floor{icon = 'icons/turf/shuttle.dmi'; icon_state = "floor9"},/area/exoplanet/barren/asteroid)
"cT" = (/obj/structure/bed/stool/chair/office/bridge/pilot{dir = 4},/obj/effect/decal/cleanable/dirt,/turf/unsimulated/floor{icon = 'icons/turf/shuttle.dmi'; icon_state = "floor9"},/area/exoplanet/barren/asteroid)
"dA" = (/turf/simulated/mineral/random/high_chance,/area/exoplanet/barren/asteroid)
"ed" = (/obj/structure/closet/secure_closet/engineering_electrical{req_access = null},/obj/effect/decal/cleanable/dirt,/turf/unsimulated/floor{icon = 'icons/turf/shuttle.dmi'; icon_state = "floor9"},/area/exoplanet/barren/asteroid)
"eq" = (/obj/structure/window/reinforced{dir = 1},/turf/unsimulated/floor{icon = 'icons/turf/shuttle.dmi'; icon_state = "floor9"},/area/exoplanet/barren/asteroid)
"gf" = (/obj/structure/table/rack,/obj/random/tool,/obj/random/voidsuit/no_nanotrasen,/turf/unsimulated/floor{icon = 'icons/turf/shuttle.dmi'; icon_state = "floor9"},/area/exoplanet/barren/asteroid)
"gS" = (/obj/machinery/light/colored/red,/obj/effect/floor_decal/industrial/warning/full,/obj/effect/decal/cleanable/dirt,/obj/machinery/porta_turret/ballistic{check_arrest = 0; check_records = 0; check_wildlife = 0},/turf/unsimulated/floor{icon = 'icons/turf/shuttle.dmi'; icon_state = "floor9"},/area/exoplanet/barren/asteroid)
"ha" = (/obj/structure/window/reinforced{dir = 8},/obj/structure/window/reinforced{dir = 1},/obj/structure/computerframe,/turf/unsimulated/floor{icon = 'icons/turf/shuttle.dmi'; icon_state = "floor9"},/area/exoplanet/barren/asteroid)
"jo" = (/obj/structure/computerframe,/obj/effect/decal/cleanable/dirt,/obj/item/material/shard,/turf/unsimulated/floor{icon = 'icons/turf/shuttle.dmi'; icon_state = "floor9"},/area/exoplanet/barren/asteroid)
"jr" = (/obj/structure/railing{dir = 4},/obj/effect/decal/cleanable/dirt,/turf/simulated/floor/tiled/ramp,/area/exoplanet/barren/asteroid)
"jE" = (/obj/machinery/porta_turret/xray{check_arrest = 0; check_records = 0; check_wildlife = 0},/obj/effect/decal/cleanable/dirt,/obj/effect/floor_decal/industrial/warning/full,/turf/unsimulated/floor{icon = 'icons/turf/shuttle.dmi'; icon_state = "floor7"},/area/exoplanet/barren/asteroid)
"kc" = (/obj/structure/extinguisher_cabinet{dir = 8},/turf/simulated/wall/shuttle/dark/cardinal,/area/exoplanet/barren/asteroid)
"kK" = (/obj/item/material/shard,/turf/unsimulated/floor{icon = 'icons/turf/shuttle.dmi'; icon_state = "floor9"},/area/exoplanet/barren/asteroid)
"lZ" = (/mob/living/simple_animal/hostile/viscerator{destroy_surroundings = 0; wander = 0},/turf/unsimulated/floor/asteroid/ash,/area/exoplanet/barren/asteroid)
"mD" = (/turf/unsimulated/floor/asteroid/ash/rocky,/area/exoplanet/barren/asteroid)
"mE" = (/obj/effect/decal/cleanable/dirt,/mob/living/simple_animal/hostile/viscerator{destroy_surroundings = 0; wander = 0},/turf/unsimulated/floor{icon = 'icons/turf/shuttle.dmi'; icon_state = "floor7"},/area/exoplanet/barren/asteroid)
"mR" = (/obj/machinery/door/airlock/highsecurity{req_access = list(150)},/turf/simulated/floor/shuttle/black,/area/exoplanet/barren/asteroid)
"nt" = (/turf/simulated/mineral/surface,/area/exoplanet/barren/asteroid)
"nE" = (/obj/structure/window/reinforced{dir = 4},/obj/structure/window/reinforced,/obj/structure/computerframe,/turf/unsimulated/floor{icon = 'icons/turf/shuttle.dmi'; icon_state = "floor9"},/area/exoplanet/barren/asteroid)
"oh" = (/mob/living/simple_animal/hostile/viscerator{destroy_surroundings = 0; wander = 0},/obj/effect/decal/cleanable/dirt,/turf/unsimulated/floor{icon = 'icons/turf/shuttle.dmi'; icon_state = "floor9"},/area/exoplanet/barren/asteroid)
"ou" = (/obj/random/powercell,/obj/effect/decal/cleanable/blood/oil,/turf/unsimulated/floor{icon = 'icons/turf/shuttle.dmi'; icon_state = "floor9"},/area/exoplanet/barren/asteroid)
"pf" = (/obj/structure/table/reinforced/steel,/obj/structure/window/reinforced{dir = 8},/obj/structure/window/reinforced{dir = 1},/obj/machinery/door/window{dir = 4; req_access = list(150)},/obj/random/voidsuit/no_nanotrasen,/obj/random/voidsuit/no_nanotrasen,/turf/unsimulated/floor{icon = 'icons/turf/shuttle.dmi'; icon_state = "floor7"},/area/exoplanet/barren/asteroid)
"pV" = (/obj/structure/sign/securearea,/turf/simulated/wall/shuttle/dark/cardinal,/area/exoplanet/barren/asteroid)
"qe" = (/obj/machinery/autolathe,/obj/machinery/light/colored/red{dir = 8},/turf/unsimulated/floor{icon = 'icons/turf/shuttle.dmi'; icon_state = "floor9"},/area/exoplanet/barren/asteroid)
"qE" = (/obj/random/toolbox,/obj/effect/decal/cleanable/dirt,/turf/unsimulated/floor{icon = 'icons/turf/shuttle.dmi'; icon_state = "floor9"},/area/exoplanet/barren/asteroid)
"rj" = (/obj/machinery/door/window{dir = 1},/obj/effect/decal/cleanable/blood,/obj/effect/decal/cleanable/dirt,/turf/unsimulated/floor{icon = 'icons/turf/shuttle.dmi'; icon_state = "floor9"},/area/exoplanet/barren/asteroid)
"tD" = (/obj/machinery/light/colored/red{dir = 1},/obj/effect/decal/cleanable/dirt,/turf/unsimulated/floor{icon = 'icons/turf/shuttle.dmi'; icon_state = "floor9"},/area/exoplanet/barren/asteroid)
"uc" = (/obj/effect/decal/cleanable/dirt,/turf/unsimulated/floor{icon = 'icons/turf/shuttle.dmi'; icon_state = "floor9"},/area/exoplanet/barren/asteroid)
"up" = (/obj/effect/decal/remains/human,/obj/effect/floor_decal/industrial/warning,/obj/effect/decal/cleanable/dirt,/turf/unsimulated/floor{icon = 'icons/turf/shuttle.dmi'; icon_state = "floor9"},/area/exoplanet/barren/asteroid)
"uM" = (/obj/effect/decal/cleanable/dirt,/obj/structure/table/rack,/obj/item/stack/material/steel{amount = 50; pixel_x = -2},/obj/item/stack/material/glass/full,/obj/item/material/shard,/turf/unsimulated/floor{icon = 'icons/turf/shuttle.dmi'; icon_state = "floor9"},/area/exoplanet/barren/asteroid)
"wY" = (/obj/structure/window/reinforced,/obj/structure/window/reinforced{dir = 8},/obj/structure/computerframe,/turf/unsimulated/floor{icon = 'icons/turf/shuttle.dmi'; icon_state = "floor9"},/area/exoplanet/barren/asteroid)
"yK" = (/turf/simulated/mineral/random/higher_chance,/area/exoplanet/barren/asteroid)
"zH" = (/obj/effect/floor_decal/asteroid,/turf/unsimulated/floor/asteroid/ash,/area/exoplanet/barren/asteroid)
"Af" = (/turf/simulated/wall/shuttle/dark/cardinal,/area/exoplanet/barren/asteroid)
"Ao" = (/obj/structure/bed/stool/chair/office/bridge/pilot{dir = 8},/obj/effect/decal/cleanable/dirt,/turf/unsimulated/floor{icon = 'icons/turf/shuttle.dmi'; icon_state = "floor9"},/area/exoplanet/barren/asteroid)
"As" = (/turf/unsimulated/floor/plating,/area/exoplanet/barren/asteroid)
"Az" = (/obj/structure/grille,/obj/structure/window/reinforced{dir = 1},/obj/structure/window/reinforced{dir = 4},/obj/structure/window/reinforced,/turf/unsimulated/floor/plating,/area/exoplanet/barren/asteroid)
"Bu" = (/obj/structure/railing,/obj/structure/railing,/obj/effect/floor_decal/industrial/warning/full,/obj/machinery/porta_turret/ballistic{check_arrest = 0; check_records = 0; check_wildlife = 0},/turf/unsimulated/floor{icon = 'icons/turf/shuttle.dmi'; icon_state = "floor9"},/area/exoplanet/barren/asteroid)
"BJ" = (/obj/machinery/light/colored/red,/turf/unsimulated/floor{icon = 'icons/turf/shuttle.dmi'; icon_state = "floor9"},/area/exoplanet/barren/asteroid)
"Cf" = (/obj/effect/floor_decal/industrial/warning,/obj/effect/decal/cleanable/dirt,/turf/unsimulated/floor{icon = 'icons/turf/shuttle.dmi'; icon_state = "floor9"},/area/exoplanet/barren/asteroid)
"CA" = (/obj/effect/decal/cleanable/dirt,/obj/effect/floor_decal/industrial/warning/full,/obj/machinery/porta_turret/xray{check_arrest = 0; check_records = 0; check_wildlife = 0},/turf/unsimulated/floor{icon = 'icons/turf/shuttle.dmi'; icon_state = "floor9"},/area/exoplanet/barren/asteroid)
"CG" = (/turf/unsimulated/floor/asteroid/ash,/area/exoplanet/barren/asteroid)
"Dh" = (/obj/effect/decal/cleanable/dirt,/mob/living/simple_animal/hostile/viscerator{destroy_surroundings = 0; wander = 0},/turf/unsimulated/floor{icon = 'icons/turf/shuttle.dmi'; icon_state = "floor9"},/area/exoplanet/barren/asteroid)
"DW" = (/obj/structure/closet/crate/secure/loot,/obj/effect/decal/cleanable/dirt,/turf/unsimulated/floor{icon = 'icons/turf/shuttle.dmi'; icon_state = "floor9"},/area/exoplanet/barren/asteroid)
"EB" = (/obj/effect/decal/remains/human,/obj/effect/decal/cleanable/dirt,/turf/unsimulated/floor{icon = 'icons/turf/shuttle.dmi'; icon_state = "floor9"},/area/exoplanet/barren/asteroid)
"Fl" = (/obj/structure/extinguisher_cabinet,/turf/simulated/wall/shuttle/dark/cardinal,/area/exoplanet/barren/asteroid)
"HH" = (/obj/effect/decal/cleanable/blood,/obj/effect/decal/cleanable/dirt,/turf/unsimulated/floor{icon = 'icons/turf/shuttle.dmi'; icon_state = "floor9"},/area/exoplanet/barren/asteroid)
"IH" = (/obj/structure/closet/walllocker/emerglocker,/turf/simulated/wall/shuttle/dark/cardinal,/area/exoplanet/barren/asteroid)
"Jl" = (/obj/effect/decal/cleanable/dirt,/turf/unsimulated/floor{icon = 'icons/turf/shuttle.dmi'; icon_state = "floor7"},/area/exoplanet/barren/asteroid)
"Jw" = (/obj/structure/window/reinforced,/obj/structure/bed/stool/chair/office/bridge{dir = 4},/turf/unsimulated/floor{icon = 'icons/turf/shuttle.dmi'; icon_state = "floor9"},/area/exoplanet/barren/asteroid)
"Ll" = (/obj/effect/decal/remains/human,/obj/effect/decal/cleanable/dirt,/mob/living/simple_animal/hostile/viscerator{destroy_surroundings = 0; wander = 0},/turf/unsimulated/floor{icon = 'icons/turf/shuttle.dmi'; icon_state = "floor9"},/area/exoplanet/barren/asteroid)
"Mb" = (/obj/effect/floor_decal/industrial/warning/full,/obj/machinery/porta_turret/ballistic{check_arrest = 0; check_records = 0; check_wildlife = 0},/turf/unsimulated/floor{icon = 'icons/turf/shuttle.dmi'; icon_state = "floor9"},/area/exoplanet/barren/asteroid)
"MO" = (/obj/structure/window/reinforced{dir = 4},/obj/structure/window/reinforced{dir = 1},/obj/structure/computerframe,/turf/unsimulated/floor{icon = 'icons/turf/shuttle.dmi'; icon_state = "floor9"},/area/exoplanet/barren/asteroid)
"NI" = (/obj/structure/closet/secure_closet/engineering_welding{req_access = null},/turf/unsimulated/floor{icon = 'icons/turf/shuttle.dmi'; icon_state = "floor9"},/area/exoplanet/barren/asteroid)
"Oo" = (/obj/structure/window/reinforced,/obj/structure/bed/stool/chair/office/bridge,/turf/unsimulated/floor{icon = 'icons/turf/shuttle.dmi'; icon_state = "floor9"},/area/exoplanet/barren/asteroid)
"Oy" = (/obj/structure/window/reinforced,/obj/structure/window/reinforced{dir = 4},/obj/structure/computerframe,/turf/unsimulated/floor{icon = 'icons/turf/shuttle.dmi'; icon_state = "floor9"},/area/exoplanet/barren/asteroid)
"OI" = (/obj/structure/railing{dir = 8},/obj/effect/decal/cleanable/dirt,/turf/simulated/floor/tiled/ramp,/area/exoplanet/barren/asteroid)
"Pc" = (/obj/structure/computerframe,/obj/effect/decal/cleanable/dirt,/turf/unsimulated/floor{icon = 'icons/turf/shuttle.dmi'; icon_state = "floor9"},/area/exoplanet/barren/asteroid)
"PS" = (/obj/effect/decal/cleanable/cobweb,/obj/structure/computerframe,/obj/effect/decal/cleanable/dirt,/turf/unsimulated/floor{icon = 'icons/turf/shuttle.dmi'; icon_state = "floor9"},/area/exoplanet/barren/asteroid)
"QV" = (/obj/effect/decal/cleanable/dirt,/obj/effect/floor_decal/industrial/warning{dir = 1},/turf/unsimulated/floor{icon = 'icons/turf/shuttle.dmi'; icon_state = "floor9"},/area/exoplanet/barren/asteroid)
"QX" = (/obj/structure/window/reinforced{dir = 1},/obj/structure/table/reinforced/steel,/obj/item/paper/crumpled/bloody,/turf/unsimulated/floor{icon = 'icons/turf/shuttle.dmi'; icon_state = "floor9"},/area/exoplanet/barren/asteroid)
"Rp" = (/obj/effect/decal/cleanable/blood,/turf/unsimulated/floor{icon = 'icons/turf/shuttle.dmi'; icon_state = "floor9"},/area/exoplanet/barren/asteroid)
"Sl" = (/obj/structure/window/reinforced{dir = 1},/obj/random/junk,/turf/unsimulated/floor{icon = 'icons/turf/shuttle.dmi'; icon_state = "floor9"},/area/exoplanet/barren/asteroid)
"SZ" = (/obj/structure/bed/stool/chair/office/bridge/generic,/obj/effect/decal/remains/human,/obj/effect/decal/cleanable/dirt,/turf/unsimulated/floor{icon = 'icons/turf/shuttle.dmi'; icon_state = "floor9"},/area/exoplanet/barren/asteroid)
"Ty" = (/obj/structure/mech_wreckage,/obj/machinery/mech_recharger,/obj/effect/floor_decal/industrial/warning/full,/turf/unsimulated/floor{icon = 'icons/turf/shuttle.dmi'; icon_state = "floor9"},/area/exoplanet/barren/asteroid)
"TC" = (/obj/structure/window/reinforced{dir = 1},/obj/structure/table/reinforced/steel,/obj/item/coin/gold,/obj/item/coin/iron{pixel_y = 5; pixel_x = 6},/obj/item/coin/iron{pixel_y = -4; pixel_x = -1},/turf/unsimulated/floor{icon = 'icons/turf/shuttle.dmi'; icon_state = "floor9"},/area/exoplanet/barren/asteroid)
"TX" = (/obj/structure/window/reinforced{dir = 1},/obj/structure/window/reinforced{dir = 8},/obj/structure/computerframe,/turf/unsimulated/floor{icon = 'icons/turf/shuttle.dmi'; icon_state = "floor9"},/area/exoplanet/barren/asteroid)
"Ua" = (/obj/effect/decal/cleanable/dirt,/obj/structure/closet/wardrobe/black,/turf/unsimulated/floor{icon = 'icons/turf/shuttle.dmi'; icon_state = "floor7"},/area/exoplanet/barren/asteroid)
"UA" = (/obj/structure/window/reinforced{dir = 1},/obj/structure/window/reinforced{dir = 4},/obj/structure/computerframe,/turf/unsimulated/floor{icon = 'icons/turf/shuttle.dmi'; icon_state = "floor9"},/area/exoplanet/barren/asteroid)
"Vw" = (/obj/structure/window/reinforced{dir = 1},/obj/structure/table/reinforced/steel,/obj/item/haircomb,/obj/item/rig/industrial,/turf/unsimulated/floor{icon = 'icons/turf/shuttle.dmi'; icon_state = "floor9"},/area/exoplanet/barren/asteroid)
"WF" = (/turf/unsimulated/floor{icon = 'icons/turf/shuttle.dmi'; icon_state = "floor9"},/area/exoplanet/barren/asteroid)
"Xs" = (/obj/effect/decal/cleanable/dirt,/turf/unsimulated/floor/asteroid/ash,/area/exoplanet/barren/asteroid)
"Xu" = (/obj/structure/computerframe,/turf/unsimulated/floor{icon = 'icons/turf/shuttle.dmi'; icon_state = "floor9"},/area/exoplanet/barren/asteroid)
"Yg" = (/obj/machinery/door/airlock/hatch,/turf/simulated/floor/shuttle/dark_blue{nitrogen = 0; oxygen = 0},/area/exoplanet/barren/asteroid)
"Yw" = (/obj/structure/table/reinforced/steel,/obj/structure/window/reinforced{dir = 8},/obj/structure/window/reinforced,/obj/machinery/door/window{dir = 4; req_access = list(150)},/obj/random/weapon_and_ammo,/obj/structure/closet/crate/secure/weapon/alt{req_access = list(150)},/obj/item/clothing/accessory/storage/bayonet,/turf/unsimulated/floor{icon = 'icons/turf/shuttle.dmi'; icon_state = "floor7"},/area/exoplanet/barren/asteroid)
"YI" = (/mob/living/simple_animal/hostile/viscerator{destroy_surroundings = 0; wander = 0},/turf/unsimulated/floor{icon = 'icons/turf/shuttle.dmi'; icon_state = "floor9"},/area/exoplanet/barren/asteroid)
"Zb" = (/obj/structure/window/reinforced{dir = 8},/obj/structure/window/reinforced,/obj/structure/computerframe,/turf/unsimulated/floor{icon = 'icons/turf/shuttle.dmi'; icon_state = "floor9"},/area/exoplanet/barren/asteroid)
"Zd" = (/obj/structure/grille/broken,/obj/structure/window/reinforced,/obj/item/material/shard,/turf/unsimulated/floor/plating,/area/exoplanet/barren/asteroid)
"Zm" = (/obj/effect/decal/remains/human,/turf/unsimulated/floor{icon = 'icons/turf/shuttle.dmi'; icon_state = "floor9"},/area/exoplanet/barren/asteroid)
"Zu" = (/obj/structure/bed/stool/chair/office/bridge/generic{dir = 4},/turf/unsimulated/floor{icon = 'icons/turf/shuttle.dmi'; icon_state = "floor9"},/area/exoplanet/barren/asteroid)
"ZI" = (/obj/machinery/door/airlock/hatch,/obj/effect/decal/cleanable/dirt,/turf/unsimulated/floor{icon = 'icons/turf/shuttle.dmi'; icon_state = "floor9"},/area/exoplanet/barren/asteroid)

(1,1,1) = {"
CGntntCGCGntntCGCGCGCGCGCGCGCGCGCGCGCGCGCGCGCGCGCGCGCGCGCGCGCGCG
ntyKntCGntntntCGCGntntntntCGntCGCGCGCGCGCGCGCGCGCGCGCGntntCGCGCG
CGyKntCGCGntCGCGntyKyKyKntntCGCGntCGntntzHCGCGCGCGCGyKyKyKyKntCG
CGyKyKntCGCGCGntntntyKntCGCGCGCGCGntntntCGCGCGCGCGntyKntyKyKntnt
CGyKyKntCGCGCGCGntCGntntntntntCGntntntCGCGCGCGCGCGntntntyKntntCG
ntntntCGCGCGCGntCGntntdAntntCGntntntntCGCGntntCGCGntCGCGntntCGCG
CGntCGzHCGCGntntntdAdAdAdAZdAzAfCGntCGCGntntntCGCGCGCGntCGntCGCG
CGCGCGCGCGntntntdAdAntAfjoPcXuAfAfCGntCGntntntntyKyKzHCGCGntntCG
CGntntCGntntdAdAntntAfPSAoZmcTXuAfAfntntCGCGCGntyKyKCGCGyKyKntnt
ntntntCGCGntntdAntAfAfhactucVwMOAfAfdAntntntCGCGyKCGCGCGntntntCG
ntntCGCGntntntntCGAfAfwYSZCAZunEAfAfntdAntzHCGCGCGCGCGCGntntyKCG
yKCGCGCGntCGntntntAfTXTCSlrjeqQXUAAfAfntntCGntCGntCGCGntntdAyKCG
ntntntCGCGCGzHCGAfAfZbJwYIBJLlOoOyAfAfCGntCGntntCGCGntdAdAntyKnt
CGntyKCGCGCGCGCGAfAfAfpVZIAfZIpVAfAfAfCGCGCGCGCGCGCGntntntdAntnt
yKyKntntCGCGCGCGAfucCfDhuctDucucupuckcCGntCGntCGCGntntntdAdAdAnt
ntyKyKyKntCGCGCGCGMbOIAfAfIHAfAfjrBuntntntntCGCGCGCGCGntntntntCG
CGntyKyKntCGCGCGCGWFQVAfWFuclZCGQVCGntntntCGCGntntCGCGCGntCGCGCG
ntCGntntCGCGntCGntWFWFWFWFucRpWFWFCGntntntCGntntntntCGCGCGCGCGCG
ntntCGCGCGntyKntWFWFWFWFWFWFCGucWFntCGntCGCGntntntntntzHCGCGCGCG
CGntCGzHCGntyKntWFucWFWFDWWFWFAflZCGCGCGCGCGntntntntntntCGCGCGCG
CGCGCGCGntyKntAfCGagohAfAfFlAfWFWFCGCGCGCGntntntntntntCGCGCGCGCG
ntntCGCGntntntyKAfucEBWFCGucuclZCGCGCGCGCGCGCGntntCGCGCGCGCGCGCG
ntntntCGCGCGntCGAfkKqEHHucgSEBucaglZAfCGCGCGzHCGntCGCGCGCGCGCGCG
CGntntCGCGCGCGCGAfAfAfAfYgAfAfAfmRAfAfCGntntCGCGCGCGCGCGCGCGCGCG
ntntntntCGCGCGCGAfAsNIgfWFAfUamEJlmEAfXsntCGCGCGCGntCGCGCGCGCGCG
CGCGntntntCGCGCGntAfqeZmYIIHpfJlJlJlAfntntntCGCGCGCGntntCGCGCGCG
ntyKyKyKntCGCGntntAfuMohouAfYwJljEJlAfdAntntCGCGCGCGntntntCGCGCG
ntyKyKyKntCGntCGntntAfedTyAfAfAfAfAfAfntntntCGCGCGntntntntzHntCG
CGntntyKntCGntCGCGntntCGntntntntntAfntntntntCGCGntntntntCGCGntCG
ntyKyKyKntntntCGCGzHCGCGntntntmDntdAdAntCGzHCGntntntntCGntntntCG
ntntyKntzHCGntntCGCGntntntCGntntntntntntntntCGntntntntntCGntCGCG
ntCGntCGCGntntntCGCGCGCGCGntntntntmDntntntCGCGCGntntntntntCGCGCG
"}
