//MAP CONVERTED BY dmm2tgm.py THIS HEADER COMMENT PREVENTS RECONVERSION, DO NOT REMOVE
"a" = (
/obj/structure/table/rack,
/obj/item/wirecutters,
/turf/simulated/floor/plating,
/area/shuttle/ox_container_ship/container)
"b" = (
/obj/structure/table/steel,
/obj/item/stack/rods/full,
/turf/simulated/floor/plating,
/area/shuttle/ox_container_ship/container)
"d" = (
/obj/structure/table/steel,
/obj/item/stack/material/steel/full,
/obj/item/storage/toolbox/mechanical{
	pixel_y = 1;
	pixel_x = 10
	},
/turf/simulated/floor/plating,
/area/shuttle/ox_container_ship/container)
"i" = (
/obj/structure/table/rack,
/obj/item/device/multitool,
/turf/simulated/floor/plating,
/area/shuttle/ox_container_ship/container)
"l" = (
/obj/structure/table/rack,
/obj/item/crowbar,
/turf/simulated/floor/plating,
/area/shuttle/ox_container_ship/container)
"s" = (
/obj/item/material/twohanded/fireaxe,
/obj/structure/table/rack,
/turf/simulated/floor/plating,
/area/shuttle/ox_container_ship/container)
"C" = (
/obj/structure/table/rack,
/obj/item/wrench,
/turf/simulated/floor/plating,
/area/shuttle/ox_container_ship/container)
"F" = (
/obj/machinery/door/airlock/palepurple,
/turf/simulated/floor/plating,
/area/shuttle/ox_container_ship/container)
"H" = (
/obj/structure/table/rack,
/obj/item/pipewrench,
/turf/simulated/floor/plating,
/area/shuttle/ox_container_ship/container)
"J" = (
/turf/simulated/wall/shuttle/palepurple/cardinal,
/area/shuttle/ox_container_ship/container)
"S" = (
/obj/machinery/vending/tool,
/turf/simulated/floor/plating,
/area/shuttle/ox_container_ship/container)
"T" = (
/obj/machinery/vending/vendors{
	req_access = null
	},
/turf/simulated/floor/plating,
/area/shuttle/ox_container_ship/container)
"X" = (
/turf/simulated/floor/plating,
/area/shuttle/ox_container_ship/container)

(1,1,1) = {"
J
J
F
J
J
"}
(2,1,1) = {"
J
T
X
s
J
"}
(3,1,1) = {"
J
S
X
d
J
"}
(4,1,1) = {"
J
T
X
b
J
"}
(5,1,1) = {"
J
S
X
l
J
"}
(6,1,1) = {"
J
i
X
H
J
"}
(7,1,1) = {"
J
a
X
C
J
"}
(8,1,1) = {"
J
J
F
J
J
"}
