//MAP CONVERTED BY dmm2tgm.py THIS HEADER COMMENT PREVENTS RECONVERSION, DO NOT REMOVE
"a" = (
/turf/simulated/floor/plating,
/area/shuttle/ox_container_ship/container)
"g" = (
/obj/item/mecha_equipment/clamp,
/obj/effect/floor_decal/industrial/outline/yellow,
/turf/simulated/floor/plating,
/area/shuttle/ox_container_ship/container)
"k" = (
/obj/item/mecha_equipment/drill,
/obj/structure/table/rack,
/obj/effect/floor_decal/industrial/outline/yellow,
/turf/simulated/floor/plating,
/area/shuttle/ox_container_ship/container)
"n" = (
/obj/item/rig_module/device/basicdrill,
/obj/structure/table/rack,
/obj/effect/floor_decal/industrial/outline/yellow,
/turf/simulated/floor/plating,
/area/shuttle/ox_container_ship/container)
"s" = (
/obj/item/rig_module/chem_dispenser/combat,
/obj/structure/table/rack,
/obj/effect/floor_decal/industrial/outline/yellow,
/turf/simulated/floor/plating,
/area/shuttle/ox_container_ship/container)
"u" = (
/obj/item/mecha_equipment/light,
/obj/structure/table/rack,
/obj/effect/floor_decal/industrial/outline/yellow,
/turf/simulated/floor/plating,
/area/shuttle/ox_container_ship/container)
"v" = (
/obj/item/rig_module/actuators,
/obj/structure/table/rack,
/obj/effect/floor_decal/industrial/outline/yellow,
/turf/simulated/floor/plating,
/area/shuttle/ox_container_ship/container)
"A" = (
/obj/item/mecha_equipment/quick_enter,
/obj/effect/floor_decal/industrial/outline/yellow,
/turf/simulated/floor/plating,
/area/shuttle/ox_container_ship/container)
"E" = (
/obj/item/mecha_equipment/autolathe,
/obj/effect/floor_decal/industrial/outline/yellow,
/turf/simulated/floor/plating,
/area/shuttle/ox_container_ship/container)
"F" = (
/obj/machinery/door/airlock/palepurple,
/turf/simulated/floor/plating,
/area/shuttle/ox_container_ship/container)
"J" = (
/turf/simulated/wall/shuttle/palepurple/cardinal,
/area/shuttle/ox_container_ship/container)
"K" = (
/obj/item/mecha_equipment/crisis_drone,
/obj/structure/table/rack,
/obj/effect/floor_decal/industrial/outline/yellow,
/turf/simulated/floor/plating,
/area/shuttle/ox_container_ship/container)
"M" = (
/obj/item/mecha_equipment/mounted_system/medanalyzer,
/obj/structure/table/rack,
/obj/effect/floor_decal/industrial/outline/yellow,
/turf/simulated/floor/plating,
/area/shuttle/ox_container_ship/container)
"P" = (
/obj/item/stack/material/plasteel/full{
	pixel_y = 1;
	pixel_x = -3
	},
/obj/item/stack/material/plasteel/full{
	pixel_x = -4;
	pixel_y = 1
	},
/obj/item/stack/material/steel/full{
	pixel_x = 5;
	pixel_y = -4
	},
/obj/item/stack/material/steel/full{
	pixel_y = -4;
	pixel_x = 5
	},
/obj/structure/table/rack,
/obj/effect/floor_decal/industrial/outline/yellow,
/turf/simulated/floor/plating,
/area/shuttle/ox_container_ship/container)
"S" = (
/obj/random/rig_module,
/obj/effect/floor_decal/industrial/outline/yellow,
/turf/simulated/floor/plating,
/area/shuttle/ox_container_ship/container)

(1,1,1) = {"
J
J
F
J
J
"}
(2,1,1) = {"
J
g
a
P
J
"}
(3,1,1) = {"
J
A
a
s
J
"}
(4,1,1) = {"
J
S
a
u
J
"}
(5,1,1) = {"
J
k
a
K
J
"}
(6,1,1) = {"
J
n
a
M
J
"}
(7,1,1) = {"
J
E
a
v
J
"}
(8,1,1) = {"
J
J
F
J
J
"}
