//MAP CONVERTED BY dmm2tgm.py THIS HEADER COMMENT PREVENTS RECONVERSION, DO NOT REMOVE
"a" = (
/turf/simulated/floor/plating,
/area/shuttle/ox_container_ship/container)
"b" = (
/obj/structure/closet,
/obj/item/clothing/suit/wizard_costume,
/obj/item/clothing/head/wizard,
/obj/item/toy/figure/wizard,
/turf/simulated/floor/plating,
/area/shuttle/ox_container_ship/container)
"c" = (
/obj/structure/closet,
/obj/item/clothing/suit/marisa_costume,
/obj/item/clothing/head/marisa_hat,
/turf/simulated/floor/plating,
/area/shuttle/ox_container_ship/container)
"e" = (
/obj/structure/closet,
/obj/item/clothing/suit/carp_costume,
/obj/effect/floor_decal/industrial/outline/yellow,
/turf/simulated/floor/plating,
/area/shuttle/ox_container_ship/container)
"f" = (
/obj/structure/table/rack,
/obj/item/toy/katana,
/obj/effect/floor_decal/industrial/outline/yellow,
/turf/simulated/floor/plating,
/area/shuttle/ox_container_ship/container)
"g" = (
/obj/structure/closet,
/obj/item/clothing/suit/skeleton_costume,
/turf/simulated/floor/plating,
/area/shuttle/ox_container_ship/container)
"h" = (
/obj/structure/closet,
/obj/item/clothing/suit/lobster_costume,
/obj/item/clothing/head/lobster_hat,
/obj/effect/floor_decal/industrial/outline/yellow,
/turf/simulated/floor/plating,
/area/shuttle/ox_container_ship/container)
"k" = (
/obj/machinery/vending/coffee/free,
/turf/simulated/floor/plating,
/area/shuttle/ox_container_ship/container)
"v" = (
/obj/structure/table/rack,
/obj/item/toy/ammo/crossbow,
/obj/item/toy/ammo/crossbow,
/obj/item/toy/ammo/crossbow,
/obj/item/toy/ammo/crossbow,
/obj/item/toy/ammo/crossbow,
/obj/effect/floor_decal/industrial/outline/yellow,
/turf/simulated/floor/plating,
/area/shuttle/ox_container_ship/container)
"y" = (
/obj/structure/table/rack,
/obj/item/toy/cultsword,
/obj/effect/floor_decal/industrial/outline/yellow,
/turf/simulated/floor/plating,
/area/shuttle/ox_container_ship/container)
"E" = (
/obj/machinery/vending/coffee/free,
/obj/effect/floor_decal/industrial/outline/yellow,
/turf/simulated/floor/plating,
/area/shuttle/ox_container_ship/container)
"F" = (
/obj/machinery/door/airlock/palepurple,
/turf/simulated/floor/plating,
/area/shuttle/ox_container_ship/container)
"J" = (
/turf/simulated/wall/shuttle/palepurple/cardinal,
/area/shuttle/ox_container_ship/container)
"K" = (
/obj/structure/table/rack,
/obj/item/toy/crossbow,
/obj/effect/floor_decal/industrial/outline/yellow,
/turf/simulated/floor/plating,
/area/shuttle/ox_container_ship/container)
"O" = (
/obj/item/toy/comic/inspector,
/obj/item/toy/comic/outlandish_tales{
	pixel_y = 3
	},
/obj/item/toy/comic/stormman{
	pixel_y = 8
	},
/obj/structure/table/rack,
/obj/effect/floor_decal/industrial/outline/yellow,
/turf/simulated/floor/plating,
/area/shuttle/ox_container_ship/container)

(1,1,1) = {"
J
J
F
J
J
"}
(2,1,1) = {"
J
g
a
b
J
"}
(3,1,1) = {"
J
O
a
e
J
"}
(4,1,1) = {"
J
y
a
v
J
"}
(5,1,1) = {"
J
K
a
f
J
"}
(6,1,1) = {"
J
E
a
h
J
"}
(7,1,1) = {"
J
k
a
c
J
"}
(8,1,1) = {"
J
J
F
J
J
"}
