//MAP CONVERTED BY dmm2tgm.py THIS HEADER COMMENT PREVENTS RECONVERSION, DO NOT REMOVE
"a" = (
/turf/simulated/floor/plating,
/area/shuttle/ox_container_ship/container)
"d" = (
/obj/effect/floor_decal/industrial/outline/yellow,
/obj/item/storage/firstaid/combat,
/obj/item/storage/firstaid/fire,
/obj/item/storage/firstaid/o2,
/obj/structure/closet/crate/medical,
/turf/simulated/floor/plating,
/area/shuttle/ox_container_ship/container)
"e" = (
/obj/effect/floor_decal/industrial/outline/yellow,
/obj/item/storage/firstaid/surgery,
/obj/item/storage/firstaid/surgery,
/obj/structure/closet/crate/medical,
/obj/structure/sign/flag/zenghu/left{
	pixel_y = 32
	},
/turf/simulated/floor/plating,
/area/shuttle/ox_container_ship/container)
"j" = (
/obj/effect/floor_decal/industrial/outline/yellow,
/obj/machinery/iv_drip,
/turf/simulated/floor/plating,
/area/shuttle/ox_container_ship/container)
"q" = (
/obj/effect/floor_decal/industrial/outline/yellow,
/obj/item/roller,
/obj/item/roller{
	pixel_y = 16
	},
/turf/simulated/floor/plating,
/area/shuttle/ox_container_ship/container)
"r" = (
/obj/effect/floor_decal/industrial/outline/yellow,
/obj/item/roller,
/turf/simulated/floor/plating,
/area/shuttle/ox_container_ship/container)
"E" = (
/obj/effect/floor_decal/industrial/outline/yellow,
/obj/item/storage/firstaid/adv,
/obj/item/storage/firstaid/brute,
/obj/item/storage/firstaid/regular,
/obj/structure/closet/crate/medical,
/turf/simulated/floor/plating,
/area/shuttle/ox_container_ship/container)
"F" = (
/obj/machinery/door/airlock/palepurple,
/turf/simulated/floor/plating,
/area/shuttle/ox_container_ship/container)
"G" = (
/obj/structure/closet/crate/medical,
/obj/effect/floor_decal/industrial/outline/yellow,
/obj/item/storage/backpack/duffel/zeng,
/obj/random/medical,
/obj/random/medical,
/obj/random/medical,
/obj/random/medical,
/obj/random/medical,
/obj/random/medical,
/obj/random/medical,
/obj/random/medical,
/obj/random/medical,
/turf/simulated/floor/plating,
/area/shuttle/ox_container_ship/container)
"J" = (
/turf/simulated/wall/shuttle/palepurple/cardinal,
/area/shuttle/ox_container_ship/container)
"R" = (
/obj/effect/floor_decal/industrial/outline/yellow,
/obj/item/deployable_kit/surgery_table,
/obj/item/deployable_kit/surgery_table,
/obj/structure/closet/crate/medical,
/obj/structure/sign/flag/zenghu/right{
	pixel_y = 32
	},
/turf/simulated/floor/plating,
/area/shuttle/ox_container_ship/container)
"Z" = (
/obj/structure/closet/crate/medical,
/obj/effect/floor_decal/industrial/outline/yellow,
/obj/item/storage/box/bloodpacks,
/obj/item/reagent_containers/blood/OMinus{
	pixel_x = -4
	},
/obj/item/reagent_containers/blood/OMinus{
	pixel_x = 4
	},
/obj/item/reagent_containers/blood/OMinus{
	pixel_x = -6
	},
/obj/item/reagent_containers/blood/OMinus{
	pixel_y = 0;
	pixel_x = 5
	},
/turf/simulated/floor/plating,
/area/shuttle/ox_container_ship/container)

(1,1,1) = {"
J
J
F
J
J
"}
(2,1,1) = {"
J
G
a
a
J
"}
(3,1,1) = {"
J
j
j
a
J
"}
(4,1,1) = {"
J
e
E
a
J
"}
(5,1,1) = {"
J
R
d
a
J
"}
(6,1,1) = {"
J
r
q
a
J
"}
(7,1,1) = {"
J
Z
a
a
J
"}
(8,1,1) = {"
J
J
F
J
J
"}
