//MAP CONVERTED BY dmm2tgm.py THIS HEADER COMMENT PREVENTS RECONVERSION, DO NOT REMOVE
"a" = (
/turf/simulated/floor/plating,
/area/shuttle/ox_container_ship/container)
"f" = (
/obj/item/aiModule/nanotrasen,
/obj/structure/closet/crate/secure,
/obj/structure/window/reinforced{
	dir = 8
	},
/obj/structure/window/reinforced,
/obj/structure/railing/mapped{
	dir = 1
	},
/turf/simulated/floor/plating,
/area/shuttle/ox_container_ship/container)
"j" = (
/obj/item/clothing/suit/storage/toggle/labcoat/nt,
/obj/item/clothing/suit/storage/toggle/labcoat/nt,
/obj/structure/closet,
/turf/simulated/floor/plating,
/area/shuttle/ox_container_ship/container)
"p" = (
/obj/structure/table/rack,
/obj/item/pickaxe/drill{
	pixel_y = 5
	},
/obj/item/pickaxe/drill{
	pixel_y = -5
	},
/turf/simulated/floor/plating,
/area/shuttle/ox_container_ship/container)
"v" = (
/obj/structure/table/rack,
/obj/item/clothing/shoes/magboots,
/obj/item/clothing/suit/space/void/sci,
/obj/item/clothing/head/helmet/space/void/sci,
/turf/simulated/floor/plating,
/area/shuttle/ox_container_ship/container)
"y" = (
/obj/structure/sign/flag/nanotrasen{
	pixel_y = 32
	},
/obj/effect/floor_decal/industrial/outline/yellow,
/obj/machinery/floodlight,
/turf/simulated/floor/plating,
/area/shuttle/ox_container_ship/container)
"E" = (
/obj/item/circuitboard/ntnet_relay,
/obj/structure/closet/crate/secure,
/obj/structure/window/reinforced{
	dir = 4
	},
/obj/structure/window/reinforced,
/obj/structure/railing/mapped{
	dir = 1
	},
/turf/simulated/floor/plating,
/area/shuttle/ox_container_ship/container)
"F" = (
/obj/machinery/door/airlock/palepurple,
/turf/simulated/floor/plating,
/area/shuttle/ox_container_ship/container)
"H" = (
/obj/item/clothing/suit/storage/toggle/longcoat/nt,
/obj/structure/closet,
/turf/simulated/floor/plating,
/area/shuttle/ox_container_ship/container)
"J" = (
/turf/simulated/wall/shuttle/palepurple/cardinal,
/area/shuttle/ox_container_ship/container)
"M" = (
/obj/effect/floor_decal/industrial/outline/yellow,
/obj/machinery/suspension_gen{
	dir = 1
	},
/turf/simulated/floor/plating,
/area/shuttle/ox_container_ship/container)
"P" = (
/obj/effect/floor_decal/industrial/outline/yellow,
/obj/machinery/floodlight,
/turf/simulated/floor/plating,
/area/shuttle/ox_container_ship/container)
"Q" = (
/obj/structure/closet/excavation,
/obj/effect/floor_decal/industrial/outline/yellow,
/turf/simulated/floor/plating,
/area/shuttle/ox_container_ship/container)
"U" = (
/obj/item/storage/backpack/duffel/nt,
/obj/item/storage/backpack/messenger/nt,
/obj/structure/closet,
/turf/simulated/floor/plating,
/area/shuttle/ox_container_ship/container)

(1,1,1) = {"
J
J
F
J
J
"}
(2,1,1) = {"
J
j
a
Q
J
"}
(3,1,1) = {"
J
H
a
Q
J
"}
(4,1,1) = {"
J
U
a
f
J
"}
(5,1,1) = {"
J
M
a
E
J
"}
(6,1,1) = {"
J
y
a
v
J
"}
(7,1,1) = {"
J
P
a
p
J
"}
(8,1,1) = {"
J
J
F
J
J
"}
