//MAP CONVERTED BY dmm2tgm.py THIS HEADER COMMENT PREVENTS RECONVERSION, DO NOT REMOVE
"a" = (
/turf/simulated/floor/plating,
/area/shuttle/ox_container_ship/container)
"F" = (
/obj/machinery/door/airlock/palepurple,
/turf/simulated/floor/plating,
/area/shuttle/ox_container_ship/container)
"J" = (
/turf/simulated/wall/shuttle/palepurple/cardinal,
/area/shuttle/ox_container_ship/container)
"Z" = (
/obj/structure/trash_pile,
/turf/simulated/floor/plating,
/area/shuttle/ox_container_ship/container)

(1,1,1) = {"
J
J
F
J
J
"}
(2,1,1) = {"
J
Z
a
Z
J
"}
(3,1,1) = {"
J
Z
a
Z
J
"}
(4,1,1) = {"
J
Z
a
Z
J
"}
(5,1,1) = {"
J
Z
a
Z
J
"}
(6,1,1) = {"
J
Z
a
Z
J
"}
(7,1,1) = {"
J
Z
a
Z
J
"}
(8,1,1) = {"
J
J
F
J
J
"}
