//MAP CONVERTED BY dmm2tgm.py THIS HEADER COMMENT PREVENTS RECONVERSION, DO NOT REMOVE
"a" = (
/turf/simulated/floor/plating,
/area/shuttle/ox_container_ship/container)
"u" = (
/obj/random/animal_crate,
/obj/effect/floor_decal/industrial/outline/yellow,
/turf/simulated/floor/plating,
/area/shuttle/ox_container_ship/container)
"z" = (
/obj/effect/floor_decal/industrial/outline/yellow,
/turf/simulated/floor/plating,
/area/shuttle/ox_container_ship/container)
"B" = (
/obj/random/animal_crate,
/turf/simulated/floor/plating,
/area/shuttle/ox_container_ship/container)
"F" = (
/obj/machinery/door/airlock/palepurple,
/turf/simulated/floor/plating,
/area/shuttle/ox_container_ship/container)
"J" = (
/turf/simulated/wall/shuttle/palepurple/cardinal,
/area/shuttle/ox_container_ship/container)

(1,1,1) = {"
J
J
F
J
J
"}
(2,1,1) = {"
J
B
a
B
J
"}
(3,1,1) = {"
J
z
a
z
J
"}
(4,1,1) = {"
J
z
a
u
J
"}
(5,1,1) = {"
J
u
a
z
J
"}
(6,1,1) = {"
J
z
a
z
J
"}
(7,1,1) = {"
J
B
a
B
J
"}
(8,1,1) = {"
J
J
F
J
J
"}
