//MAP CONVERTED BY dmm2tgm.py THIS HEADER COMMENT PREVENTS RECONVERSION, DO NOT REMOVE
"a" = (
/turf/simulated/floor/plating,
/area/shuttle/ox_container_ship/container)
"i" = (
/obj/effect/floor_decal/industrial/outline/yellow,
/obj/machinery/portable_atmospherics/canister/carbon_dioxide,
/turf/simulated/floor/plating,
/area/shuttle/ox_container_ship/container)
"s" = (
/obj/effect/floor_decal/industrial/outline/yellow,
/turf/simulated/floor/plating,
/area/shuttle/ox_container_ship/container)
"F" = (
/obj/machinery/door/airlock/palepurple,
/turf/simulated/floor/plating,
/area/shuttle/ox_container_ship/container)
"J" = (
/turf/simulated/wall/shuttle/palepurple/cardinal,
/area/shuttle/ox_container_ship/container)
"S" = (
/obj/effect/floor_decal/industrial/outline/yellow,
/obj/structure/closet/crate/loot,
/turf/simulated/floor/plating,
/area/shuttle/ox_container_ship/container)
"X" = (
/obj/structure/closet/crate/loot,
/obj/effect/floor_decal/industrial/outline/yellow,
/turf/simulated/floor/plating,
/area/shuttle/ox_container_ship/container)

(1,1,1) = {"
J
J
F
J
J
"}
(2,1,1) = {"
J
s
a
s
J
"}
(3,1,1) = {"
J
s
a
X
J
"}
(4,1,1) = {"
J
S
a
i
J
"}
(5,1,1) = {"
J
i
a
s
J
"}
(6,1,1) = {"
J
i
a
S
J
"}
(7,1,1) = {"
J
s
a
X
J
"}
(8,1,1) = {"
J
J
F
J
J
"}
