//MAP CONVERTED BY dmm2tgm.py THIS HEADER COMMENT PREVENTS RECONVERSION, DO NOT REMOVE
"a" = (
/turf/simulated/floor/exoplanet/water/shallow/konyang/beach,
/area/exoplanet/grass/konyang)
"e" = (
/obj/structure/flora/rock/konyang/water,
/turf/simulated/floor/exoplanet/water/shallow/konyang/beach,
/area/exoplanet/grass/konyang)
"h" = (
/obj/structure/flora/rock/konyang/water,
/obj/structure/flora/bush/konyang_reeds/water,
/turf/simulated/floor/exoplanet/water/shallow/konyang/beach,
/area/exoplanet/grass/konyang)
"m" = (
/turf/simulated/floor/exoplanet/water/konyang,
/area/exoplanet/grass/konyang)
"n" = (
/obj/structure/flora/bush/konyang_reeds,
/turf/simulated/floor/exoplanet/konyang,
/area/exoplanet/grass/konyang)
"q" = (
/obj/structure/flora/bush/konyang_reeds/water,
/turf/simulated/floor/exoplanet/water/shallow/konyang/beach,
/area/exoplanet/grass/konyang)
"u" = (
/turf/simulated/floor/exoplanet/dirt_konyang/sand,
/area/exoplanet/grass/konyang)
"v" = (
/mob/living/simple_animal/hostile/retaliate/aquatic/thresher,
/turf/simulated/floor/exoplanet/water/shallow/konyang/beach,
/area/exoplanet/grass/konyang)
"y" = (
/turf/simulated/floor/exoplanet/konyang,
/area/exoplanet/grass/konyang)
"G" = (
/obj/structure/flora/rock/konyang/small,
/turf/simulated/floor/exoplanet/dirt_konyang/sand,
/area/exoplanet/grass/konyang)
"I" = (
/obj/structure/flora/rock/random,
/turf/simulated/floor/exoplanet/dirt_konyang/sand,
/area/exoplanet/grass/konyang)
"M" = (
/obj/structure/flora/tree/konyang/spring,
/turf/simulated/floor/exoplanet/konyang,
/area/exoplanet/grass/konyang)
"Q" = (
/obj/structure/flora/rock/konyang/moss,
/turf/simulated/floor/exoplanet/konyang,
/area/exoplanet/grass/konyang)
"R" = (
/obj/structure/flora/rock/konyang/small,
/obj/structure/flora/bush/konyang_reeds,
/turf/simulated/floor/exoplanet/dirt_konyang/sand,
/area/exoplanet/grass/konyang)
"Z" = (
/obj/structure/flora/bush/konyang_reeds,
/turf/simulated/floor/exoplanet/dirt_konyang/sand,
/area/exoplanet/grass/konyang)

(1,1,1) = {"
m
m
m
m
m
m
m
m
m
m
m
m
m
m
m
m
m
m
m
m
m
m
m
m
m
m
m
m
m
m
"}
(2,1,1) = {"
m
m
m
m
m
m
m
m
m
m
m
a
a
a
m
m
m
m
m
a
a
a
a
a
a
a
m
m
m
m
"}
(3,1,1) = {"
m
m
q
q
a
a
m
m
m
a
a
a
a
a
a
a
a
a
a
a
a
a
a
a
a
a
a
m
m
m
"}
(4,1,1) = {"
m
a
q
q
a
a
a
a
a
a
a
a
a
a
a
e
a
a
a
q
q
e
a
a
a
a
a
a
m
m
"}
(5,1,1) = {"
m
q
q
q
a
a
a
a
q
q
a
a
a
a
a
a
a
a
a
q
q
a
a
a
a
a
a
a
m
m
"}
(6,1,1) = {"
m
a
a
a
u
u
a
a
q
q
a
e
a
a
a
a
q
q
a
q
q
a
a
a
a
a
a
a
m
m
"}
(7,1,1) = {"
m
a
a
u
u
u
u
a
q
q
a
a
a
a
a
a
a
a
a
a
a
a
a
a
a
a
a
a
a
m
"}
(8,1,1) = {"
m
a
u
u
Z
R
u
u
a
a
a
q
a
a
G
Z
u
u
a
a
a
a
a
q
a
e
a
a
a
m
"}
(9,1,1) = {"
m
a
u
Z
Z
Z
u
u
a
a
a
q
a
u
u
Z
u
G
u
u
u
a
a
q
a
a
a
a
a
m
"}
(10,1,1) = {"
m
a
G
u
u
u
u
a
a
e
q
a
a
u
u
Z
Q
y
u
I
u
a
a
a
a
a
a
a
a
m
"}
(11,1,1) = {"
m
a
a
u
u
u
a
a
a
a
q
a
a
u
I
y
y
y
y
u
u
u
a
a
q
q
a
a
a
m
"}
(12,1,1) = {"
m
a
a
a
a
a
a
a
q
q
a
a
u
u
y
y
M
y
y
u
u
u
a
a
q
q
a
a
m
m
"}
(13,1,1) = {"
m
q
q
a
e
a
a
a
q
q
a
a
u
Z
n
y
y
y
u
u
G
u
a
a
q
q
a
a
m
m
"}
(14,1,1) = {"
m
q
q
a
a
a
a
a
h
q
a
a
u
u
y
n
y
Q
I
u
u
u
a
a
a
a
a
a
m
m
"}
(15,1,1) = {"
m
a
a
a
q
a
q
a
a
a
a
a
a
u
u
u
u
u
u
Z
Z
a
a
a
a
a
a
a
m
m
"}
(16,1,1) = {"
m
m
a
a
a
a
a
a
a
a
a
a
a
u
u
Z
u
u
u
u
u
a
q
q
a
a
a
a
m
m
"}
(17,1,1) = {"
m
m
a
a
e
a
a
a
u
a
a
a
a
a
u
u
G
u
a
a
a
a
q
q
m
a
a
a
m
m
"}
(18,1,1) = {"
m
m
a
a
a
a
a
u
u
u
a
q
q
a
u
u
a
a
a
a
a
a
a
a
m
a
a
a
m
m
"}
(19,1,1) = {"
m
m
m
a
a
a
u
u
G
u
u
q
q
a
a
a
a
a
a
a
a
a
a
m
m
a
a
a
a
m
"}
(20,1,1) = {"
m
m
m
a
q
a
u
Z
u
u
a
a
a
a
a
a
v
a
q
q
a
a
a
m
m
m
a
a
a
m
"}
(21,1,1) = {"
m
m
m
a
q
a
G
Z
u
Z
a
a
a
e
a
e
a
a
q
q
e
q
a
a
m
m
m
a
m
m
"}
(22,1,1) = {"
m
m
m
a
a
a
a
u
u
Z
u
a
a
a
a
a
a
a
a
a
a
q
a
a
m
m
m
a
m
m
"}
(23,1,1) = {"
m
m
m
m
a
a
a
u
u
u
u
u
a
a
a
q
q
a
a
a
a
q
a
a
a
m
m
m
m
m
"}
(24,1,1) = {"
m
m
m
m
m
a
a
a
a
u
u
a
q
q
q
q
q
e
a
a
a
a
a
a
a
m
m
m
m
m
"}
(25,1,1) = {"
m
m
m
m
m
a
a
a
a
q
q
a
q
q
q
a
a
a
a
a
a
q
q
q
q
a
m
m
m
m
"}
(26,1,1) = {"
m
m
m
m
m
m
m
a
a
a
a
a
q
q
q
a
a
a
a
a
a
q
q
q
q
a
m
m
m
m
"}
(27,1,1) = {"
m
m
m
m
m
m
m
a
a
a
a
a
a
a
a
a
a
a
a
a
a
q
q
q
q
a
a
a
m
m
"}
(28,1,1) = {"
m
m
m
m
m
m
m
m
m
m
a
a
a
a
m
m
m
a
a
a
a
a
a
a
e
a
a
a
m
m
"}
(29,1,1) = {"
m
m
m
m
m
m
m
m
m
m
m
m
m
m
m
m
m
m
a
a
a
a
m
m
m
m
m
m
m
m
"}
(30,1,1) = {"
m
m
m
m
m
m
m
m
m
m
m
m
m
m
m
m
m
m
m
m
m
m
m
m
m
m
m
m
m
m
"}
