"a" = (/turf/space,/area/space)
"b" = (/turf/simulated/wall,/area/space)
"c" = (/turf/simulated/floor/tiled,/area/space)
"d" = (/mob/living/simple_animal/schlorrgo,/turf/simulated/floor/tiled,/area/space)
"e" = (/obj/effect/landmark/start{name = "JoinLate"},/turf/simulated/floor/tiled,/area/space)

(1,1,1) = {"
aaaabbbbbb
aaaabccccb
aaaabccdcb
aaaabccccb
aaaabecccb
aaaabbbbbb
aaaaaaaaaa
aaaaaaaaaa
aaaaaaaaaa
aaaaaaaaaa
"}
