//MAP CONVERTED BY dmm2tgm.py THIS HEADER COMMENT PREVENTS RECONVERSION, DO NOT REMOVE
"a" = (
/obj/structure/lattice/catwalk/indoor/grate/old,
/obj/structure/closet/crate,
/turf/simulated/floor,
/area/space)
"b" = (
/obj/structure/lattice/catwalk/indoor/grate,
/obj/item/reagent_containers/inhaler/soporific,
/obj/item/reagent_containers/inhaler/soporific,
/obj/item/reagent_containers/inhaler/space_drugs,
/obj/item/reagent_containers/inhaler/space_drugs,
/obj/item/reagent_containers/inhaler/space_drugs,
/obj/item/reagent_containers/inhaler/space_drugs,
/obj/structure/closet/crate/medical,
/turf/simulated/floor,
/area/space)
"n" = (
/obj/effect/decal/cleanable/dirt,
/obj/structure/lattice/catwalk/indoor/grate,
/obj/structure/largecrate/animal/adhomai/schlorrgo,
/obj/item/device/radio{
	icon_state = "radio";
	pixel_x = -1;
	pixel_y = 16
	},
/turf/simulated/floor,
/area/space)
"x" = (
/obj/structure/lattice/catwalk/indoor/grate,
/obj/item/reagent_containers/glass/bucket,
/turf/simulated/floor,
/area/space)
"z" = (
/obj/structure/lattice/catwalk/indoor/grate,
/obj/structure/bed,
/obj/item/device/flashlight,
/turf/simulated/floor,
/area/space)
"B" = (
/obj/structure/lattice/catwalk/indoor/grate/damaged,
/turf/simulated/floor,
/area/space)
"E" = (
/obj/structure/lattice/catwalk/indoor/grate/old,
/turf/simulated/floor,
/area/space)
"H" = (
/obj/structure/lattice/catwalk/indoor/grate,
/obj/structure/closet/crate,
/turf/simulated/floor,
/area/space)
"I" = (
/obj/structure/closet/crate/medical{
	name = "IAC crate"
	},
/obj/item/clothing/shoes/iac,
/obj/item/clothing/under/rank/iacjumpsuit,
/obj/item/clothing/suit/storage/hazardvest/iac,
/obj/item/clothing/mask/balaclava/iac,
/obj/item/clothing/accessory/armband/iac,
/obj/item/clothing/head/softcap/iac,
/obj/item/gun/launcher/syringe,
/obj/structure/lattice/catwalk/indoor/grate/old,
/obj/item/clothing/gloves/latex/nitrile,
/turf/simulated/floor,
/area/space)
"R" = (
/obj/structure/lattice/catwalk/indoor/grate,
/obj/structure/table/steel,
/obj/item/reagent_containers/food/snacks/liquidfood,
/obj/item/reagent_containers/food/drinks/waterbottle{
	pixel_x = -5;
	pixel_y = 5
	},
/turf/simulated/floor,
/area/space)
"S" = (
/obj/structure/lattice/catwalk/indoor/grate,
/turf/simulated/floor,
/area/space)
"V" = (
/obj/structure/lattice/catwalk/indoor/grate,
/obj/structure/closet/crate,
/obj/item/clothing/accessory/badge/passport/sol,
/obj/item/clothing/accessory/badge/passport/elyra,
/obj/item/clothing/accessory/badge/passport/dominia,
/obj/item/clothing/accessory/badge/passport/coc,
/obj/item/clothing/accessory/badge/passport,
/obj/item/stamp/sol,
/obj/item/stamp/biesel,
/obj/item/stamp/denied,
/obj/item/stamp,
/turf/simulated/floor,
/area/space)

(1,1,1) = {"
x
S
B
z
"}
(2,1,1) = {"
a
V
S
R
"}
(3,1,1) = {"
H
I
S
S
"}
(4,1,1) = {"
n
b
S
E
"}
