//MAP CONVERTED BY dmm2tgm.py THIS HEADER COMMENT PREVENTS RECONVERSION, DO NOT REMOVE
"ar" = (
/obj/machinery/vending/cigarette,
/turf/template_noop,
/area/template_noop)
"aI" = (
/obj/effect/map_effect/marker/mapmanip/submap/extract/sccv_horizon/ops_warehouse_small_storage,
/obj/structure/table/rack/no_cargo,
/obj/random/hardhat,
/obj/random/hardhat,
/obj/random/powercell,
/obj/random/powercell,
/turf/template_noop,
/area/template_noop)
"bw" = (
/obj/structure/table/rack/no_cargo,
/obj/item/rfd/piping,
/turf/template_noop,
/area/template_noop)
"cm" = (
/obj/machinery/portable_atmospherics/hydroponics,
/turf/template_noop,
/area/template_noop)
"cJ" = (
/obj/structure/closet/crate/medical,
/obj/random/firstaid,
/obj/random/medical,
/obj/random/medical,
/obj/random/medical,
/obj/random/medical,
/obj/random/medical,
/obj/random/medical,
/turf/template_noop,
/area/template_noop)
"cQ" = (
/obj/structure/table/rack/no_cargo,
/obj/item/stack/material/plastic/full,
/turf/template_noop,
/area/template_noop)
"cU" = (
/obj/structure/closet/crate/hydroponics,
/obj/item/material/minihoe,
/obj/item/material/hatchet,
/obj/item/wirecutters/clippers,
/obj/item/reagent_containers/glass/bucket,
/obj/item/storage/backpack/hydroponics,
/turf/template_noop,
/area/template_noop)
"dJ" = (
/obj/machinery/washing_machine,
/turf/template_noop,
/area/template_noop)
"dY" = (
/obj/structure/reagent_dispensers/extinguisher,
/turf/template_noop,
/area/template_noop)
"eB" = (
/obj/structure/table/wood/gamblingtable,
/obj/item/material/ashtray/glass{
	pixel_y = 6;
	pixel_x = -5
	},
/obj/random/smokable{
	pixel_y = -8;
	pixel_x = 4
	},
/obj/item/flame/lighter/zippo{
	pixel_y = -4;
	pixel_x = -8
	},
/turf/template_noop,
/area/template_noop)
"go" = (
/obj/structure/bed/stool/bar/padded{
	dir = 8;
	pixel_x = -8
	},
/turf/template_noop,
/area/template_noop)
"gp" = (
/obj/structure/closet/excavation,
/turf/template_noop,
/area/template_noop)
"gr" = (
/obj/structure/trash_pile,
/turf/template_noop,
/area/template_noop)
"is" = (
/obj/machinery/vending/overloaders,
/turf/template_noop,
/area/template_noop)
"jI" = (
/obj/structure/table/rack/no_cargo,
/obj/item/stack/material/wood/full,
/turf/template_noop,
/area/template_noop)
"kA" = (
/obj/structure/table/rack/no_cargo,
/obj/random/coin,
/turf/template_noop,
/area/template_noop)
"lG" = (
/obj/structure/table/rack/no_cargo,
/obj/random/contraband,
/turf/template_noop,
/area/template_noop)
"lI" = (
/obj/random/cookingoil,
/turf/template_noop,
/area/template_noop)
"lM" = (
/obj/structure/table/fancy/black,
/obj/random/lavalamp{
	pixel_y = 9
	},
/turf/template_noop,
/area/template_noop)
"lP" = (
/obj/structure/table/rack/no_cargo,
/obj/item/stack/material/steel/full{
	pixel_x = -7;
	pixel_y = 2
	},
/obj/item/stack/material/glass/full{
	pixel_x = 7;
	pixel_y = 2
	},
/turf/template_noop,
/area/template_noop)
"mb" = (
/obj/structure/table/rack/no_cargo,
/obj/random/tech_supply,
/obj/random/tech_supply,
/obj/random/tool,
/obj/random/tool,
/turf/template_noop,
/area/template_noop)
"mS" = (
/obj/machinery/vending/security,
/turf/template_noop,
/area/template_noop)
"nn" = (
/obj/effect/map_effect/marker_helper/mapmanip/submap/edge{
	dir = 1
	},
/turf/template_noop,
/area/template_noop)
"np" = (
/obj/structure/table/rack/no_cargo,
/obj/random/tech_supply,
/obj/random/bomb_supply,
/turf/template_noop,
/area/template_noop)
"nF" = (
/obj/effect/map_effect/marker/mapmanip/submap/extract/sccv_horizon/ops_warehouse_small_storage,
/obj/structure/trash_pile,
/turf/template_noop,
/area/template_noop)
"nK" = (
/obj/structure/closet/crate/trashcart,
/obj/random/junk,
/obj/random/junk,
/obj/random/junk,
/turf/template_noop,
/area/template_noop)
"oz" = (
/obj/structure/reagent_dispensers/fueltank,
/turf/template_noop,
/area/template_noop)
"qo" = (
/obj/effect/map_effect/marker/mapmanip/submap/extract/sccv_horizon/ops_warehouse_small_storage,
/obj/structure/closet/crate/miningcart/ore,
/turf/template_noop,
/area/template_noop)
"qI" = (
/obj/machinery/media/jukebox,
/turf/template_noop,
/area/template_noop)
"qM" = (
/obj/effect/map_effect/marker/mapmanip/submap/extract/sccv_horizon/ops_warehouse_small_storage,
/obj/structure/bed/stool/chair/sofa/right/brown{
	dir = 4
	},
/turf/template_noop,
/area/template_noop)
"qV" = (
/obj/machinery/portable_atmospherics/canister/empty/chlorine,
/turf/template_noop,
/area/template_noop)
"rC" = (
/obj/structure/table/rack/no_cargo,
/obj/random/booze,
/obj/random/booze,
/turf/template_noop,
/area/template_noop)
"rO" = (
/obj/machinery/vending/battlemonsters,
/turf/template_noop,
/area/template_noop)
"rP" = (
/obj/effect/map_effect/marker/mapmanip/submap/extract/sccv_horizon/ops_warehouse_small_storage,
/obj/structure/closet/crate,
/obj/item/stock_parts/scanning_module/adv,
/obj/item/stock_parts/micro_laser/high,
/obj/item/stock_parts/micro_laser/high,
/obj/item/stock_parts/matter_bin/super,
/obj/item/stock_parts/manipulator/nano,
/obj/item/stock_parts/manipulator/nano,
/obj/item/stock_parts/capacitor/adv,
/obj/item/stock_parts/capacitor/adv,
/turf/template_noop,
/area/template_noop)
"rQ" = (
/obj/structure/closet/crate/miningcart,
/turf/template_noop,
/area/template_noop)
"sF" = (
/obj/structure/closet/crate,
/obj/item/robot_parts/robot_component/armor,
/obj/item/robot_parts/robot_component/diagnosis_unit,
/obj/item/robot_parts/robot_component/camera,
/turf/template_noop,
/area/template_noop)
"sQ" = (
/obj/effect/map_effect/marker_helper/mapmanip/submap/edge{
	dir = 8
	},
/turf/template_noop,
/area/template_noop)
"sW" = (
/obj/effect/map_effect/marker_helper/mapmanip/submap/edge,
/turf/template_noop,
/area/template_noop)
"sY" = (
/obj/structure/table/rack/no_cargo,
/obj/item/storage/box/led_collars,
/turf/template_noop,
/area/template_noop)
"tG" = (
/obj/effect/map_effect/marker/mapmanip/submap/extract/sccv_horizon/ops_warehouse_small_storage,
/turf/template_noop,
/area/template_noop)
"tR" = (
/obj/structure/table/rack/no_cargo,
/obj/random/kitchen_staples,
/obj/random/kitchen_staples,
/turf/template_noop,
/area/template_noop)
"vj" = (
/obj/structure/largecrate,
/turf/template_noop,
/area/template_noop)
"wW" = (
/obj/structure/weightlifter,
/turf/template_noop,
/area/template_noop)
"xg" = (
/obj/effect/map_effect/marker/mapmanip/submap/extract/sccv_horizon/ops_warehouse_small_storage,
/obj/structure/closet/crate/freezer,
/obj/item/storage/box/produce,
/obj/item/storage/box/produce,
/obj/item/storage/box/produce,
/obj/item/storage/box/produce,
/turf/template_noop,
/area/template_noop)
"xI" = (
/obj/structure/closet/crate/autakh,
/turf/template_noop,
/area/template_noop)
"yk" = (
/obj/structure/table/rack/no_cargo,
/obj/item/stack/material/steel/full,
/turf/template_noop,
/area/template_noop)
"yE" = (
/obj/machinery/portable_atmospherics/canister/hydrogen,
/turf/template_noop,
/area/template_noop)
"yW" = (
/obj/structure/table/rack/no_cargo,
/obj/item/circuitboard/destructive_analyzer,
/obj/item/circuitboard/protolathe,
/obj/item/circuitboard/rdconsole,
/turf/template_noop,
/area/template_noop)
"zw" = (
/obj/structure/table/rack/no_cargo,
/obj/item/watertank/janitor,
/obj/item/clothing/gloves/janitor,
/turf/template_noop,
/area/template_noop)
"zP" = (
/obj/effect/map_effect/marker/mapmanip/submap/extract/sccv_horizon/ops_warehouse_small_storage,
/obj/random/pottedplant,
/turf/template_noop,
/area/template_noop)
"Ab" = (
/obj/structure/table/rack/no_cargo,
/obj/random/tech_supply,
/obj/random/tool,
/turf/template_noop,
/area/template_noop)
"AD" = (
/obj/effect/map_effect/marker/mapmanip/submap/extract/sccv_horizon/ops_warehouse_small_storage,
/obj/structure/table/rack/no_cargo,
/obj/random/tech_supply,
/obj/random/tool,
/obj/random/loot,
/turf/template_noop,
/area/template_noop)
"BM" = (
/obj/structure/closet/crate/miningcart/ore,
/turf/template_noop,
/area/template_noop)
"CQ" = (
/obj/structure/table/rack/no_cargo,
/obj/random/custom_ka,
/turf/template_noop,
/area/template_noop)
"Dk" = (
/obj/structure/bed/stool/chair/sofa/left/brown{
	dir = 4
	},
/turf/template_noop,
/area/template_noop)
"Dl" = (
/obj/machinery/portable_atmospherics/canister/boron,
/turf/template_noop,
/area/template_noop)
"Er" = (
/obj/machinery/media/jukebox/audioconsole,
/turf/template_noop,
/area/template_noop)
"Fb" = (
/obj/effect/map_effect/marker/mapmanip/submap/extract/sccv_horizon/ops_warehouse_small_storage,
/obj/machinery/vending/boozeomat,
/turf/template_noop,
/area/template_noop)
"Gz" = (
/turf/template_noop,
/area/template_noop)
"Hn" = (
/obj/structure/closet/crate/freezer/rations,
/turf/template_noop,
/area/template_noop)
"HL" = (
/obj/effect/map_effect/marker/mapmanip/submap/extract/sccv_horizon/ops_warehouse_small_storage,
/obj/random/keg,
/turf/template_noop,
/area/template_noop)
"HU" = (
/obj/structure/table/rack/no_cargo,
/obj/random/plushie,
/obj/random/plushie,
/obj/random/plushie,
/turf/template_noop,
/area/template_noop)
"Jc" = (
/obj/structure/table/rack/no_cargo,
/obj/random/tech_supply,
/obj/random/tech_supply,
/turf/template_noop,
/area/template_noop)
"JF" = (
/obj/structure/bed/psych,
/turf/template_noop,
/area/template_noop)
"Kn" = (
/obj/structure/punching_bag,
/turf/template_noop,
/area/template_noop)
"KW" = (
/obj/structure/table/rack/no_cargo,
/obj/item/storage/box/beanbags,
/obj/item/storage/box/beanbags,
/turf/template_noop,
/area/template_noop)
"LU" = (
/obj/machinery/vending/boozeomat/merchant,
/turf/template_noop,
/area/template_noop)
"LW" = (
/obj/structure/table/rack/no_cargo,
/obj/random/tech_supply,
/obj/random/bomb_supply,
/obj/random/loot,
/turf/template_noop,
/area/template_noop)
"LZ" = (
/obj/effect/map_effect/marker_helper/mapmanip/submap/edge{
	dir = 4
	},
/turf/template_noop,
/area/template_noop)
"MH" = (
/obj/random/junk,
/turf/template_noop,
/area/template_noop)
"MQ" = (
/obj/effect/map_effect/marker/mapmanip/submap/extract/sccv_horizon/ops_warehouse_small_storage,
/obj/machinery/vending/hydronutrients,
/turf/template_noop,
/area/template_noop)
"Nm" = (
/obj/machinery/vending/zora,
/turf/template_noop,
/area/template_noop)
"NJ" = (
/obj/structure/janitorialcart/full,
/turf/template_noop,
/area/template_noop)
"NU" = (
/obj/structure/reagent_dispensers/watertank,
/turf/template_noop,
/area/template_noop)
"Oc" = (
/obj/effect/map_effect/marker/mapmanip/submap/extract/sccv_horizon/ops_warehouse_small_storage,
/obj/structure/table/rack/no_cargo,
/obj/item/stack/material/cardboard/full,
/turf/template_noop,
/area/template_noop)
"Op" = (
/obj/effect/map_effect/marker/mapmanip/submap/extract/sccv_horizon/ops_warehouse_small_storage,
/obj/machinery/portable_atmospherics/canister/empty/phoron,
/turf/template_noop,
/area/template_noop)
"OC" = (
/obj/effect/map_effect/marker/mapmanip/submap/extract/sccv_horizon/ops_warehouse_small_storage,
/obj/structure/table/rack/no_cargo,
/obj/random/tech_supply,
/obj/random/tech_supply,
/obj/random/toolbox,
/turf/template_noop,
/area/template_noop)
"OS" = (
/obj/structure/table/rack/no_cargo,
/obj/random/syrup,
/obj/random/syrup,
/obj/random/syrup,
/obj/random/syrup,
/turf/template_noop,
/area/template_noop)
"PM" = (
/obj/structure/table/rack/no_cargo,
/obj/item/rfd/service,
/obj/item/rfd_ammo,
/turf/template_noop,
/area/template_noop)
"QV" = (
/obj/machinery/portable_atmospherics/canister/empty/helium,
/turf/template_noop,
/area/template_noop)
"Rl" = (
/obj/effect/map_effect/marker/mapmanip/submap/extract/sccv_horizon/ops_warehouse_small_storage,
/obj/structure/closet/crate,
/turf/template_noop,
/area/template_noop)
"Se" = (
/obj/machinery/vending/mredispenser,
/turf/template_noop,
/area/template_noop)
"Sl" = (
/obj/structure/closet/crate/rad/gear,
/turf/template_noop,
/area/template_noop)
"Sm" = (
/obj/structure/bed/stool/bar/padded{
	dir = 8;
	pixel_y = 0;
	pixel_x = -8
	},
/turf/template_noop,
/area/template_noop)
"SE" = (
/obj/structure/table/rack/no_cargo,
/obj/item/circuitboard/rdtechprocessor,
/obj/item/circuitboard/rdservercontrol,
/obj/item/circuitboard/rdserver,
/turf/template_noop,
/area/template_noop)
"Tf" = (
/obj/structure/closet/crate/freezer,
/obj/random/pizzabox,
/obj/random/pizzabox,
/obj/random/mre/dessert,
/obj/random/mre/dessert,
/obj/random/mre/dessert,
/obj/random/mre/dessert,
/turf/template_noop,
/area/template_noop)
"TL" = (
/obj/effect/map_effect/marker/mapmanip/submap/extract/sccv_horizon/ops_warehouse_small_storage,
/obj/machinery/vending/ramen,
/turf/template_noop,
/area/template_noop)
"Un" = (
/obj/effect/map_effect/marker/mapmanip/submap/extract/sccv_horizon/ops_warehouse_small_storage,
/obj/structure/table/wood/gamblingtable,
/obj/item/deck/cards{
	pixel_y = 3;
	pixel_x = -4
	},
/turf/template_noop,
/area/template_noop)
"Uv" = (
/obj/random/pottedplant,
/turf/template_noop,
/area/template_noop)
"UE" = (
/obj/random/dirt_75,
/turf/template_noop,
/area/template_noop)
"Vh" = (
/obj/structure/table/rack/no_cargo,
/obj/random/tech_supply,
/obj/random/tech_supply,
/obj/random/tool,
/obj/random/tool,
/obj/random/toolbox,
/turf/template_noop,
/area/template_noop)
"Vi" = (
/obj/structure/table/rack/no_cargo,
/obj/random/coin,
/obj/random/coin,
/turf/template_noop,
/area/template_noop)
"Vl" = (
/obj/effect/map_effect/marker/mapmanip/submap/extract/sccv_horizon/ops_warehouse_small_storage,
/obj/structure/closet/crate/security,
/obj/item/storage/box/handcuffs,
/obj/item/storage/box/zipties,
/turf/template_noop,
/area/template_noop)
"VO" = (
/obj/structure/table/rack/no_cargo,
/obj/item/toy/figure/janitor,
/turf/template_noop,
/area/template_noop)
"WG" = (
/obj/machinery/vending/hydroseeds,
/turf/template_noop,
/area/template_noop)
"WZ" = (
/obj/structure/closet/crate/tool,
/obj/random/toolbox,
/obj/random/tech_supply,
/obj/random/tech_supply,
/obj/random/tech_supply,
/obj/random/tool,
/obj/random/tool,
/obj/random/tool,
/turf/template_noop,
/area/template_noop)
"Xn" = (
/obj/structure/table/rack/no_cargo,
/obj/random/tech_supply,
/obj/random/toolbox,
/obj/random/tool,
/turf/template_noop,
/area/template_noop)
"XR" = (
/obj/structure/table/rack/no_cargo,
/obj/item/stack/liquidbags/half_full,
/obj/item/ammo_display,
/obj/item/ammo_display,
/turf/template_noop,
/area/template_noop)
"Zb" = (
/obj/structure/closet/crate,
/turf/template_noop,
/area/template_noop)
"ZM" = (
/obj/structure/closet/crate/extinguisher_cartridges,
/obj/item/reagent_containers/extinguisher_refill/filled,
/obj/item/reagent_containers/extinguisher_refill/filled,
/obj/item/reagent_containers/extinguisher_refill/filled,
/obj/item/reagent_containers/extinguisher_refill/filled,
/obj/item/reagent_containers/extinguisher_refill/filled,
/obj/item/reagent_containers/extinguisher_refill/filled,
/turf/template_noop,
/area/template_noop)

(1,1,1) = {"
Gz
Gz
Gz
Gz
Gz
Gz
Gz
Gz
Gz
Gz
Gz
Gz
Gz
Gz
Gz
Gz
Gz
Gz
Gz
"}
(2,1,1) = {"
Gz
Gz
Gz
LZ
Gz
Gz
Gz
Gz
Gz
Gz
Gz
LZ
Gz
Gz
Gz
Gz
Gz
Gz
Gz
"}
(3,1,1) = {"
Gz
Gz
sW
Gz
gr
Gz
Gz
nF
Gz
Gz
sW
Gz
Gz
Gz
Gz
tG
Gz
Gz
Gz
"}
(4,1,1) = {"
Gz
Gz
Gz
Gz
Gz
Gz
Gz
Gz
Gz
Gz
Gz
Gz
Gz
Gz
Gz
Gz
Gz
Gz
Gz
"}
(5,1,1) = {"
Gz
Gz
sW
gr
Gz
Gz
gr
Zb
nn
Gz
sW
Gz
Gz
Gz
Gz
Gz
nn
Gz
Gz
"}
(6,1,1) = {"
Gz
Gz
Gz
sQ
Gz
Gz
Gz
sQ
Gz
Gz
Gz
sQ
Gz
Gz
Gz
sQ
Gz
Gz
Gz
"}
(7,1,1) = {"
Gz
Gz
Gz
Gz
Gz
Gz
Gz
Gz
Gz
Gz
Gz
Gz
Gz
Gz
Gz
Gz
Gz
Gz
Gz
"}
(8,1,1) = {"
Gz
Gz
Gz
LZ
Gz
Gz
Gz
Gz
Gz
Gz
Gz
LZ
Gz
Gz
Gz
Gz
Gz
Gz
Gz
"}
(9,1,1) = {"
Gz
Gz
sW
Gz
yk
Gz
jI
Oc
Gz
Gz
sW
Zb
Zb
Gz
Zb
tG
Gz
Gz
Gz
"}
(10,1,1) = {"
Gz
Gz
Gz
Gz
Gz
Gz
Gz
Gz
Gz
Gz
Gz
Gz
Gz
Gz
Gz
Gz
Gz
Gz
Gz
"}
(11,1,1) = {"
Gz
Gz
sW
cQ
Gz
Gz
Gz
yk
nn
Gz
sW
Zb
Gz
Gz
Gz
Zb
nn
Gz
Gz
"}
(12,1,1) = {"
Gz
Gz
Gz
sQ
Gz
Gz
Gz
sQ
Gz
Gz
Gz
sQ
Gz
Gz
Gz
sQ
Gz
Gz
Gz
"}
(13,1,1) = {"
Gz
Gz
Gz
Gz
Gz
Gz
Gz
Gz
Gz
Gz
Gz
Gz
Gz
Gz
Gz
Gz
Gz
Gz
Gz
"}
(14,1,1) = {"
Gz
Gz
Gz
LZ
Gz
Gz
Gz
Gz
Gz
Gz
Gz
LZ
Gz
Gz
Gz
Gz
Gz
Gz
Gz
"}
(15,1,1) = {"
Gz
Gz
sW
Gz
Gz
Gz
np
AD
Gz
Gz
sW
Gz
Gz
Gz
vj
tG
Gz
Gz
Gz
"}
(16,1,1) = {"
Gz
Gz
Gz
Gz
Gz
Gz
Gz
Gz
Gz
Gz
Gz
Gz
Gz
Gz
Gz
Gz
Gz
Gz
Gz
"}
(17,1,1) = {"
Gz
Gz
sW
LW
Ab
Gz
Gz
Gz
nn
Gz
sW
vj
vj
Gz
Gz
Gz
nn
Gz
Gz
"}
(18,1,1) = {"
Gz
Gz
Gz
sQ
Gz
Gz
Gz
sQ
Gz
Gz
Gz
sQ
Gz
Gz
Gz
sQ
Gz
Gz
Gz
"}
(19,1,1) = {"
Gz
Gz
Gz
Gz
Gz
Gz
Gz
Gz
Gz
Gz
Gz
Gz
Gz
Gz
Gz
Gz
Gz
Gz
Gz
"}
(20,1,1) = {"
Gz
Gz
Gz
LZ
Gz
Gz
Gz
Gz
Gz
Gz
Gz
LZ
Gz
Gz
Gz
Gz
Gz
Gz
Gz
"}
(21,1,1) = {"
Gz
Gz
sW
gr
Gz
Gz
nK
tG
Gz
Gz
sW
cJ
Gz
Gz
Hn
tG
Gz
Gz
Gz
"}
(22,1,1) = {"
Gz
Gz
Gz
Gz
Gz
Gz
Gz
Gz
Gz
Gz
Gz
Gz
Gz
Gz
Gz
Gz
Gz
Gz
Gz
"}
(23,1,1) = {"
Gz
Gz
sW
Gz
nK
Gz
Gz
MH
nn
Gz
sW
Jc
WZ
Gz
Gz
Gz
nn
Gz
Gz
"}
(24,1,1) = {"
Gz
Gz
Gz
sQ
Gz
Gz
Gz
sQ
Gz
Gz
Gz
sQ
Gz
Gz
Gz
sQ
Gz
Gz
Gz
"}
(25,1,1) = {"
Gz
Gz
Gz
Gz
Gz
Gz
Gz
Gz
Gz
Gz
Gz
Gz
Gz
Gz
Gz
Gz
Gz
Gz
Gz
"}
(26,1,1) = {"
Gz
Gz
Gz
LZ
Gz
Gz
Gz
Gz
Gz
Gz
Gz
LZ
Gz
Gz
Gz
Gz
Gz
Gz
Gz
"}
(27,1,1) = {"
Gz
Gz
sW
Tf
Gz
Gz
lI
xg
Gz
Gz
sW
dY
Gz
Gz
ZM
aI
Gz
Gz
Gz
"}
(28,1,1) = {"
Gz
Gz
Gz
Gz
Gz
Gz
Gz
Gz
Gz
Gz
Gz
Gz
Gz
Gz
Gz
Gz
Gz
Gz
Gz
"}
(29,1,1) = {"
Gz
Gz
sW
rC
rC
Gz
tR
OS
nn
Gz
sW
Sl
Gz
Gz
Vh
oz
nn
Gz
Gz
"}
(30,1,1) = {"
Gz
Gz
Gz
sQ
Gz
Gz
Gz
sQ
Gz
Gz
Gz
sQ
Gz
Gz
Gz
sQ
Gz
Gz
Gz
"}
(31,1,1) = {"
Gz
Gz
Gz
Gz
Gz
Gz
Gz
Gz
Gz
Gz
Gz
Gz
Gz
Gz
Gz
Gz
Gz
Gz
Gz
"}
(32,1,1) = {"
Gz
Gz
Gz
LZ
Gz
Gz
Gz
Gz
Gz
Gz
Gz
LZ
Gz
Gz
Gz
Gz
Gz
Gz
Gz
"}
(33,1,1) = {"
Gz
Gz
sW
sY
XR
Gz
Gz
Vl
Gz
Gz
sW
Gz
VO
Gz
Gz
tG
Gz
Gz
Gz
"}
(34,1,1) = {"
Gz
Gz
Gz
Gz
Gz
Gz
Gz
Gz
Gz
Gz
Gz
Gz
Gz
Gz
Gz
Gz
Gz
Gz
Gz
"}
(35,1,1) = {"
Gz
Gz
sW
Gz
Gz
Gz
Gz
mS
nn
Gz
sW
zw
Gz
Gz
Gz
NJ
nn
Gz
Gz
"}
(36,1,1) = {"
Gz
Gz
Gz
sQ
Gz
Gz
Gz
sQ
Gz
Gz
Gz
sQ
Gz
Gz
Gz
sQ
Gz
Gz
Gz
"}
(37,1,1) = {"
Gz
Gz
Gz
Gz
Gz
Gz
Gz
Gz
Gz
Gz
Gz
Gz
Gz
Gz
Gz
Gz
Gz
Gz
Gz
"}
(38,1,1) = {"
Gz
Gz
Gz
LZ
Gz
Gz
Gz
Gz
Gz
Gz
Gz
LZ
Gz
Gz
Gz
Gz
Gz
Gz
Gz
"}
(39,1,1) = {"
Gz
Gz
sW
is
Gz
Gz
xI
OC
Gz
Gz
sW
sF
Gz
Gz
Gz
rP
Gz
Gz
Gz
"}
(40,1,1) = {"
Gz
Gz
Gz
Gz
Gz
Gz
Gz
Gz
Gz
Gz
Gz
Gz
Gz
Gz
Gz
Gz
Gz
Gz
Gz
"}
(41,1,1) = {"
Gz
Gz
sW
Xn
Gz
Gz
lP
Uv
nn
Gz
sW
gp
Gz
Gz
SE
yW
nn
Gz
Gz
"}
(42,1,1) = {"
Gz
Gz
Gz
sQ
Gz
Gz
Gz
sQ
Gz
Gz
Gz
sQ
Gz
Gz
Gz
sQ
Gz
Gz
Gz
"}
(43,1,1) = {"
Gz
Gz
Gz
Gz
Gz
Gz
Gz
Gz
Gz
Gz
Gz
Gz
Gz
Gz
Gz
Gz
Gz
Gz
Gz
"}
(44,1,1) = {"
Gz
Gz
Gz
LZ
Gz
Gz
Gz
Gz
Gz
Gz
Gz
LZ
Gz
Gz
Gz
Gz
Gz
Gz
Gz
"}
(45,1,1) = {"
Gz
Gz
sW
ar
Gz
Gz
UE
Fb
Gz
Gz
sW
qV
QV
Gz
bw
Op
Gz
Gz
Gz
"}
(46,1,1) = {"
Gz
Gz
Gz
UE
Gz
Gz
Gz
Gz
Gz
Gz
Gz
Gz
Gz
Gz
Gz
Gz
Gz
Gz
Gz
"}
(47,1,1) = {"
Gz
Gz
sW
lG
rC
Gz
PM
KW
nn
Gz
sW
Dl
Gz
Gz
yE
Gz
nn
Gz
Gz
"}
(48,1,1) = {"
Gz
Gz
Gz
sQ
Gz
Gz
Gz
sQ
Gz
Gz
Gz
sQ
Gz
Gz
Gz
sQ
Gz
Gz
Gz
"}
(49,1,1) = {"
Gz
Gz
Gz
Gz
Gz
Gz
Gz
Gz
Gz
Gz
Gz
Gz
Gz
Gz
Gz
Gz
Gz
Gz
Gz
"}
(50,1,1) = {"
Gz
Gz
Gz
LZ
Gz
Gz
Gz
Gz
Gz
Gz
Gz
LZ
Gz
Gz
Gz
Gz
Gz
Gz
Gz
"}
(51,1,1) = {"
Gz
Gz
sW
NU
cU
Gz
WG
MQ
Gz
Gz
sW
BM
Gz
Gz
rQ
qo
Gz
Gz
Gz
"}
(52,1,1) = {"
Gz
Gz
Gz
Gz
Gz
Gz
Gz
Gz
Gz
Gz
Gz
Gz
Gz
Gz
Gz
Gz
Gz
Gz
Gz
"}
(53,1,1) = {"
Gz
Gz
sW
cm
cm
Gz
cm
cm
nn
Gz
sW
CQ
Uv
Gz
mb
rQ
nn
Gz
Gz
"}
(54,1,1) = {"
Gz
Gz
Gz
sQ
Gz
Gz
Gz
sQ
Gz
Gz
Gz
sQ
Gz
Gz
Gz
sQ
Gz
Gz
Gz
"}
(55,1,1) = {"
Gz
Gz
Gz
Gz
Gz
Gz
Gz
Gz
Gz
Gz
Gz
Gz
Gz
Gz
Gz
Gz
Gz
Gz
Gz
"}
(56,1,1) = {"
Gz
Gz
Gz
LZ
Gz
Gz
Gz
Gz
Gz
Gz
Gz
LZ
Gz
Gz
Gz
Gz
Gz
Gz
Gz
"}
(57,1,1) = {"
Gz
Gz
sW
Er
Gz
Gz
Dk
qM
Gz
Gz
sW
Gz
Nm
Gz
Se
TL
Gz
Gz
Gz
"}
(58,1,1) = {"
Gz
Gz
Gz
Gz
Gz
Gz
Gz
Gz
Gz
Gz
Gz
Gz
Gz
Gz
Gz
Gz
Gz
Gz
Gz
"}
(59,1,1) = {"
Gz
Gz
sW
is
Gz
Gz
lM
JF
nn
Gz
sW
rO
Gz
Gz
Gz
mS
nn
Gz
Gz
"}
(60,1,1) = {"
Gz
Gz
Gz
sQ
Gz
Gz
Gz
sQ
Gz
Gz
Gz
sQ
Gz
Gz
Gz
sQ
Gz
Gz
Gz
"}
(61,1,1) = {"
Gz
Gz
Gz
Gz
Gz
Gz
Gz
Gz
Gz
Gz
Gz
Gz
Gz
Gz
Gz
Gz
Gz
Gz
Gz
"}
(62,1,1) = {"
Gz
Gz
Gz
LZ
Gz
Gz
Gz
Gz
Gz
Gz
Gz
LZ
Gz
Gz
Gz
Gz
Gz
Gz
Gz
"}
(63,1,1) = {"
Gz
Gz
sW
Gz
ar
Gz
Gz
HL
Gz
Gz
sW
HU
Gz
Gz
Gz
Rl
Gz
Gz
Gz
"}
(64,1,1) = {"
Gz
Gz
Gz
Gz
Gz
Gz
Gz
Gz
Gz
Gz
Gz
Gz
Gz
Gz
Gz
Gz
Gz
Gz
Gz
"}
(65,1,1) = {"
Gz
Gz
sW
Gz
Gz
Gz
Gz
Gz
nn
Gz
sW
HU
Gz
Gz
Zb
Gz
nn
Gz
Gz
"}
(66,1,1) = {"
Gz
Gz
Gz
sQ
Gz
Gz
Gz
sQ
Gz
Gz
Gz
sQ
Gz
Gz
Gz
sQ
Gz
Gz
Gz
"}
(67,1,1) = {"
Gz
Gz
Gz
Gz
Gz
Gz
Gz
Gz
Gz
Gz
Gz
Gz
Gz
Gz
Gz
Gz
Gz
Gz
Gz
"}
(68,1,1) = {"
Gz
Gz
Gz
LZ
Gz
Gz
Gz
Gz
Gz
Gz
Gz
LZ
Gz
Gz
Gz
Gz
Gz
Gz
Gz
"}
(69,1,1) = {"
Gz
Gz
sW
Uv
Uv
Gz
Uv
zP
Gz
Gz
sW
Vi
Gz
Gz
kA
tG
Gz
Gz
Gz
"}
(70,1,1) = {"
Gz
Gz
Gz
Gz
Gz
Gz
Gz
Gz
Gz
Gz
Gz
Gz
Gz
Gz
Gz
Gz
Gz
Gz
Gz
"}
(71,1,1) = {"
Gz
Gz
sW
Uv
Uv
Gz
Uv
Uv
nn
Gz
sW
Gz
gr
Gz
Gz
gr
nn
Gz
Gz
"}
(72,1,1) = {"
Gz
Gz
Gz
sQ
Gz
Gz
Gz
sQ
Gz
Gz
Gz
sQ
Gz
Gz
Gz
sQ
Gz
Gz
Gz
"}
(73,1,1) = {"
Gz
Gz
Gz
Gz
Gz
Gz
Gz
Gz
Gz
Gz
Gz
Gz
Gz
Gz
Gz
Gz
Gz
Gz
Gz
"}
(74,1,1) = {"
Gz
Gz
Gz
LZ
Gz
Gz
Gz
Gz
Gz
Gz
Gz
LZ
Gz
Gz
Gz
Gz
Gz
Gz
Gz
"}
(75,1,1) = {"
Gz
Gz
sW
qI
Gz
Gz
eB
Un
Gz
Gz
sW
wW
Gz
Gz
Gz
tG
Gz
Gz
Gz
"}
(76,1,1) = {"
Gz
Gz
Gz
Gz
Gz
Gz
Sm
go
Gz
Gz
Gz
Gz
Gz
Kn
Gz
Gz
Gz
Gz
Gz
"}
(77,1,1) = {"
Gz
Gz
sW
LU
Gz
Gz
Gz
Gz
nn
Gz
sW
dJ
Gz
Gz
Gz
Se
nn
Gz
Gz
"}
(78,1,1) = {"
Gz
Gz
Gz
sQ
Gz
Gz
Gz
sQ
Gz
Gz
Gz
sQ
Gz
Gz
Gz
sQ
Gz
Gz
Gz
"}
(79,1,1) = {"
Gz
Gz
Gz
Gz
Gz
Gz
Gz
Gz
Gz
Gz
Gz
Gz
Gz
Gz
Gz
Gz
Gz
Gz
Gz
"}
