//MAP CONVERTED BY dmm2tgm.py THIS HEADER COMMENT PREVENTS RECONVERSION, DO NOT REMOVE
"a" = (
/obj/machinery/atmospherics/unary/vent_scrubber/on,
/turf/simulated/floor/tiled,
/area/space)
"b" = (
/obj/effect/floor_decal/industrial/outline/yellow,
/obj/machinery/light/small{
	dir = 4
	},
/turf/simulated/floor/tiled,
/area/space)
"c" = (
/obj/effect/floor_decal/industrial/outline/yellow,
/obj/machinery/light/small{
	dir = 4
	},
/obj/structure/closet/crate,
/turf/simulated/floor/tiled,
/area/space)
"d" = (
/obj/effect/floor_decal/industrial/outline/yellow,
/obj/machinery/alarm/west,
/obj/item/stack/material/steel/full,
/turf/simulated/floor/tiled,
/area/space)
"f" = (
/obj/effect/floor_decal/industrial/outline/yellow,
/obj/structure/table/rack,
/turf/simulated/floor/tiled,
/area/space)
"g" = (
/turf/simulated/floor/tiled,
/area/space)
"h" = (
/obj/effect/floor_decal/industrial/outline/yellow,
/obj/structure/largecrate,
/turf/simulated/floor/tiled,
/area/space)
"i" = (
/obj/effect/floor_decal/industrial/outline/yellow,
/obj/machinery/alarm/west,
/turf/simulated/floor/tiled,
/area/space)
"k" = (
/obj/effect/floor_decal/industrial/outline/yellow,
/obj/machinery/alarm/west,
/obj/structure/closet/crate,
/turf/simulated/floor/tiled,
/area/space)
"m" = (
/obj/effect/floor_decal/industrial/outline/yellow,
/obj/machinery/light/small{
	dir = 8
	},
/obj/effect/map_effect/marker/mapmanip/submap/extract/sccv_horizon/ops_warehouse_small_storage,
/obj/structure/table/rack,
/turf/simulated/floor/tiled,
/area/space)
"n" = (
/obj/machinery/firealarm/south,
/turf/simulated/floor/tiled,
/area/space)
"p" = (
/obj/effect/floor_decal/industrial/outline/yellow,
/obj/machinery/light/small{
	dir = 8
	},
/obj/structure/closet/crate,
/turf/simulated/floor/tiled,
/area/space)
"q" = (
/obj/effect/floor_decal/industrial/outline/yellow,
/obj/structure/trash_pile,
/turf/simulated/floor/tiled,
/area/space)
"u" = (
/obj/effect/floor_decal/industrial/outline/yellow,
/obj/machinery/light/small{
	dir = 4
	},
/obj/item/stack/material/plastic/full,
/turf/simulated/floor/tiled,
/area/space)
"v" = (
/obj/effect/floor_decal/industrial/outline/yellow,
/obj/machinery/light/small{
	dir = 8
	},
/obj/effect/map_effect/marker/mapmanip/submap/extract/sccv_horizon/ops_warehouse_small_storage,
/obj/item/stack/material/cardboard/full,
/turf/simulated/floor/tiled,
/area/space)
"w" = (
/obj/effect/floor_decal/industrial/outline/yellow,
/obj/machinery/light/small{
	dir = 8
	},
/obj/effect/map_effect/marker/mapmanip/submap/extract/sccv_horizon/ops_warehouse_small_storage,
/turf/simulated/floor/tiled,
/area/space)
"x" = (
/obj/effect/floor_decal/industrial/outline/yellow,
/obj/machinery/light/small{
	dir = 4
	},
/obj/item/stack/material/steel/full,
/turf/simulated/floor/tiled,
/area/space)
"y" = (
/obj/effect/floor_decal/industrial/outline/yellow,
/turf/simulated/floor/tiled,
/area/space)
"A" = (
/obj/effect/floor_decal/industrial/outline/yellow,
/obj/item/stack/material/wood/full,
/turf/simulated/floor/tiled,
/area/space)
"B" = (
/obj/effect/floor_decal/industrial/outline/yellow,
/obj/machinery/light/small{
	dir = 4
	},
/obj/structure/trash_pile,
/turf/simulated/floor/tiled,
/area/space)
"E" = (
/turf/template_noop,
/area/space)
"G" = (
/obj/effect/floor_decal/industrial/outline/yellow,
/obj/machinery/light/small{
	dir = 8
	},
/turf/simulated/floor/tiled,
/area/space)
"I" = (
/obj/effect/floor_decal/industrial/outline/yellow,
/obj/structure/closet/crate,
/turf/simulated/floor/tiled,
/area/space)
"J" = (
/obj/machinery/atmospherics/pipe/simple/hidden/scrubbers{
	dir = 4
	},
/obj/machinery/atmospherics/pipe/simple/hidden/supply{
	dir = 4
	},
/turf/simulated/floor/tiled,
/area/space)
"K" = (
/obj/machinery/camera/network/supply{
	c_tag = "Operations - Warehouse Starboard Aft Storage Room";
	dir = 4
	},
/turf/simulated/floor/tiled,
/area/space)
"L" = (
/obj/effect/floor_decal/industrial/outline/yellow,
/obj/machinery/light/small{
	dir = 4
	},
/obj/structure/table/rack,
/turf/simulated/floor/tiled,
/area/space)
"N" = (
/obj/effect/floor_decal/industrial/outline/yellow,
/obj/item/stack/material/cardboard/full,
/turf/simulated/floor/tiled,
/area/space)
"P" = (
/obj/machinery/atmospherics/pipe/simple/hidden/scrubbers{
	dir = 5
	},
/obj/machinery/atmospherics/pipe/simple/hidden/supply{
	dir = 6
	},
/turf/simulated/floor/tiled,
/area/space)
"Q" = (
/obj/machinery/atmospherics/unary/vent_pump/on{
	dir = 1
	},
/turf/simulated/floor/tiled,
/area/space)
"U" = (
/obj/effect/floor_decal/industrial/outline/yellow,
/obj/machinery/alarm/west,
/obj/structure/trash_pile,
/turf/simulated/floor/tiled,
/area/space)
"Y" = (
/obj/effect/floor_decal/industrial/outline/yellow,
/obj/machinery/light/small{
	dir = 4
	},
/obj/structure/largecrate,
/turf/simulated/floor/tiled,
/area/space)

(1,1,1) = {"
E
E
E
E
E
E
E
E
E
E
E
E
E
E
E
E
E
E
E
"}
(2,1,1) = {"
E
E
E
E
E
E
E
E
E
E
E
E
E
E
E
E
E
E
E
"}
(3,1,1) = {"
E
E
E
G
U
K
y
w
E
E
E
G
i
K
y
w
E
E
E
"}
(4,1,1) = {"
E
E
E
g
a
P
Q
n
E
E
E
g
a
P
Q
n
E
E
E
"}
(5,1,1) = {"
E
E
E
B
y
J
q
B
E
E
E
b
y
J
y
b
E
E
E
"}
(6,1,1) = {"
E
E
E
E
E
E
E
E
E
E
E
E
E
E
E
E
E
E
E
"}
(7,1,1) = {"
E
E
E
E
E
E
E
E
E
E
E
E
E
E
E
E
E
E
E
"}
(8,1,1) = {"
E
E
E
E
E
E
E
E
E
E
E
E
E
E
E
E
E
E
E
"}
(9,1,1) = {"
E
E
E
G
d
K
A
v
E
E
E
p
k
K
I
w
E
E
E
"}
(10,1,1) = {"
E
E
E
g
a
P
Q
n
E
E
E
g
a
P
Q
n
E
E
E
"}
(11,1,1) = {"
E
E
E
u
y
J
N
x
E
E
E
c
y
J
y
c
E
E
E
"}
(12,1,1) = {"
E
E
E
E
E
E
E
E
E
E
E
E
E
E
E
E
E
E
E
"}
(13,1,1) = {"
E
E
E
E
E
E
E
E
E
E
E
E
E
E
E
E
E
E
E
"}
(14,1,1) = {"
E
E
E
E
E
E
E
E
E
E
E
E
E
E
E
E
E
E
E
"}
(15,1,1) = {"
E
E
E
G
i
K
f
m
E
E
E
G
i
K
h
w
E
E
E
"}
(16,1,1) = {"
E
E
E
g
a
P
Q
n
E
E
E
g
a
P
Q
n
E
E
E
"}
(17,1,1) = {"
E
E
E
L
f
J
y
b
E
E
E
Y
h
J
y
b
E
E
E
"}
(18,1,1) = {"
E
E
E
E
E
E
E
E
E
E
E
E
E
E
E
E
E
E
E
"}
(19,1,1) = {"
E
E
E
E
E
E
E
E
E
E
E
E
E
E
E
E
E
E
E
"}
(20,1,1) = {"
E
E
E
E
E
E
E
E
E
E
E
E
E
E
E
E
E
E
E
"}
