//MAP CONVERTED BY dmm2tgm.py THIS HEADER COMMENT PREVENTS RECONVERSION, DO NOT REMOVE
"aE" = (
/obj/machinery/power/smes/buildable,
/turf/simulated/floor/tiled,
/area/grove_sdf_outpost/power_plant)
"bn" = (
/obj/machinery/porta_turret/ballistic{
	light_range = 1
	},
/obj/effect/decal/warning_stripes,
/obj/machinery/light/small/red{
	dir = 1
	},
/turf/simulated/floor/tiled/full,
/area/grove_sdf_outpost/exterior)
"bq" = (
/turf/simulated/mineral/random/exoplanet,
/area/grove_sdf_outpost/exterior)
"bx" = (
/obj/machinery/atmospherics/unary/vent_pump/on{
	dir = 4
	},
/turf/simulated/floor/exoplanet/grass/grove,
/area/grove_sdf_outpost/exterior)
"da" = (
/obj/structure/blocker/steel/fence,
/turf/simulated/floor/exoplanet/barren,
/area/grove_sdf_outpost/exterior)
"dr" = (
/turf/simulated/floor/exoplanet/grass/grove,
/area/grove_sdf_outpost/exterior)
"dJ" = (
/obj/effect/decal/cleanable/dirt,
/obj/effect/decal/cleanable/generic,
/turf/simulated/floor/tiled/full,
/area/grove_sdf_outpost/work_area)
"dR" = (
/obj/effect/floor_decal/corner_wide/dark_green/full{
	dir = 1
	},
/obj/structure/table/reinforced/steel,
/obj/effect/decal/cleanable/cobweb2,
/obj/random/junk,
/turf/simulated/floor/tiled,
/area/grove_sdf_outpost/work_area)
"dY" = (
/obj/effect/decal/cleanable/dirt,
/obj/structure/table/reinforced/steel,
/obj/item/deck/cards,
/obj/random/junk,
/turf/simulated/floor/tiled/full,
/area/grove_sdf_outpost/main)
"fa" = (
/obj/machinery/atmospherics/pipe/simple/hidden{
	dir = 6
	},
/obj/effect/decal/cleanable/dirt,
/turf/simulated/floor/tiled/full,
/area/grove_sdf_outpost/main)
"fu" = (
/turf/simulated/floor/tiled,
/area/grove_sdf_outpost/power_plant)
"gb" = (
/obj/machinery/atmospherics/pipe/simple/hidden/scrubbers{
	dir = 4
	},
/obj/machinery/atmospherics/pipe/simple/hidden/supply{
	dir = 4
	},
/turf/simulated/floor/tiled,
/area/grove_sdf_outpost/barracks)
"gA" = (
/obj/machinery/light/small/red{
	dir = 8
	},
/turf/simulated/floor/exoplanet/barren,
/area/grove_sdf_outpost/exterior)
"gG" = (
/obj/structure/blocker/steel/fence{
	dir = 8
	},
/turf/simulated/floor/exoplanet/grass/grove,
/area/grove_sdf_outpost/exterior)
"hc" = (
/obj/structure/cable/yellow{
	icon_state = "1-2"
	},
/obj/structure/cable/yellow{
	icon_state = "1-4"
	},
/obj/structure/cable/yellow{
	icon_state = "1-8"
	},
/turf/simulated/floor/exoplanet/plating,
/area/grove_sdf_outpost/power_plant)
"hD" = (
/obj/effect/map_effect/marker/airlock,
/obj/effect/floor_decal/industrial/hatch/yellow,
/obj/machinery/atmospherics/pipe/manifold/visible{
	dir = 4
	},
/obj/effect/decal/cleanable/dirt,
/turf/simulated/floor/tiled/full,
/area/grove_sdf_outpost/entrance)
"hI" = (
/turf/simulated/wall/r_wall,
/area/grove_sdf_outpost/barracks)
"hK" = (
/turf/simulated/floor/tiled/full,
/area/grove_sdf_outpost/main)
"hM" = (
/obj/effect/decal/cleanable/dirt,
/obj/machinery/atmospherics/pipe/simple/hidden/scrubbers{
	dir = 4
	},
/obj/machinery/atmospherics/pipe/simple/hidden/supply{
	dir = 4
	},
/turf/simulated/floor/tiled/full,
/area/grove_sdf_outpost/work_area)
"if" = (
/obj/effect/decal/cleanable/dirt,
/obj/machinery/atmospherics/unary/vent_scrubber/on,
/obj/machinery/atmospherics/pipe/simple/hidden/supply{
	dir = 10
	},
/obj/structure/sign/flag/sol/old{
	pixel_y = 32
	},
/turf/simulated/floor/tiled,
/area/grove_sdf_outpost/barracks)
"iN" = (
/turf/simulated/wall/r_wall,
/area/grove_sdf_outpost/work_area)
"iZ" = (
/obj/machinery/atmospherics/pipe/simple/hidden/scrubbers,
/obj/machinery/atmospherics/pipe/simple/hidden/supply{
	dir = 9
	},
/turf/simulated/floor/tiled/full,
/area/grove_sdf_outpost/main)
"jF" = (
/obj/structure/bed/padded,
/obj/item/bedsheet/blue,
/obj/effect/decal/cleanable/dirt,
/turf/simulated/floor/tiled,
/area/grove_sdf_outpost/barracks)
"kj" = (
/obj/effect/floor_decal/corner_wide/dark_green{
	dir = 9
	},
/obj/effect/decal/cleanable/dirt,
/obj/machinery/atmospherics/pipe/simple/hidden/red{
	dir = 4
	},
/obj/random/junk,
/turf/simulated/floor/tiled,
/area/grove_sdf_outpost/main)
"kU" = (
/obj/effect/floor_decal/corner_wide/dark_green,
/obj/machinery/atmospherics/pipe/simple/hidden/universal{
	dir = 4
	},
/turf/simulated/floor/tiled,
/area/grove_sdf_outpost/main)
"ls" = (
/obj/item/flashlight/maglight/on,
/turf/simulated/floor/exoplanet/grass/grove,
/area/grove_sdf_outpost/exterior)
"lG" = (
/obj/effect/floor_decal/corner_wide/dark_green{
	dir = 10
	},
/obj/effect/decal/cleanable/dirt,
/obj/structure/closet/secure_closet/guncabinet{
	locked = 0;
	opened = 1;
	req_access = null
	},
/obj/item/flashlight/maglight,
/obj/item/storage/belt/military,
/obj/item/storage/belt/military,
/turf/simulated/floor/tiled,
/area/grove_sdf_outpost/work_area)
"lJ" = (
/obj/structure/bed/padded,
/obj/structure/bed/padded,
/obj/item/bedsheet/blue,
/obj/structure/sign/poster{
	pixel_x = 32
	},
/turf/simulated/floor/tiled,
/area/grove_sdf_outpost/barracks)
"mo" = (
/obj/effect/floor_decal/corner_wide/dark_green{
	dir = 6
	},
/obj/structure/table/reinforced/steel,
/obj/machinery/light/small/red{
	dir = 4
	},
/obj/effect/decal/cleanable/dirt,
/turf/simulated/floor/tiled,
/area/grove_sdf_outpost/work_area)
"mE" = (
/obj/structure/flora/ausbushes/fullgrass,
/turf/simulated/floor/exoplanet/grass/grove,
/area/template_noop)
"nD" = (
/obj/effect/decal/cleanable/dirt,
/obj/structure/curtain/open/shower,
/obj/machinery/shower,
/obj/item/soap/blue_soap,
/obj/machinery/atmospherics/unary/vent_pump/on{
	dir = 4
	},
/turf/simulated/floor/tiled/white,
/area/grove_sdf_outpost/restroom)
"nL" = (
/obj/structure/cable/yellow{
	icon_state = "1-8"
	},
/obj/structure/cable/yellow{
	icon_state = "1-4"
	},
/turf/simulated/floor/exoplanet/plating,
/area/grove_sdf_outpost/power_plant)
"oB" = (
/obj/effect/floor_decal/corner_wide/dark_green/full{
	dir = 8
	},
/obj/effect/decal/cleanable/dirt,
/obj/structure/bed/stool{
	dir = 4
	},
/turf/simulated/floor/tiled,
/area/grove_sdf_outpost/main)
"oJ" = (
/obj/structure/flora/ausbushes/brflowers,
/turf/simulated/floor/exoplanet/grass/grove,
/area/grove_sdf_outpost/exterior)
"pK" = (
/obj/machinery/atmospherics/pipe/simple/hidden/universal{
	dir = 4
	},
/turf/simulated/floor/tiled/full,
/area/grove_sdf_outpost/main)
"pM" = (
/obj/effect/floor_decal/corner_wide/dark_green{
	dir = 10
	},
/obj/machinery/photocopier,
/turf/simulated/floor/tiled,
/area/grove_sdf_outpost/work_area)
"pS" = (
/obj/structure/flora/bush/grove,
/turf/simulated/floor/exoplanet/grass/grove,
/area/template_noop)
"pT" = (
/obj/machinery/door/airlock/generic{
	dir = 8
	},
/obj/machinery/atmospherics/pipe/simple/hidden/scrubbers{
	dir = 4
	},
/obj/machinery/atmospherics/pipe/simple/hidden/supply{
	dir = 4
	},
/turf/simulated/floor/tiled/white,
/area/grove_sdf_outpost/barracks)
"qh" = (
/obj/effect/floor_decal/corner_wide/dark_green{
	dir = 6
	},
/obj/effect/decal/cleanable/dirt,
/obj/machinery/computer/terminal{
	dir = 8
	},
/turf/simulated/floor/tiled,
/area/grove_sdf_outpost/work_area)
"qU" = (
/obj/effect/decal/cleanable/dirt,
/obj/machinery/atmospherics/unary/vent_pump/on{
	dir = 4
	},
/turf/simulated/floor/tiled/full,
/area/grove_sdf_outpost/main)
"qW" = (
/obj/structure/blocker/steel/fence{
	dir = 8
	},
/turf/simulated/floor/exoplanet/barren,
/area/grove_sdf_outpost/exterior)
"ri" = (
/obj/effect/floor_decal/corner_wide/dark_green{
	dir = 5
	},
/obj/effect/decal/cleanable/dirt,
/obj/structure/filingcabinet{
	pixel_x = 7
	},
/obj/structure/filingcabinet{
	pixel_x = -7
	},
/turf/simulated/floor/tiled,
/area/grove_sdf_outpost/work_area)
"ru" = (
/obj/effect/decal/cleanable/dirt,
/obj/machinery/light/small{
	brightness_color = "#FA8282"
	},
/obj/machinery/atmospherics/pipe/simple/hidden/scrubbers{
	dir = 4
	},
/obj/machinery/atmospherics/pipe/simple/hidden/supply{
	dir = 5
	},
/turf/simulated/floor/tiled/white,
/area/grove_sdf_outpost/restroom)
"ry" = (
/obj/effect/floor_decal/corner_wide/dark_green{
	dir = 9
	},
/obj/machinery/atmospherics/pipe/tank/air{
	dir = 4
	},
/obj/structure/window/reinforced{
	dir = 1
	},
/obj/machinery/door/window/eastleft,
/obj/structure/window/reinforced,
/turf/simulated/floor/tiled,
/area/grove_sdf_outpost/main)
"rF" = (
/turf/simulated/wall/r_wall,
/area/grove_sdf_outpost/main)
"rW" = (
/obj/machinery/door/airlock/generic{
	dir = 8
	},
/obj/machinery/atmospherics/pipe/simple/hidden/scrubbers{
	dir = 4
	},
/obj/machinery/atmospherics/pipe/simple/hidden/supply{
	dir = 4
	},
/turf/simulated/floor/tiled/full,
/area/grove_sdf_outpost/work_area)
"sX" = (
/obj/structure/sign/electricshock{
	pixel_x = 32
	},
/turf/simulated/floor/exoplanet/barren,
/area/grove_sdf_outpost/exterior)
"tl" = (
/obj/effect/decal/cleanable/dirt,
/obj/structure/toilet,
/obj/machinery/atmospherics/pipe/simple/hidden/supply{
	dir = 10
	},
/turf/simulated/floor/tiled/white,
/area/grove_sdf_outpost/restroom)
"tu" = (
/obj/machinery/door/airlock/service,
/obj/machinery/atmospherics/pipe/simple/hidden/scrubbers,
/obj/machinery/atmospherics/pipe/simple/hidden/supply,
/turf/simulated/floor/tiled,
/area/grove_sdf_outpost/work_area)
"tZ" = (
/obj/item/stack/rods,
/turf/simulated/floor/exoplanet/barren,
/area/grove_sdf_outpost/exterior)
"uk" = (
/obj/structure/bed/stool/chair/office/light{
	dir = 4
	},
/obj/effect/decal/cleanable/dirt,
/turf/simulated/floor/tiled/full,
/area/grove_sdf_outpost/work_area)
"ux" = (
/obj/effect/floor_decal/corner_wide/dark_green{
	dir = 10
	},
/obj/machinery/light/small,
/obj/effect/decal/cleanable/dirt,
/obj/random/junk,
/obj/structure/closet/crate/bin,
/obj/machinery/atmospherics/pipe/simple/hidden/scrubbers{
	dir = 9
	},
/obj/random/junk,
/obj/random/junk,
/obj/random/junk,
/turf/simulated/floor/tiled,
/area/grove_sdf_outpost/main)
"uL" = (
/obj/effect/decal/cleanable/dirt,
/turf/simulated/floor/tiled/full,
/area/grove_sdf_outpost/work_area)
"uR" = (
/obj/effect/floor_decal/corner_wide/dark_green/full{
	dir = 4
	},
/obj/structure/table/reinforced/steel,
/obj/item/paper_bin,
/obj/item/pen,
/obj/effect/decal/cleanable/dirt,
/turf/simulated/floor/tiled,
/area/grove_sdf_outpost/work_area)
"vj" = (
/obj/item/stack/rods,
/turf/simulated/floor/exoplanet/grass/grove,
/area/grove_sdf_outpost/exterior)
"vC" = (
/obj/effect/floor_decal/corner_wide/dark_green{
	dir = 6
	},
/obj/effect/decal/cleanable/generic,
/turf/simulated/floor/tiled,
/area/grove_sdf_outpost/main)
"vO" = (
/obj/structure/sign/securearea,
/turf/simulated/wall/r_wall,
/area/grove_sdf_outpost/exterior)
"vR" = (
/obj/effect/decal/cleanable/dirt,
/obj/machinery/atmospherics/pipe/manifold/hidden/scrubbers{
	dir = 4
	},
/obj/machinery/atmospherics/pipe/manifold/hidden/supply{
	dir = 4
	},
/turf/simulated/floor/tiled,
/area/grove_sdf_outpost/barracks)
"wl" = (
/obj/effect/decal/cleanable/dirt,
/obj/machinery/atmospherics/pipe/manifold/hidden/scrubbers{
	dir = 1
	},
/obj/machinery/atmospherics/pipe/manifold/hidden/supply{
	dir = 1
	},
/turf/simulated/floor/tiled/full,
/area/grove_sdf_outpost/main)
"wr" = (
/obj/effect/floor_decal/corner_wide/dark_green{
	dir = 10
	},
/obj/effect/decal/cleanable/dirt,
/obj/structure/closet/secure_closet/guncabinet{
	locked = 0;
	opened = 1;
	req_access = null
	},
/obj/item/clothing/suit/armor/carrier/military{
	starting_accessories = list(/obj/item/clothing/accessory/armor_plate/military,/obj/item/clothing/accessory/storage/modular_pouch)
	},
/turf/simulated/floor/tiled,
/area/grove_sdf_outpost/work_area)
"wO" = (
/obj/effect/decal/cleanable/dirt,
/obj/effect/decal/cleanable/generic,
/obj/machinery/atmospherics/pipe/simple/hidden/cyan{
	dir = 4
	},
/turf/simulated/floor/tiled/full,
/area/grove_sdf_outpost/main)
"yR" = (
/obj/machinery/embedded_controller/radio/airlock/airlock_controller{
	pixel_y = 27
	},
/obj/machinery/airlock_sensor{
	pixel_y = 38
	},
/obj/effect/map_effect/marker/airlock,
/obj/effect/floor_decal/industrial/hatch/yellow,
/obj/machinery/atmospherics/unary/vent_pump/high_volume,
/obj/effect/decal/cleanable/dirt,
/turf/simulated/floor/tiled/full,
/area/grove_sdf_outpost/entrance)
"zt" = (
/obj/machinery/light/small/red,
/turf/simulated/floor/exoplanet/barren,
/area/grove_sdf_outpost/exterior)
"zT" = (
/obj/effect/floor_decal/corner_wide/dark_green{
	dir = 6
	},
/obj/machinery/access_button{
	pixel_x = 33;
	pixel_y = -6
	},
/turf/simulated/floor/tiled,
/area/grove_sdf_outpost/main)
"At" = (
/obj/effect/floor_decal/corner_wide/dark_green{
	dir = 1
	},
/obj/effect/decal/cleanable/dirt,
/obj/structure/bed/stool{
	dir = 4
	},
/turf/simulated/floor/tiled/full,
/area/grove_sdf_outpost/main)
"Bm" = (
/obj/structure/bed/stool/chair/office/light{
	dir = 4
	},
/turf/simulated/floor/tiled/full,
/area/grove_sdf_outpost/work_area)
"CT" = (
/obj/machinery/light/small/red{
	dir = 4
	},
/turf/simulated/floor/exoplanet/barren,
/area/grove_sdf_outpost/exterior)
"Dr" = (
/obj/effect/floor_decal/corner_wide/dark_green{
	dir = 5
	},
/obj/machinery/light/small/broken{
	dir = 1
	},
/obj/structure/flora/pottedplant/dead,
/turf/simulated/floor/tiled,
/area/grove_sdf_outpost/main)
"DG" = (
/turf/simulated/floor/exoplanet/grass/grove,
/area/template_noop)
"DM" = (
/obj/effect/decal/cleanable/dirt,
/obj/effect/decal/cleanable/dirt,
/obj/structure/sink{
	dir = 8;
	pixel_x = -12;
	pixel_y = 6
	},
/obj/structure/mirror{
	pixel_x = -32
	},
/obj/effect/decal/cleanable/generic,
/obj/machinery/atmospherics/unary/vent_scrubber/on{
	dir = 4
	},
/turf/simulated/floor/tiled/white,
/area/grove_sdf_outpost/restroom)
"DW" = (
/obj/effect/floor_decal/corner_wide/dark_green{
	dir = 9
	},
/obj/structure/table/rack,
/obj/item/clothing/suit/space/void/engineering,
/obj/effect/decal/cleanable/dirt,
/obj/item/clothing/suit/space/void/engineering,
/turf/simulated/floor/tiled,
/area/grove_sdf_outpost/main)
"Eh" = (
/obj/structure/flora/ausbushes/brflowers,
/turf/simulated/floor/exoplanet/grass/grove,
/area/template_noop)
"Eo" = (
/obj/structure/flora/tree/grove,
/turf/simulated/floor/exoplanet/grass/grove,
/area/grove_sdf_outpost/exterior)
"Gp" = (
/obj/effect/floor_decal/corner_wide/dark_green{
	dir = 8
	},
/obj/effect/decal/cleanable/dirt,
/turf/simulated/floor/tiled/full,
/area/grove_sdf_outpost/main)
"Gw" = (
/obj/structure/flora/tree/grove,
/turf/simulated/floor/exoplanet/grass/grove,
/area/template_noop)
"Gx" = (
/obj/effect/floor_decal/corner_wide/dark_green{
	dir = 6
	},
/obj/effect/decal/cleanable/generic,
/obj/machinery/computer/terminal{
	dir = 8
	},
/turf/simulated/floor/tiled,
/area/grove_sdf_outpost/work_area)
"GQ" = (
/obj/machinery/atmospherics/pipe/manifold/hidden/scrubbers{
	dir = 4
	},
/obj/machinery/atmospherics/pipe/manifold/hidden/supply,
/turf/simulated/floor/tiled/full,
/area/grove_sdf_outpost/work_area)
"HT" = (
/obj/effect/decal/cleanable/dirt,
/obj/machinery/atmospherics/unary/vent_scrubber/on{
	dir = 4
	},
/obj/machinery/atmospherics/pipe/simple/hidden/supply{
	dir = 4
	},
/turf/simulated/floor/tiled/full,
/area/grove_sdf_outpost/main)
"Ih" = (
/obj/effect/floor_decal/corner_wide/dark_green/full{
	dir = 4
	},
/obj/machinery/atmospherics/portables_connector{
	dir = 1
	},
/obj/machinery/portable_atmospherics/canister/air/airlock,
/obj/effect/floor_decal/industrial/outline/yellow,
/turf/simulated/floor/tiled,
/area/grove_sdf_outpost/main)
"Iu" = (
/obj/machinery/atmospherics/unary/vent_scrubber/on{
	dir = 1
	},
/turf/simulated/floor/tiled/full,
/area/grove_sdf_outpost/work_area)
"Jh" = (
/obj/effect/decal/cleanable/dirt,
/obj/machinery/atmospherics/pipe/simple/hidden/red{
	dir = 4
	},
/turf/simulated/floor/tiled/full,
/area/grove_sdf_outpost/main)
"Jr" = (
/obj/structure/flora/ausbushes/fullgrass,
/turf/simulated/floor/exoplanet/grass/grove,
/area/grove_sdf_outpost/exterior)
"Ju" = (
/obj/structure/sign/flag/sol/old{
	pixel_x = -32;
	dir = 8
	},
/turf/simulated/floor/exoplanet/barren,
/area/grove_sdf_outpost/exterior)
"JO" = (
/obj/structure/blocker/steel/fence,
/turf/simulated/floor/exoplanet/grass/grove,
/area/grove_sdf_outpost/exterior)
"Kh" = (
/obj/machinery/light/small{
	dir = 8
	},
/obj/effect/decal/cleanable/dirt,
/obj/effect/floor_decal/corner_wide/dark_green/full,
/obj/structure/dispenser/oxygen,
/obj/effect/floor_decal/industrial/outline/yellow,
/turf/simulated/floor/tiled,
/area/grove_sdf_outpost/main)
"Ki" = (
/obj/effect/floor_decal/corner_wide/dark_green{
	dir = 5
	},
/obj/structure/filingcabinet{
	pixel_x = 7
	},
/obj/structure/filingcabinet{
	pixel_x = -7
	},
/turf/simulated/floor/tiled,
/area/grove_sdf_outpost/work_area)
"KL" = (
/obj/effect/floor_decal/industrial/warning,
/turf/simulated/floor/exoplanet/barren,
/area/grove_sdf_outpost/exterior)
"LG" = (
/obj/effect/decal/cleanable/dirt,
/obj/effect/floor_decal/corner_wide/dark_green/full,
/obj/effect/decal/cleanable/dirt,
/obj/machinery/portable_atmospherics/canister/oxygen,
/obj/effect/floor_decal/industrial/outline/yellow,
/turf/simulated/floor/tiled,
/area/grove_sdf_outpost/main)
"LV" = (
/obj/machinery/door/airlock/external{
	dir = 8
	},
/obj/effect/map_effect/marker_helper/airlock/interior,
/obj/effect/map_effect/marker/airlock,
/obj/effect/floor_decal/industrial/hatch/red,
/obj/machinery/atmospherics/pipe/simple/hidden{
	dir = 4
	},
/turf/simulated/floor/tiled/full,
/area/grove_sdf_outpost/main)
"Mk" = (
/obj/structure/cable/yellow{
	icon_state = "0-4"
	},
/obj/machinery/power/rtg,
/turf/simulated/floor/exoplanet/plating,
/area/grove_sdf_outpost/power_plant)
"Ml" = (
/obj/machinery/atmospherics/unary/vent_pump/on{
	dir = 8
	},
/turf/simulated/floor/tiled/full,
/area/grove_sdf_outpost/work_area)
"MF" = (
/obj/effect/floor_decal/corner_wide/dark_green{
	dir = 9
	},
/obj/effect/decal/cleanable/dirt,
/obj/item/storage/toolbox/mechanical,
/obj/structure/closet/crate/tool,
/obj/item/clothing/head/welding,
/obj/item/clothing/gloves/yellow,
/obj/item/multitool,
/turf/simulated/floor/tiled,
/area/grove_sdf_outpost/main)
"MM" = (
/obj/effect/floor_decal/corner_wide/dark_green{
	dir = 9
	},
/obj/machinery/light/small{
	dir = 8
	},
/obj/effect/decal/cleanable/dirt,
/obj/structure/reagent_dispensers/watertank,
/turf/simulated/floor/tiled,
/area/grove_sdf_outpost/main)
"Om" = (
/obj/machinery/light/small{
	dir = 8
	},
/obj/structure/closet/cabinet,
/obj/effect/decal/cleanable/dirt,
/obj/item/reagent_containers/toothbrush,
/obj/item/reagent_containers/toothbrush/green,
/obj/item/reagent_containers/toothpaste,
/obj/item/clothing/suit/storage/toggle/leather_jacket/military,
/obj/item/towel/random,
/obj/machinery/atmospherics/unary/vent_pump/on{
	dir = 4
	},
/obj/random/junk,
/turf/simulated/floor/tiled,
/area/grove_sdf_outpost/barracks)
"OO" = (
/turf/simulated/wall/r_wall,
/area/grove_sdf_outpost/restroom)
"OS" = (
/obj/effect/floor_decal/corner_wide/dark_green{
	dir = 5
	},
/obj/structure/table/reinforced/steel,
/obj/effect/decal/cleanable/dirt,
/obj/machinery/vending/wallmed2{
	pixel_x = -7;
	pixel_y = 30;
	req_access = null
	},
/obj/item/gps,
/turf/simulated/floor/tiled,
/area/grove_sdf_outpost/work_area)
"OW" = (
/obj/machinery/light/small/red{
	dir = 4
	},
/turf/simulated/floor/exoplanet/grass/grove,
/area/grove_sdf_outpost/exterior)
"Pn" = (
/obj/effect/decal/cleanable/dirt,
/obj/effect/floor_decal/corner_wide/dark_green/full{
	dir = 8
	},
/obj/effect/decal/cleanable/dirt,
/obj/effect/decal/cleanable/cobweb,
/obj/structure/closet/crate/drop,
/obj/item/storage/field_ration,
/obj/item/storage/field_ration,
/obj/item/storage/field_ration,
/obj/item/storage/field_ration,
/obj/item/storage/field_ration,
/obj/item/storage/field_ration,
/obj/item/storage/field_ration,
/turf/simulated/floor/tiled,
/area/grove_sdf_outpost/main)
"Py" = (
/obj/effect/floor_decal/corner_wide/dark_green{
	dir = 5
	},
/obj/effect/decal/cleanable/dirt,
/obj/machinery/atmospherics/pipe/simple/hidden/scrubbers,
/obj/machinery/atmospherics/pipe/simple/hidden/supply,
/turf/simulated/floor/tiled,
/area/grove_sdf_outpost/work_area)
"Qk" = (
/obj/item/landmine/frag{
	deployed = 1
	},
/turf/simulated/floor/exoplanet/grass/grove,
/area/grove_sdf_outpost/exterior)
"QH" = (
/obj/effect/floor_decal/corner_wide/dark_green{
	dir = 10
	},
/obj/structure/table/reinforced/steel,
/obj/random/junk,
/turf/simulated/floor/tiled,
/area/grove_sdf_outpost/work_area)
"QK" = (
/obj/effect/floor_decal/corner_wide/dark_green{
	dir = 5
	},
/obj/structure/sign/flag/sol/old/large/north{
	pixel_y = 32
	},
/obj/structure/table/reinforced/steel,
/obj/machinery/chemical_dispenser/coffeemaster/full{
	pixel_y = 18;
	pixel_x = 1
	},
/obj/item/reagent_containers/food/drinks/drinkingglass/newglass/coffeecup/sol{
	pixel_x = -4
	},
/obj/item/reagent_containers/food/drinks/drinkingglass/newglass/coffeecup/sol{
	pixel_x = 5
	},
/turf/simulated/floor/tiled,
/area/grove_sdf_outpost/main)
"QO" = (
/obj/effect/floor_decal/corner_wide/dark_green{
	dir = 10
	},
/obj/structure/sign/flag/sol/old{
	pixel_y = -32
	},
/obj/machinery/light/small,
/obj/structure/closet/secure_closet/guncabinet{
	locked = 0;
	opened = 1;
	req_access = null
	},
/obj/item/gun/projectile/pistol/sol,
/obj/item/gun/projectile/pistol/sol,
/obj/item/ammo_magazine/mc9mm,
/obj/item/ammo_magazine/mc9mm,
/turf/simulated/floor/tiled,
/area/grove_sdf_outpost/work_area)
"QS" = (
/obj/effect/floor_decal/corner_wide/dark_green{
	dir = 5
	},
/obj/machinery/light/small{
	dir = 1
	},
/obj/effect/decal/cleanable/dirt,
/turf/simulated/floor/tiled,
/area/grove_sdf_outpost/work_area)
"Rv" = (
/turf/simulated/wall/r_wall,
/area/grove_sdf_outpost/entrance)
"RN" = (
/obj/item/landmine/frag{
	deployed = 1
	},
/obj/structure/flora/ausbushes/fullgrass,
/turf/simulated/floor/exoplanet/grass/grove,
/area/grove_sdf_outpost/exterior)
"RT" = (
/obj/machinery/door/airlock/engineering{
	dir = 8
	},
/turf/simulated/floor/tiled,
/area/grove_sdf_outpost/power_plant)
"Sj" = (
/turf/simulated/wall/r_wall,
/area/grove_sdf_outpost/power_plant)
"SE" = (
/obj/effect/map_effect/marker/airlock,
/obj/effect/floor_decal/industrial/hatch/yellow,
/obj/machinery/atmospherics/unary/vent_pump/high_volume{
	dir = 1
	},
/obj/effect/decal/cleanable/dirt,
/turf/simulated/floor/tiled/full,
/area/grove_sdf_outpost/entrance)
"SR" = (
/obj/machinery/door/airlock/external{
	dir = 8
	},
/obj/effect/map_effect/marker_helper/airlock/exterior,
/obj/effect/map_effect/marker/airlock,
/obj/effect/floor_decal/industrial/hatch/red,
/turf/simulated/floor/tiled/full,
/area/grove_sdf_outpost/entrance)
"TC" = (
/obj/structure/cable/yellow{
	icon_state = "0-8"
	},
/obj/machinery/power/rtg,
/turf/simulated/floor/exoplanet/plating,
/area/grove_sdf_outpost/power_plant)
"TN" = (
/obj/machinery/light/small/red{
	dir = 1
	},
/turf/simulated/floor/exoplanet/barren,
/area/grove_sdf_outpost/exterior)
"UW" = (
/obj/machinery/access_button{
	pixel_x = -33;
	pixel_y = -6
	},
/obj/machinery/light/small/red{
	dir = 8
	},
/turf/simulated/floor/exoplanet/barren,
/area/grove_sdf_outpost/exterior)
"VB" = (
/turf/simulated/floor/tiled/full,
/area/grove_sdf_outpost/work_area)
"VU" = (
/obj/structure/flora/tree/jungle,
/turf/simulated/floor/exoplanet/grass/grove,
/area/template_noop)
"Wx" = (
/turf/simulated/floor/exoplanet/barren,
/area/grove_sdf_outpost/exterior)
"WE" = (
/obj/structure/flora/tree/jungle,
/turf/simulated/floor/exoplanet/grass/grove,
/area/grove_sdf_outpost/exterior)
"WL" = (
/obj/structure/bed/stool{
	dir = 8
	},
/turf/simulated/floor/tiled/full,
/area/grove_sdf_outpost/main)
"WN" = (
/obj/machinery/power/apc/high/north,
/obj/machinery/power/terminal{
	dir = 4
	},
/obj/structure/cable/yellow{
	icon_state = "0-2"
	},
/turf/simulated/floor/tiled,
/area/grove_sdf_outpost/power_plant)
"Yu" = (
/obj/structure/flora/bush/grove,
/turf/simulated/floor/exoplanet/grass/grove,
/area/grove_sdf_outpost/exterior)
"YN" = (
/obj/effect/decal/cleanable/dirt,
/obj/machinery/atmospherics/pipe/simple/hidden/scrubbers,
/obj/machinery/atmospherics/pipe/simple/hidden/supply,
/turf/simulated/floor/tiled/full,
/area/grove_sdf_outpost/work_area)
"Zn" = (
/obj/machinery/atmospherics/pipe/simple/hidden/red{
	dir = 4
	},
/turf/simulated/wall/r_wall,
/area/grove_sdf_outpost/main)

(1,1,1) = {"
mE
mE
mE
DG
DG
DG
DG
DG
DG
DG
DG
DG
mE
mE
mE
DG
DG
DG
DG
DG
DG
DG
DG
DG
DG
DG
DG
DG
DG
DG
"}
(2,1,1) = {"
DG
DG
DG
DG
DG
Eh
DG
DG
DG
DG
DG
DG
DG
DG
DG
mE
DG
DG
DG
Eh
DG
DG
DG
Gw
DG
DG
mE
mE
DG
DG
"}
(3,1,1) = {"
DG
DG
DG
pS
DG
DG
DG
DG
DG
DG
DG
DG
DG
DG
DG
DG
DG
DG
DG
DG
DG
DG
DG
DG
DG
DG
DG
DG
mE
DG
"}
(4,1,1) = {"
DG
vO
dr
dr
dr
dr
Jr
dr
dr
dr
dr
dr
WE
dr
dr
dr
dr
Jr
Jr
dr
dr
dr
dr
dr
dr
Jr
dr
dr
mE
DG
"}
(5,1,1) = {"
DG
dr
dr
dr
dr
dr
Jr
dr
dr
dr
dr
dr
dr
dr
dr
dr
dr
dr
Jr
Jr
dr
oJ
dr
dr
dr
Jr
dr
vO
DG
DG
"}
(6,1,1) = {"
DG
dr
dr
bq
dr
dr
dr
dr
dr
dr
dr
dr
dr
dr
dr
dr
dr
dr
dr
dr
Jr
dr
Yu
dr
dr
dr
dr
dr
DG
DG
"}
(7,1,1) = {"
DG
dr
bq
bq
Jr
Jr
dr
dr
Qk
dr
dr
dr
dr
dr
dr
Jr
dr
dr
dr
dr
Jr
dr
dr
dr
dr
dr
dr
dr
Eh
DG
"}
(8,1,1) = {"
DG
dr
bq
bq
bq
dr
dr
dr
dr
dr
dr
dr
dr
dr
Jr
oJ
RN
dr
dr
dr
dr
dr
dr
dr
bq
dr
Jr
Jr
DG
DG
"}
(9,1,1) = {"
mE
dr
dr
bq
bq
Jr
dr
dr
dr
dr
dr
dr
dr
dr
dr
dr
dr
dr
dr
dr
dr
dr
dr
dr
bq
dr
dr
dr
DG
DG
"}
(10,1,1) = {"
DG
dr
dr
bq
bq
da
tZ
vj
JO
da
da
da
da
da
JO
JO
JO
da
da
da
da
da
JO
bq
bq
bq
dr
dr
DG
DG
"}
(11,1,1) = {"
DG
dr
Jr
dr
gG
dr
dr
vj
dr
dr
dr
dr
dr
dr
dr
dr
dr
dr
dr
dr
dr
dr
oJ
bq
bq
bq
dr
dr
DG
DG
"}
(12,1,1) = {"
DG
dr
dr
dr
gG
dr
dr
dr
dr
dr
dr
OW
dr
dr
Wx
bx
Wx
Wx
Wx
OW
dr
dr
dr
bq
bq
bq
bq
dr
DG
mE
"}
(13,1,1) = {"
Eh
dr
dr
dr
gG
dr
Yu
dr
dr
Wx
dr
rF
rF
rF
rF
Zn
rF
rF
rF
rF
dr
dr
dr
bq
bq
bq
bq
dr
DG
mE
"}
(14,1,1) = {"
DG
dr
dr
dr
qW
dr
dr
dr
CT
Wx
rF
rF
Pn
MM
ry
kj
MF
DW
Kh
rF
rF
TN
dr
gG
dr
bq
dr
dr
DG
mE
"}
(15,1,1) = {"
DG
dr
dr
WE
qW
dr
dr
OO
OO
OO
rF
oB
At
qU
wO
Jh
hK
hK
Gp
LG
rF
Wx
dr
qW
dr
dr
dr
Jr
mE
DG
"}
(16,1,1) = {"
DG
dr
dr
dr
qW
dr
oJ
OO
nD
DM
rF
QK
dY
HT
pK
kU
vC
zT
fa
Ih
rF
dr
Wx
gG
dr
dr
Jr
dr
DG
DG
"}
(17,1,1) = {"
DG
RN
dr
dr
qW
dr
dr
OO
tl
ru
rF
Dr
WL
wl
iZ
ux
rF
rF
LV
rF
rF
dr
dr
vj
dr
dr
dr
dr
DG
DG
"}
(18,1,1) = {"
DG
Jr
dr
Yu
qW
dr
zt
hI
hI
pT
iN
iN
iN
rW
iN
iN
iN
yR
hD
SE
Rv
dr
dr
dr
vj
dr
dr
oJ
pS
DG
"}
(19,1,1) = {"
DG
Jr
dr
dr
qW
dr
Wx
hI
Om
gb
iN
Ki
uL
hM
uL
wr
iN
Rv
SR
Rv
Rv
oJ
dr
gG
dr
dr
dr
oJ
DG
DG
"}
(20,1,1) = {"
mE
Jr
dr
dr
qW
dr
dr
hI
if
vR
tu
Py
YN
GQ
Iu
lG
iN
Ju
Wx
UW
dr
dr
dr
qW
Jr
dr
dr
dr
mE
DG
"}
(21,1,1) = {"
DG
dr
dr
Jr
qW
dr
dr
hI
lJ
jF
iN
QS
dJ
Ml
uL
QO
iN
Wx
Wx
Wx
Wx
dr
qW
qW
Jr
dr
dr
dr
DG
Eh
"}
(22,1,1) = {"
DG
dr
dr
Jr
gG
dr
Wx
hI
hI
hI
iN
ri
VB
VB
uL
pM
iN
Wx
Wx
Wx
Wx
Wx
Wx
KL
dr
dr
dr
WE
DG
DG
"}
(23,1,1) = {"
DG
oJ
dr
dr
gG
dr
dr
Wx
Wx
Wx
iN
OS
Bm
uL
uk
QH
iN
bn
Wx
Wx
Wx
Wx
Wx
KL
dr
dr
dr
dr
DG
DG
"}
(24,1,1) = {"
DG
dr
RN
dr
qW
dr
dr
dr
Wx
Wx
iN
dR
qh
mo
Gx
uR
iN
Wx
Wx
Wx
Wx
dr
qW
qW
dr
dr
dr
Yu
DG
DG
"}
(25,1,1) = {"
DG
dr
Eo
dr
qW
dr
dr
dr
dr
Wx
iN
iN
iN
iN
iN
iN
iN
Wx
Wx
Wx
dr
dr
dr
qW
dr
dr
dr
dr
DG
mE
"}
(26,1,1) = {"
DG
dr
dr
dr
qW
dr
Jr
dr
dr
dr
gA
Wx
oJ
dr
Wx
Wx
Wx
Wx
Wx
dr
Wx
dr
dr
qW
dr
Jr
dr
dr
DG
DG
"}
(27,1,1) = {"
DG
dr
dr
dr
qW
dr
dr
Jr
Jr
dr
dr
Wx
dr
dr
dr
Wx
Wx
Wx
ls
Wx
dr
dr
bq
bq
dr
RN
dr
dr
DG
mE
"}
(28,1,1) = {"
DG
dr
dr
dr
gG
dr
dr
dr
dr
Wx
dr
dr
dr
dr
dr
dr
Yu
dr
dr
dr
bq
bq
bq
dr
dr
dr
Jr
dr
DG
mE
"}
(29,1,1) = {"
DG
dr
Jr
dr
qW
oJ
dr
dr
dr
dr
dr
dr
Jr
dr
dr
dr
dr
dr
dr
bq
bq
bq
bq
dr
dr
dr
dr
Jr
DG
DG
"}
(30,1,1) = {"
DG
dr
dr
dr
qW
bq
bq
dr
sX
Wx
dr
Jr
dr
dr
dr
Jr
dr
dr
dr
bq
bq
bq
bq
dr
dr
dr
dr
dr
DG
DG
"}
(31,1,1) = {"
DG
dr
WE
dr
bq
bq
bq
bq
Sj
RT
Sj
Sj
Sj
Sj
vj
dr
dr
dr
dr
bq
bq
bq
dr
Jr
dr
dr
dr
dr
DG
DG
"}
(32,1,1) = {"
DG
dr
dr
dr
bq
bq
bq
bq
Sj
fu
Mk
Mk
Mk
Sj
JO
dr
dr
Wx
da
bq
dr
dr
dr
dr
dr
dr
dr
dr
mE
DG
"}
(33,1,1) = {"
DG
dr
dr
dr
oJ
bq
bq
bq
Sj
WN
hc
hc
nL
Sj
dr
vj
dr
vj
dr
dr
dr
dr
dr
dr
dr
dr
Eo
dr
DG
DG
"}
(34,1,1) = {"
DG
dr
Yu
Jr
dr
bq
bq
bq
Sj
aE
TC
TC
TC
Sj
bq
dr
dr
dr
dr
dr
dr
dr
dr
dr
dr
dr
dr
dr
pS
DG
"}
(35,1,1) = {"
DG
dr
dr
Jr
dr
oJ
bq
bq
Sj
Sj
Sj
Sj
Sj
Sj
bq
RN
dr
dr
dr
dr
dr
Jr
dr
dr
dr
dr
dr
dr
DG
DG
"}
(36,1,1) = {"
DG
dr
Jr
Jr
dr
dr
Yu
bq
bq
bq
bq
dr
bq
bq
dr
dr
dr
dr
dr
Jr
Jr
dr
dr
dr
dr
dr
dr
dr
DG
DG
"}
(37,1,1) = {"
DG
vO
dr
dr
dr
Jr
dr
dr
dr
dr
dr
dr
dr
Jr
dr
dr
dr
dr
dr
dr
dr
dr
Yu
dr
dr
dr
dr
vO
DG
DG
"}
(38,1,1) = {"
DG
DG
DG
mE
DG
DG
mE
DG
mE
DG
DG
DG
DG
DG
DG
Eh
DG
DG
DG
Gw
DG
DG
DG
DG
Eh
DG
DG
DG
VU
DG
"}
(39,1,1) = {"
DG
DG
Gw
DG
DG
DG
mE
DG
VU
DG
DG
DG
DG
DG
DG
DG
DG
DG
DG
DG
DG
DG
DG
DG
DG
DG
DG
DG
DG
DG
"}
(40,1,1) = {"
DG
DG
DG
DG
DG
DG
DG
DG
DG
DG
DG
DG
DG
DG
DG
DG
DG
DG
DG
DG
DG
DG
DG
DG
DG
DG
DG
DG
DG
DG
"}
