//MAP CONVERTED BY dmm2tgm.py THIS HEADER COMMENT PREVENTS RECONVERSION, DO NOT REMOVE
"a" = (
/turf/simulated/floor/exoplanet/desert,
/area/template_noop)
"b" = (
/obj/structure/bonfire/light_up,
/turf/simulated/floor/exoplanet/desert,
/area/template_noop)
"f" = (
/obj/structure/anomaly_container,
/turf/simulated/floor/exoplanet/desert,
/area/template_noop)
"g" = (
/obj/effect/overlay/palmtree_r,
/turf/simulated/floor/exoplanet/desert,
/area/template_noop)
"j" = (
/obj/structure/closet/crate/loot,
/turf/simulated/floor/exoplanet/desert,
/area/template_noop)
"k" = (
/turf/simulated/floor/exoplanet/water/shallow,
/area/template_noop)
"m" = (
/obj/structure/table/rack/folding_table,
/obj/item/paper_bin{
	pixel_x = 4;
	pixel_y = 2
	},
/obj/item/pen{
	pixel_x = 3;
	pixel_y = 3
	},
/turf/simulated/floor/exoplanet/desert,
/area/template_noop)
"s" = (
/obj/structure/table/rack/folding_table,
/obj/item/clothing/gloves/latex,
/obj/item/clothing/glasses/safety/goggles/science,
/turf/simulated/floor/exoplanet/desert,
/area/template_noop)
"t" = (
/obj/structure/table/rack/folding_table,
/obj/item/clothing/suit/hazmat/anomaly,
/obj/item/clothing/head/hazmat/anomaly,
/obj/item/device/camera,
/turf/simulated/floor/exoplanet/desert,
/area/template_noop)
"v" = (
/obj/machinery/stasis_cage{
	req_access = list()
	},
/turf/simulated/floor/exoplanet/desert,
/area/template_noop)
"w" = (
/obj/effect/decal/cleanable/blood,
/obj/item/gun/energy/pistol,
/turf/simulated/floor/exoplanet/desert,
/area/template_noop)
"y" = (
/obj/structure/table/rack/folding_table,
/turf/simulated/floor/exoplanet/desert,
/area/template_noop)
"B" = (
/obj/structure/flora/ausbushes/sparsegrass,
/turf/simulated/floor/exoplanet/desert,
/area/template_noop)
"E" = (
/obj/structure/bed/stool/chair/folding,
/turf/simulated/floor/exoplanet/desert,
/area/template_noop)
"F" = (
/obj/structure/bed/stool/chair/folding{
	dir = 8
	},
/turf/simulated/floor/exoplanet/desert,
/area/template_noop)
"L" = (
/obj/item/crowbar/rescue_axe,
/turf/simulated/floor/exoplanet/desert,
/area/template_noop)
"N" = (
/obj/structure/table/rack/folding_table,
/obj/item/folder/purple,
/turf/simulated/floor/exoplanet/desert,
/area/template_noop)
"T" = (
/obj/item/ammo_casing/a762/spent,
/turf/simulated/floor/exoplanet/desert,
/area/template_noop)
"U" = (
/obj/effect/overlay/palmtree_l,
/turf/simulated/floor/exoplanet/desert,
/area/template_noop)
"V" = (
/obj/structure/flora/ausbushes/fernybush,
/turf/simulated/floor/exoplanet/desert,
/area/template_noop)
"X" = (
/obj/structure/table/rack/folding_table,
/obj/item/device/flashlight/heavy,
/turf/simulated/floor/exoplanet/desert,
/area/template_noop)
"Z" = (
/obj/effect/decal/cleanable/blood/drip,
/turf/simulated/floor/exoplanet/desert,
/area/template_noop)

(1,1,1) = {"
a
U
a
k
a
a
a
a
a
a
a
a
a
a
a
a
a
a
"}
(2,1,1) = {"
a
B
k
k
B
a
a
a
a
a
a
a
a
a
a
a
a
a
"}
(3,1,1) = {"
a
B
k
k
k
a
a
a
a
a
L
a
a
a
a
a
a
a
"}
(4,1,1) = {"
a
k
k
k
k
a
a
E
b
a
a
a
a
a
a
a
g
a
"}
(5,1,1) = {"
a
k
k
B
U
a
a
a
F
a
a
a
a
a
a
a
a
a
"}
(6,1,1) = {"
a
a
V
a
j
a
a
a
a
a
a
U
a
a
B
a
a
a
"}
(7,1,1) = {"
a
a
a
a
j
t
a
X
a
a
a
a
a
a
k
k
B
a
"}
(8,1,1) = {"
a
a
a
a
a
N
a
y
a
a
f
a
a
B
k
k
a
a
"}
(9,1,1) = {"
a
a
g
a
a
s
w
m
a
a
f
a
a
k
k
k
a
a
"}
(10,1,1) = {"
a
a
a
a
a
Z
a
a
a
a
v
a
V
k
k
B
a
a
"}
(11,1,1) = {"
a
a
a
a
T
a
a
a
a
a
v
a
a
a
a
a
a
a
"}
(12,1,1) = {"
a
a
a
Z
a
a
a
T
a
a
a
a
a
a
a
a
a
g
"}
