//MAP CONVERTED BY dmm2tgm.py THIS HEADER COMMENT PREVENTS RECONVERSION, DO NOT REMOVE
"a" = (
/turf/template_noop,
/area/template_noop)
"b" = (
/obj/structure/cable{
	d1 = 1;
	d2 = 4;
	icon_state = "1-4"
	},
/obj/structure/cable{
	d1 = 1;
	d2 = 2;
	icon_state = "1-2"
	},
/obj/machinery/atmospherics/pipe/manifold/hidden/supply,
/turf/simulated/floor/airless,
/area/construction/Storage)
"c" = (
/obj/structure/lattice,
/turf/template_noop,
/area/template_noop)
"d" = (
/turf/simulated/floor/airless,
/area/template_noop)
"e" = (
/obj/structure/cable{
	d1 = 4;
	d2 = 8;
	icon_state = "4-8"
	},
/obj/machinery/atmospherics/pipe/simple/hidden/supply{
	dir = 4
	},
/turf/simulated/wall/r_wall,
/area/construction/Storage)
"f" = (
/obj/machinery/alarm{
	frequency = 1439;
	locked = 0;
	pixel_y = 23
	},
/obj/machinery/power/apc{
	dir = 8;
	pixel_x = -24
	},
/obj/effect/floor_decal/industrial/warning/corner,
/obj/structure/cable{
	icon_state = "0-2";
	d2 = 2
	},
/turf/simulated/floor/tiled,
/area/construction/Storage)
"g" = (
/obj/effect/floor_decal/industrial/warning,
/turf/simulated/floor/tiled,
/area/construction/Storage)
"h" = (
/obj/effect/floor_decal/industrial/warning/corner{
	dir = 8
	},
/turf/simulated/floor/tiled,
/area/construction/Storage)
"i" = (
/obj/machinery/light{
	dir = 8
	},
/obj/effect/floor_decal/industrial/warning{
	dir = 4
	},
/obj/structure/cable{
	icon_state = "1-8"
	},
/obj/machinery/atmospherics/pipe/simple/hidden/supply{
	dir = 10
	},
/turf/simulated/floor/tiled,
/area/construction/Storage)
"j" = (
/turf/simulated/open,
/area/construction/Storage)
"k" = (
/obj/structure/lattice/catwalk,
/turf/simulated/open,
/area/construction/Storage)
"l" = (
/obj/machinery/light{
	dir = 4
	},
/obj/effect/floor_decal/industrial/warning{
	dir = 8
	},
/turf/simulated/floor/tiled,
/area/construction/Storage)
"m" = (
/obj/effect/floor_decal/industrial/warning{
	dir = 4
	},
/obj/machinery/atmospherics/unary/vent_pump{
	dir = 1
	},
/turf/simulated/floor/tiled,
/area/construction/Storage)
"n" = (
/obj/effect/floor_decal/industrial/warning{
	dir = 8
	},
/turf/simulated/floor/tiled,
/area/construction/Storage)
"o" = (
/obj/structure/lattice/catwalk,
/obj/structure/lattice/catwalk,
/turf/simulated/open,
/area/construction/Storage)
"p" = (
/obj/effect/floor_decal/industrial/warning/corner,
/obj/effect/floor_decal/industrial/warning/corner{
	dir = 4
	},
/turf/simulated/floor/tiled,
/area/construction/Storage)
"q" = (
/obj/effect/floor_decal/industrial/warning{
	dir = 1
	},
/obj/effect/floor_decal/industrial/warning,
/turf/simulated/floor/tiled,
/area/construction/Storage)
"r" = (
/obj/effect/floor_decal/industrial/warning{
	dir = 5
	},
/obj/effect/floor_decal/industrial/warning/corner{
	dir = 8
	},
/turf/simulated/floor/tiled,
/area/construction/Storage)
"s" = (
/obj/effect/floor_decal/industrial/warning{
	dir = 9
	},
/turf/simulated/floor/tiled,
/area/construction/Storage)
"t" = (
/obj/effect/floor_decal/industrial/warning{
	dir = 1
	},
/turf/simulated/floor/tiled,
/area/construction/Storage)
"u" = (
/obj/effect/floor_decal/industrial/warning/corner{
	dir = 1
	},
/turf/simulated/floor/tiled,
/area/construction/Storage)
"v" = (
/obj/effect/floor_decal/industrial/warning{
	dir = 4
	},
/obj/effect/floor_decal/industrial/warning{
	dir = 8
	},
/turf/simulated/floor/tiled,
/area/construction/Storage)
"w" = (
/obj/effect/floor_decal/industrial/warning{
	dir = 8
	},
/obj/effect/floor_decal/industrial/warning/corner,
/turf/simulated/floor/tiled,
/area/construction/Storage)
"x" = (
/turf/simulated/floor/tiled,
/area/construction/Storage)
"y" = (
/obj/effect/floor_decal/industrial/warning{
	dir = 8
	},
/obj/effect/floor_decal/industrial/warning{
	dir = 4
	},
/turf/simulated/floor/tiled,
/area/construction/Storage)
"z" = (
/obj/structure/stairs/south,
/turf/simulated/floor/tiled,
/area/construction/Storage)
"A" = (
/obj/effect/floor_decal/industrial/warning/corner{
	dir = 4
	},
/turf/simulated/floor/tiled,
/area/construction/Storage)
"B" = (
/obj/effect/floor_decal/industrial/warning/corner{
	dir = 1
	},
/obj/effect/floor_decal/industrial/warning/corner{
	dir = 4
	},
/turf/simulated/floor/tiled,
/area/construction/Storage)
"C" = (
/obj/effect/floor_decal/industrial/warning/corner{
	dir = 4
	},
/obj/effect/floor_decal/industrial/warning/corner{
	dir = 1
	},
/turf/simulated/floor/tiled,
/area/construction/Storage)
"D" = (
/obj/machinery/light{
	dir = 8
	},
/obj/effect/floor_decal/industrial/warning{
	dir = 4
	},
/turf/simulated/floor/tiled,
/area/construction/Storage)
"F" = (
/obj/machinery/atmospherics/pipe/simple/hidden/supply{
	icon_state = "intact-supply";
	dir = 9
	},
/turf/simulated/wall/r_wall,
/area/construction/Storage)
"G" = (
/obj/effect/floor_decal/industrial/warning{
	dir = 4
	},
/turf/simulated/floor/tiled,
/area/construction/Storage)
"J" = (
/turf/simulated/wall/r_wall,
/area/construction/Storage)
"M" = (
/obj/structure/cable{
	d1 = 32;
	d2 = 2;
	icon_state = "11-2"
	},
/obj/structure/lattice/catwalk,
/obj/machinery/atmospherics/pipe/zpipe/down/supply,
/turf/simulated/open,
/area/construction/Storage)
"Q" = (
/obj/machinery/atmospherics/pipe/simple/hidden/supply,
/turf/simulated/wall/r_wall,
/area/construction/Storage)
"R" = (
/obj/machinery/atmospherics/pipe/simple/hidden/supply{
	dir = 5
	},
/turf/simulated/wall/r_wall,
/area/construction/Storage)
"U" = (
/obj/structure/cable{
	d1 = 16;
	d2 = 0;
	icon_state = "12-0"
	},
/obj/structure/cable,
/obj/machinery/atmospherics/pipe/zpipe/up/supply,
/turf/simulated/floor/airless,
/area/construction/Storage)
"V" = (
/obj/machinery/atmospherics/pipe/simple/hidden/supply{
	icon_state = "intact-supply";
	dir = 6
	},
/turf/simulated/wall/r_wall,
/area/construction/Storage)

(1,1,1) = {"
a
a
a
a
a
a
a
a
a
a
a
a
a
a
a
a
a
a
a
a
a
a
a
a
a
a
a
a
a
a
a
a
a
a
a
a
a
a
a
a
a
a
a
a
a
a
a
a
a
a
a
a
"}
(2,1,1) = {"
a
a
a
a
a
a
a
a
a
a
a
a
a
a
a
a
a
a
a
a
a
a
a
a
a
a
a
a
a
a
a
a
a
a
a
a
a
a
a
a
a
a
a
a
a
a
a
a
a
a
a
a
"}
(3,1,1) = {"
a
a
a
a
a
a
a
a
a
a
a
a
a
a
a
a
a
a
a
a
a
a
a
a
a
a
a
a
a
a
a
a
a
a
a
a
a
a
a
a
a
a
a
a
a
a
a
a
a
a
a
a
"}
(4,1,1) = {"
a
a
a
a
a
a
a
a
a
a
a
a
a
a
a
a
a
a
a
a
a
a
a
a
a
a
a
a
a
a
a
a
a
a
a
a
a
a
a
a
a
a
a
a
a
a
a
a
a
a
a
a
"}
(5,1,1) = {"
a
a
a
a
a
a
a
a
a
a
a
a
a
a
a
a
a
a
a
a
a
a
a
a
a
a
a
a
a
a
a
a
a
a
a
a
a
a
a
a
a
a
a
a
a
a
a
a
a
a
a
a
"}
(6,1,1) = {"
a
a
a
a
a
a
a
a
a
a
a
a
a
a
a
a
a
a
a
a
a
a
a
a
a
a
a
a
a
a
a
a
a
a
a
a
a
a
a
a
a
a
a
a
a
a
a
a
a
a
a
a
"}
(7,1,1) = {"
a
a
a
a
a
a
a
a
a
a
a
a
a
a
a
a
a
a
a
a
a
a
a
a
a
a
a
a
a
a
a
a
a
a
a
a
a
a
a
a
a
a
a
a
a
a
a
a
a
a
a
a
"}
(8,1,1) = {"
a
a
a
a
a
a
a
a
a
a
a
a
a
a
a
a
a
a
a
a
a
a
a
a
a
a
a
a
a
a
a
a
a
a
a
a
a
a
a
a
a
a
a
a
a
a
a
a
a
a
a
a
"}
(9,1,1) = {"
a
a
a
a
a
a
a
a
c
c
c
c
c
c
c
c
c
c
c
c
c
c
c
c
c
c
c
c
c
c
c
c
c
c
c
c
c
c
c
c
c
c
c
c
a
a
a
a
a
a
a
a
"}
(10,1,1) = {"
a
a
a
a
a
a
a
a
c
a
a
a
a
a
a
a
a
a
a
a
a
a
a
a
a
a
a
a
a
a
a
a
a
a
a
a
a
a
a
a
a
a
a
c
a
a
a
a
a
a
a
a
"}
(11,1,1) = {"
a
a
a
a
a
a
a
a
c
a
d
d
d
d
d
d
d
d
d
d
d
d
d
d
d
d
J
J
V
Q
R
d
d
d
d
d
d
d
d
d
d
d
a
c
a
a
a
a
a
a
a
a
"}
(12,1,1) = {"
a
a
a
a
a
a
a
a
c
a
d
d
d
d
d
d
d
d
d
d
d
d
d
d
d
d
J
M
b
U
F
d
d
d
d
d
d
d
d
d
d
d
a
c
a
a
a
a
a
a
a
a
"}
(13,1,1) = {"
a
a
a
a
a
a
a
a
c
a
d
d
d
d
d
d
d
d
d
d
d
d
d
d
d
d
J
J
e
J
J
J
J
J
J
J
J
J
J
J
d
d
a
c
a
a
a
a
a
a
a
a
"}
(14,1,1) = {"
a
a
a
a
a
a
a
a
c
a
d
d
d
d
d
d
d
d
d
d
d
d
d
d
d
d
J
f
i
m
G
G
G
G
G
p
G
D
A
J
d
d
a
c
a
a
a
a
a
a
a
a
"}
(15,1,1) = {"
a
a
a
a
a
a
a
a
c
a
d
d
d
d
d
d
d
d
d
d
d
d
d
d
d
d
J
g
j
j
k
j
j
j
j
q
j
j
t
J
d
d
a
c
a
a
a
a
a
a
a
a
"}
(16,1,1) = {"
a
a
a
a
a
a
a
a
c
a
d
d
d
d
d
d
d
d
d
d
d
d
d
d
d
d
J
g
j
j
k
j
j
j
j
r
v
v
B
J
d
d
a
c
a
a
a
a
a
a
a
a
"}
(17,1,1) = {"
a
a
a
a
a
a
a
a
c
a
d
d
d
d
d
d
d
d
d
d
d
d
d
d
d
d
J
g
k
k
o
k
k
k
k
o
k
k
t
J
d
d
a
c
a
a
a
a
a
a
a
a
"}
(18,1,1) = {"
a
a
a
a
a
a
a
a
c
a
d
d
d
d
d
d
d
d
d
d
d
d
d
d
d
d
J
g
j
j
k
j
j
j
j
k
j
j
t
J
d
d
a
c
a
a
a
a
a
a
a
a
"}
(19,1,1) = {"
a
a
a
a
a
a
a
a
c
a
d
d
d
d
d
d
d
d
d
d
d
d
d
d
d
d
J
g
j
j
k
j
j
j
j
k
j
j
t
J
d
d
a
c
a
a
a
a
a
a
a
a
"}
(20,1,1) = {"
a
a
a
a
a
a
a
a
c
a
d
d
d
d
d
d
d
d
d
d
d
d
d
d
d
d
J
g
j
j
k
j
j
j
j
k
j
j
t
J
d
d
a
c
a
a
a
a
a
a
a
a
"}
(21,1,1) = {"
a
a
a
a
a
a
a
a
c
a
d
d
d
d
d
d
d
d
d
d
d
d
d
d
d
d
J
g
j
j
k
j
j
j
j
k
j
j
t
J
d
d
a
c
a
a
a
a
a
a
a
a
"}
(22,1,1) = {"
a
a
a
a
a
a
a
a
c
a
d
d
d
d
d
d
d
d
d
d
d
d
d
d
d
d
J
g
k
k
o
k
k
k
k
o
k
k
t
J
d
d
a
c
a
a
a
a
a
a
a
a
"}
(23,1,1) = {"
a
a
a
a
a
a
a
a
c
a
d
d
d
d
d
d
d
d
d
d
d
d
d
d
d
d
J
g
j
j
k
j
j
j
j
s
w
y
C
J
d
d
a
c
a
a
a
a
a
a
a
a
"}
(24,1,1) = {"
a
a
a
a
a
a
a
a
c
a
d
d
d
d
d
d
d
d
d
d
d
d
d
d
d
d
J
g
j
j
k
j
j
j
j
t
x
z
t
J
d
d
a
c
a
a
a
a
a
a
a
a
"}
(25,1,1) = {"
a
a
a
a
a
a
a
a
c
a
d
d
d
d
d
d
d
d
d
d
d
d
d
d
d
d
J
h
l
n
n
n
n
n
n
u
h
l
u
J
d
d
a
c
a
a
a
a
a
a
a
a
"}
(26,1,1) = {"
a
a
a
a
a
a
a
a
c
a
d
d
d
d
d
d
d
d
d
d
d
d
d
d
d
d
J
J
J
J
J
J
J
J
J
J
J
J
J
J
d
d
a
c
a
a
a
a
a
a
a
a
"}
(27,1,1) = {"
a
a
a
a
a
a
a
a
c
a
d
d
d
d
d
d
d
d
d
d
d
d
d
d
d
d
d
d
d
d
d
d
d
d
d
d
d
d
d
d
d
d
a
c
a
a
a
a
a
a
a
a
"}
(28,1,1) = {"
a
a
a
a
a
a
a
a
c
a
d
d
d
d
d
d
d
d
d
d
d
d
d
d
d
d
d
d
d
d
d
d
d
d
d
d
d
d
d
d
d
d
a
c
a
a
a
a
a
a
a
a
"}
(29,1,1) = {"
a
a
a
a
a
a
a
a
c
a
d
d
d
d
d
d
d
d
d
d
d
d
d
d
d
d
d
d
d
d
d
d
d
d
d
d
d
d
d
d
d
d
a
c
a
a
a
a
a
a
a
a
"}
(30,1,1) = {"
a
a
a
a
a
a
a
a
c
a
d
d
d
d
d
d
d
d
d
d
d
d
d
d
d
d
d
d
d
d
d
d
d
d
d
d
d
d
d
d
d
d
a
c
a
a
a
a
a
a
a
a
"}
(31,1,1) = {"
a
a
a
a
a
a
a
a
c
a
d
d
d
d
d
d
d
d
d
d
d
d
d
d
d
d
d
d
d
d
d
d
d
d
d
d
d
d
d
d
d
d
a
c
a
a
a
a
a
a
a
a
"}
(32,1,1) = {"
a
a
a
a
a
a
a
a
c
a
d
d
d
d
d
d
d
d
d
d
d
d
d
d
d
d
d
d
d
d
d
d
d
d
d
d
d
d
d
d
d
d
a
c
a
a
a
a
a
a
a
a
"}
(33,1,1) = {"
a
a
a
a
a
a
a
a
c
a
d
d
d
d
d
d
d
d
d
d
d
d
d
d
d
d
d
d
d
d
d
d
d
d
d
d
d
d
d
d
d
d
a
c
a
a
a
a
a
a
a
a
"}
(34,1,1) = {"
a
a
a
a
a
a
a
a
c
a
d
d
d
d
d
d
d
d
d
d
d
d
d
d
d
d
d
d
d
d
d
d
d
d
d
d
d
d
d
d
d
d
a
c
a
a
a
a
a
a
a
a
"}
(35,1,1) = {"
a
a
a
a
a
a
a
a
c
a
d
d
d
d
d
d
d
d
d
d
d
d
d
d
d
d
d
d
d
d
d
d
d
d
d
d
d
d
d
d
d
d
a
c
a
a
a
a
a
a
a
a
"}
(36,1,1) = {"
a
a
a
a
a
a
a
a
c
a
d
d
d
d
d
d
d
d
d
d
d
d
d
d
d
d
d
d
d
d
d
d
d
d
d
d
d
d
d
d
d
d
a
c
a
a
a
a
a
a
a
a
"}
(37,1,1) = {"
a
a
a
a
a
a
a
a
c
a
d
d
d
d
d
d
d
d
d
d
d
d
d
d
d
d
d
d
d
d
d
d
d
d
d
d
d
d
d
d
d
d
a
c
a
a
a
a
a
a
a
a
"}
(38,1,1) = {"
a
a
a
a
a
a
a
a
c
a
d
d
d
d
d
d
d
d
d
d
d
d
d
d
d
d
d
d
d
d
d
d
d
d
d
d
d
d
d
d
d
d
a
c
a
a
a
a
a
a
a
a
"}
(39,1,1) = {"
a
a
a
a
a
a
a
a
c
a
d
d
d
d
d
d
d
d
d
d
d
d
d
d
d
d
d
d
d
d
d
d
d
d
d
d
d
d
d
d
d
d
a
c
a
a
a
a
a
a
a
a
"}
(40,1,1) = {"
a
a
a
a
a
a
a
a
c
a
d
d
d
d
d
d
d
d
d
d
d
d
d
d
d
d
d
d
d
d
d
d
d
d
d
d
d
d
d
d
d
d
a
c
a
a
a
a
a
a
a
a
"}
(41,1,1) = {"
a
a
a
a
a
a
a
a
c
a
d
d
d
d
d
d
d
d
d
d
d
d
d
d
d
d
d
d
d
d
d
d
d
d
d
d
d
d
d
d
d
d
a
c
a
a
a
a
a
a
a
a
"}
(42,1,1) = {"
a
a
a
a
a
a
a
a
c
a
d
d
d
d
d
d
d
d
d
d
d
d
d
d
d
d
d
d
d
d
d
d
d
d
d
d
d
d
d
d
d
d
a
c
a
a
a
a
a
a
a
a
"}
(43,1,1) = {"
a
a
a
a
a
a
a
a
c
a
a
a
a
a
a
a
a
a
a
a
a
a
a
a
a
a
a
a
a
a
a
a
a
a
a
a
a
a
a
a
a
a
a
c
a
a
a
a
a
a
a
a
"}
(44,1,1) = {"
a
a
a
a
a
a
a
a
c
c
c
c
c
c
c
c
c
c
c
c
c
c
c
c
c
c
c
c
c
c
c
c
c
c
c
c
c
c
c
c
c
c
c
c
a
a
a
a
a
a
a
a
"}
(45,1,1) = {"
a
a
a
a
a
a
a
a
a
a
a
a
a
a
a
a
a
a
a
a
a
a
a
a
a
a
a
a
a
a
a
a
a
a
a
a
a
a
a
a
a
a
a
a
a
a
a
a
a
a
a
a
"}
(46,1,1) = {"
a
a
a
a
a
a
a
a
a
a
a
a
a
a
a
a
a
a
a
a
a
a
a
a
a
a
a
a
a
a
a
a
a
a
a
a
a
a
a
a
a
a
a
a
a
a
a
a
a
a
a
a
"}
(47,1,1) = {"
a
a
a
a
a
a
a
a
a
a
a
a
a
a
a
a
a
a
a
a
a
a
a
a
a
a
a
a
a
a
a
a
a
a
a
a
a
a
a
a
a
a
a
a
a
a
a
a
a
a
a
a
"}
(48,1,1) = {"
a
a
a
a
a
a
a
a
a
a
a
a
a
a
a
a
a
a
a
a
a
a
a
a
a
a
a
a
a
a
a
a
a
a
a
a
a
a
a
a
a
a
a
a
a
a
a
a
a
a
a
a
"}
(49,1,1) = {"
a
a
a
a
a
a
a
a
a
a
a
a
a
a
a
a
a
a
a
a
a
a
a
a
a
a
a
a
a
a
a
a
a
a
a
a
a
a
a
a
a
a
a
a
a
a
a
a
a
a
a
a
"}
(50,1,1) = {"
a
a
a
a
a
a
a
a
a
a
a
a
a
a
a
a
a
a
a
a
a
a
a
a
a
a
a
a
a
a
a
a
a
a
a
a
a
a
a
a
a
a
a
a
a
a
a
a
a
a
a
a
"}
(51,1,1) = {"
a
a
a
a
a
a
a
a
a
a
a
a
a
a
a
a
a
a
a
a
a
a
a
a
a
a
a
a
a
a
a
a
a
a
a
a
a
a
a
a
a
a
a
a
a
a
a
a
a
a
a
a
"}
(52,1,1) = {"
a
a
a
a
a
a
a
a
a
a
a
a
a
a
a
a
a
a
a
a
a
a
a
a
a
a
a
a
a
a
a
a
a
a
a
a
a
a
a
a
a
a
a
a
a
a
a
a
a
a
a
a
"}
