//MAP CONVERTED BY dmm2tgm.py THIS HEADER COMMENT PREVENTS RECONVERSION, DO NOT REMOVE
"a" = (
/turf/template_noop,
/area/template_noop)
"b" = (
/turf/template_noop,
/area/template_noop)
"c" = (
/obj/structure/lattice,
/turf/template_noop,
/area/template_noop)
"d" = (
/turf/simulated/floor/airless,
/area/template_noop)
"e" = (
/turf/simulated/wall/r_wall,
/area/construction)
"f" = (
/obj/machinery/alarm{
	frequency = 1439;
	locked = 0;
	pixel_y = 23
	},
/obj/effect/floor_decal/industrial/warning/corner,
/turf/simulated/floor/tiled,
/area/construction)
"g" = (
/obj/effect/floor_decal/industrial/warning,
/turf/simulated/floor/tiled,
/area/construction)
"h" = (
/obj/effect/floor_decal/industrial/warning/corner{
	dir = 8
	},
/turf/simulated/floor/tiled,
/area/construction)
"i" = (
/obj/machinery/light{
	dir = 8
	},
/obj/effect/floor_decal/industrial/warning{
	dir = 4
	},
/turf/simulated/floor/tiled,
/area/construction)
"j" = (
/turf/simulated/open,
/area/construction)
"k" = (
/obj/structure/lattice/catwalk,
/turf/simulated/open,
/area/construction)
"l" = (
/obj/machinery/light{
	dir = 4
	},
/obj/effect/floor_decal/industrial/warning{
	dir = 8
	},
/turf/simulated/floor/tiled,
/area/construction)
"m" = (
/obj/effect/floor_decal/industrial/warning{
	dir = 4
	},
/turf/simulated/floor/tiled,
/area/construction)
"n" = (
/obj/effect/floor_decal/industrial/warning{
	dir = 8
	},
/turf/simulated/floor/tiled,
/area/construction)
"o" = (
/obj/structure/lattice/catwalk,
/obj/structure/lattice/catwalk,
/turf/simulated/open,
/area/construction)
"p" = (
/obj/effect/floor_decal/industrial/warning/corner,
/obj/effect/floor_decal/industrial/warning/corner{
	dir = 4
	},
/turf/simulated/floor/tiled,
/area/construction)
"q" = (
/obj/effect/floor_decal/industrial/warning{
	dir = 1
	},
/obj/effect/floor_decal/industrial/warning,
/turf/simulated/floor/tiled,
/area/construction)
"r" = (
/obj/effect/floor_decal/industrial/warning{
	dir = 5
	},
/obj/effect/floor_decal/industrial/warning/corner{
	dir = 8
	},
/turf/simulated/floor/tiled,
/area/construction)
"s" = (
/obj/effect/floor_decal/industrial/warning{
	dir = 9
	},
/turf/simulated/floor/tiled,
/area/construction)
"t" = (
/obj/effect/floor_decal/industrial/warning{
	dir = 1
	},
/turf/simulated/floor/tiled,
/area/construction)
"u" = (
/obj/effect/floor_decal/industrial/warning/corner{
	dir = 1
	},
/turf/simulated/floor/tiled,
/area/construction)
"v" = (
/obj/effect/floor_decal/industrial/warning{
	dir = 4
	},
/obj/effect/floor_decal/industrial/warning{
	dir = 8
	},
/turf/simulated/floor/tiled,
/area/construction)
"w" = (
/obj/effect/floor_decal/industrial/warning{
	dir = 8
	},
/obj/effect/floor_decal/industrial/warning/corner,
/turf/simulated/floor/tiled,
/area/construction)
"x" = (
/turf/simulated/floor/tiled,
/area/construction)
"y" = (
/obj/effect/floor_decal/industrial/warning{
	dir = 8
	},
/obj/effect/floor_decal/industrial/warning{
	dir = 4
	},
/turf/simulated/floor/tiled,
/area/construction)
"z" = (
/obj/structure/stairs/south,
/turf/simulated/floor/tiled,
/area/construction)
"A" = (
/obj/effect/floor_decal/industrial/warning/corner{
	dir = 4
	},
/turf/simulated/floor/tiled,
/area/construction)
"B" = (
/obj/effect/floor_decal/industrial/warning/corner{
	dir = 1
	},
/obj/effect/floor_decal/industrial/warning/corner{
	dir = 4
	},
/turf/simulated/floor/tiled,
/area/construction)
"C" = (
/obj/effect/floor_decal/industrial/warning/corner{
	dir = 4
	},
/obj/effect/floor_decal/industrial/warning/corner{
	dir = 1
	},
/turf/simulated/floor/tiled,
/area/construction)

(1,1,1) = {"
a
b
b
b
b
b
b
b
b
b
b
b
b
b
b
b
b
b
b
b
b
b
b
b
b
b
b
b
b
b
b
b
b
b
b
b
b
b
b
b
b
b
b
b
b
b
b
b
b
b
b
b
"}
(2,1,1) = {"
b
b
b
b
b
b
b
b
b
b
b
b
b
b
b
b
b
b
b
b
b
b
b
b
b
b
b
b
b
b
b
b
b
b
b
b
b
b
b
b
b
b
b
b
b
b
b
b
b
b
b
b
"}
(3,1,1) = {"
b
b
b
b
b
b
b
b
b
b
b
b
b
b
b
b
b
b
b
b
b
b
b
b
b
b
b
b
b
b
b
b
b
b
b
b
b
b
b
b
b
b
b
b
b
b
b
b
b
b
b
b
"}
(4,1,1) = {"
b
b
b
b
b
b
b
b
b
b
b
b
b
b
b
b
b
b
b
b
b
b
b
b
b
b
b
b
b
b
b
b
b
b
b
b
b
b
b
b
b
b
b
b
b
b
b
b
b
b
b
b
"}
(5,1,1) = {"
b
b
b
b
b
b
b
b
b
b
b
b
b
b
b
b
b
b
b
b
b
b
b
b
b
b
b
b
b
b
b
b
b
b
b
b
b
b
b
b
b
b
b
b
b
b
b
b
b
b
b
b
"}
(6,1,1) = {"
b
b
b
b
b
b
b
b
b
b
b
b
b
b
b
b
b
b
b
b
b
b
b
b
b
b
b
b
b
b
b
b
b
b
b
b
b
b
b
b
b
b
b
b
b
b
b
b
b
b
b
b
"}
(7,1,1) = {"
b
b
b
b
b
b
b
b
b
b
b
b
b
b
b
b
b
b
b
b
b
b
b
b
b
b
b
b
b
b
b
b
b
b
b
b
b
b
b
b
b
b
b
b
b
b
b
b
b
b
b
b
"}
(8,1,1) = {"
b
b
b
b
b
b
b
b
b
b
b
b
b
b
b
b
b
b
b
b
b
b
b
b
b
b
b
b
b
b
b
b
b
b
b
b
b
b
b
b
b
b
b
b
b
b
b
b
b
b
b
b
"}
(9,1,1) = {"
b
b
b
b
b
b
b
b
c
c
c
c
c
c
c
c
c
c
c
c
c
c
c
c
c
c
c
c
c
c
c
c
c
c
c
c
c
c
c
c
c
c
c
c
b
b
b
b
b
b
b
b
"}
(10,1,1) = {"
b
b
b
b
b
b
b
b
c
b
b
b
b
b
b
b
b
b
b
b
b
b
b
b
b
b
b
b
b
b
b
b
b
b
b
b
b
b
b
b
b
b
b
c
b
b
b
b
b
b
b
b
"}
(11,1,1) = {"
b
b
b
b
b
b
b
b
c
b
d
d
d
d
d
d
d
d
d
d
d
d
d
d
d
d
d
d
d
d
d
d
d
d
d
d
d
d
d
d
d
d
b
c
b
b
b
b
b
b
b
b
"}
(12,1,1) = {"
b
b
b
b
b
b
b
b
c
b
d
d
d
d
d
d
d
d
d
d
d
d
d
d
d
d
d
d
d
d
d
d
d
d
d
d
d
d
d
d
d
d
b
c
b
b
b
b
b
b
b
b
"}
(13,1,1) = {"
b
b
b
b
b
b
b
b
c
b
d
d
d
d
d
d
d
d
d
d
d
d
d
d
d
d
e
e
e
e
e
e
e
e
e
e
e
e
e
e
d
d
b
c
b
b
b
b
b
b
b
b
"}
(14,1,1) = {"
b
b
b
b
b
b
b
b
c
b
d
d
d
d
d
d
d
d
d
d
d
d
d
d
d
d
e
f
i
m
m
m
m
m
m
p
m
i
A
e
d
d
b
c
b
b
b
b
b
b
b
b
"}
(15,1,1) = {"
b
b
b
b
b
b
b
b
c
b
d
d
d
d
d
d
d
d
d
d
d
d
d
d
d
d
e
g
j
j
k
j
j
j
j
q
j
j
t
e
d
d
b
c
b
b
b
b
b
b
b
b
"}
(16,1,1) = {"
b
b
b
b
b
b
b
b
c
b
d
d
d
d
d
d
d
d
d
d
d
d
d
d
d
d
e
g
j
j
k
j
j
j
j
r
v
v
B
e
d
d
b
c
b
b
b
b
b
b
b
b
"}
(17,1,1) = {"
b
b
b
b
b
b
b
b
c
b
d
d
d
d
d
d
d
d
d
d
d
d
d
d
d
d
e
g
k
k
o
k
k
k
k
o
k
k
t
e
d
d
b
c
b
b
b
b
b
b
b
b
"}
(18,1,1) = {"
b
b
b
b
b
b
b
b
c
b
d
d
d
d
d
d
d
d
d
d
d
d
d
d
d
d
e
g
j
j
k
j
j
j
j
k
j
j
t
e
d
d
b
c
b
b
b
b
b
b
b
b
"}
(19,1,1) = {"
b
b
b
b
b
b
b
b
c
b
d
d
d
d
d
d
d
d
d
d
d
d
d
d
d
d
e
g
j
j
k
j
j
j
j
k
j
j
t
e
d
d
b
c
b
b
b
b
b
b
b
b
"}
(20,1,1) = {"
b
b
b
b
b
b
b
b
c
b
d
d
d
d
d
d
d
d
d
d
d
d
d
d
d
d
e
g
j
j
k
j
j
j
j
k
j
j
t
e
d
d
b
c
b
b
b
b
b
b
b
b
"}
(21,1,1) = {"
b
b
b
b
b
b
b
b
c
b
d
d
d
d
d
d
d
d
d
d
d
d
d
d
d
d
e
g
j
j
k
j
j
j
j
k
j
j
t
e
d
d
b
c
b
b
b
b
b
b
b
b
"}
(22,1,1) = {"
b
b
b
b
b
b
b
b
c
b
d
d
d
d
d
d
d
d
d
d
d
d
d
d
d
d
e
g
k
k
o
k
k
k
k
o
k
k
t
e
d
d
b
c
b
b
b
b
b
b
b
b
"}
(23,1,1) = {"
b
b
b
b
b
b
b
b
c
b
d
d
d
d
d
d
d
d
d
d
d
d
d
d
d
d
e
g
j
j
k
j
j
j
j
s
w
y
C
e
d
d
b
c
b
b
b
b
b
b
b
b
"}
(24,1,1) = {"
b
b
b
b
b
b
b
b
c
b
d
d
d
d
d
d
d
d
d
d
d
d
d
d
d
d
e
g
j
j
k
j
j
j
j
t
x
z
t
e
d
d
b
c
b
b
b
b
b
b
b
b
"}
(25,1,1) = {"
b
b
b
b
b
b
b
b
c
b
d
d
d
d
d
d
d
d
d
d
d
d
d
d
d
d
e
h
l
n
n
n
n
n
n
u
h
l
u
e
d
d
b
c
b
b
b
b
b
b
b
b
"}
(26,1,1) = {"
b
b
b
b
b
b
b
b
c
b
d
d
d
d
d
d
d
d
d
d
d
d
d
d
d
d
e
e
e
e
e
e
e
e
e
e
e
e
e
e
d
d
b
c
b
b
b
b
b
b
b
b
"}
(27,1,1) = {"
b
b
b
b
b
b
b
b
c
b
d
d
d
d
d
d
d
d
d
d
d
d
d
d
d
d
d
d
d
d
d
d
d
d
d
d
d
d
d
d
d
d
b
c
b
b
b
b
b
b
b
b
"}
(28,1,1) = {"
b
b
b
b
b
b
b
b
c
b
d
d
d
d
d
d
d
d
d
d
d
d
d
d
d
d
d
d
d
d
d
d
d
d
d
d
d
d
d
d
d
d
b
c
b
b
b
b
b
b
b
b
"}
(29,1,1) = {"
b
b
b
b
b
b
b
b
c
b
d
d
d
d
d
d
d
d
d
d
d
d
d
d
d
d
d
d
d
d
d
d
d
d
d
d
d
d
d
d
d
d
b
c
b
b
b
b
b
b
b
b
"}
(30,1,1) = {"
b
b
b
b
b
b
b
b
c
b
d
d
d
d
d
d
d
d
d
d
d
d
d
d
d
d
d
d
d
d
d
d
d
d
d
d
d
d
d
d
d
d
b
c
b
b
b
b
b
b
b
b
"}
(31,1,1) = {"
b
b
b
b
b
b
b
b
c
b
d
d
d
d
d
d
d
d
d
d
d
d
d
d
d
d
d
d
d
d
d
d
d
d
d
d
d
d
d
d
d
d
b
c
b
b
b
b
b
b
b
b
"}
(32,1,1) = {"
b
b
b
b
b
b
b
b
c
b
d
d
d
d
d
d
d
d
d
d
d
d
d
d
d
d
d
d
d
d
d
d
d
d
d
d
d
d
d
d
d
d
b
c
b
b
b
b
b
b
b
b
"}
(33,1,1) = {"
b
b
b
b
b
b
b
b
c
b
d
d
d
d
d
d
d
d
d
d
d
d
d
d
d
d
d
d
d
d
d
d
d
d
d
d
d
d
d
d
d
d
b
c
b
b
b
b
b
b
b
b
"}
(34,1,1) = {"
b
b
b
b
b
b
b
b
c
b
d
d
d
d
d
d
d
d
d
d
d
d
d
d
d
d
d
d
d
d
d
d
d
d
d
d
d
d
d
d
d
d
b
c
b
b
b
b
b
b
b
b
"}
(35,1,1) = {"
b
b
b
b
b
b
b
b
c
b
d
d
d
d
d
d
d
d
d
d
d
d
d
d
d
d
d
d
d
d
d
d
d
d
d
d
d
d
d
d
d
d
b
c
b
b
b
b
b
b
b
b
"}
(36,1,1) = {"
b
b
b
b
b
b
b
b
c
b
d
d
d
d
d
d
d
d
d
d
d
d
d
d
d
d
d
d
d
d
d
d
d
d
d
d
d
d
d
d
d
d
b
c
b
b
b
b
b
b
b
b
"}
(37,1,1) = {"
b
b
b
b
b
b
b
b
c
b
d
d
d
d
d
d
d
d
d
d
d
d
d
d
d
d
d
d
d
d
d
d
d
d
d
d
d
d
d
d
d
d
b
c
b
b
b
b
b
b
b
b
"}
(38,1,1) = {"
b
b
b
b
b
b
b
b
c
b
d
d
d
d
d
d
d
d
d
d
d
d
d
d
d
d
d
d
d
d
d
d
d
d
d
d
d
d
d
d
d
d
b
c
b
b
b
b
b
b
b
b
"}
(39,1,1) = {"
b
b
b
b
b
b
b
b
c
b
d
d
d
d
d
d
d
d
d
d
d
d
d
d
d
d
d
d
d
d
d
d
d
d
d
d
d
d
d
d
d
d
b
c
b
b
b
b
b
b
b
b
"}
(40,1,1) = {"
b
b
b
b
b
b
b
b
c
b
d
d
d
d
d
d
d
d
d
d
d
d
d
d
d
d
d
d
d
d
d
d
d
d
d
d
d
d
d
d
d
d
b
c
b
b
b
b
b
b
b
b
"}
(41,1,1) = {"
b
b
b
b
b
b
b
b
c
b
d
d
d
d
d
d
d
d
d
d
d
d
d
d
d
d
d
d
d
d
d
d
d
d
d
d
d
d
d
d
d
d
b
c
b
b
b
b
b
b
b
b
"}
(42,1,1) = {"
b
b
b
b
b
b
b
b
c
b
d
d
d
d
d
d
d
d
d
d
d
d
d
d
d
d
d
d
d
d
d
d
d
d
d
d
d
d
d
d
d
d
b
c
b
b
b
b
b
b
b
b
"}
(43,1,1) = {"
b
b
b
b
b
b
b
b
c
b
b
b
b
b
b
b
b
b
b
b
b
b
b
b
b
b
b
b
b
b
b
b
b
b
b
b
b
b
b
b
b
b
b
c
b
b
b
b
b
b
b
b
"}
(44,1,1) = {"
b
b
b
b
b
b
b
b
c
c
c
c
c
c
c
c
c
c
c
c
c
c
c
c
c
c
c
c
c
c
c
c
c
c
c
c
c
c
c
c
c
c
c
c
b
b
b
b
b
b
b
b
"}
(45,1,1) = {"
b
b
b
b
b
b
b
b
b
b
b
b
b
b
b
b
b
b
b
b
b
b
b
b
b
b
b
b
b
b
b
b
b
b
b
b
b
b
b
b
b
b
b
b
b
b
b
b
b
b
b
b
"}
(46,1,1) = {"
b
b
b
b
b
b
b
b
b
b
b
b
b
b
b
b
b
b
b
b
b
b
b
b
b
b
b
b
b
b
b
b
b
b
b
b
b
b
b
b
b
b
b
b
b
b
b
b
b
b
b
b
"}
(47,1,1) = {"
b
b
b
b
b
b
b
b
b
b
b
b
b
b
b
b
b
b
b
b
b
b
b
b
b
b
b
b
b
b
b
b
b
b
b
b
b
b
b
b
b
b
b
b
b
b
b
b
b
b
b
b
"}
(48,1,1) = {"
b
b
b
b
b
b
b
b
b
b
b
b
b
b
b
b
b
b
b
b
b
b
b
b
b
b
b
b
b
b
b
b
b
b
b
b
b
b
b
b
b
b
b
b
b
b
b
b
b
b
b
b
"}
(49,1,1) = {"
b
b
b
b
b
b
b
b
b
b
b
b
b
b
b
b
b
b
b
b
b
b
b
b
b
b
b
b
b
b
b
b
b
b
b
b
b
b
b
b
b
b
b
b
b
b
b
b
b
b
b
b
"}
(50,1,1) = {"
b
b
b
b
b
b
b
b
b
b
b
b
b
b
b
b
b
b
b
b
b
b
b
b
b
b
b
b
b
b
b
b
b
b
b
b
b
b
b
b
b
b
b
b
b
b
b
b
b
b
b
b
"}
(51,1,1) = {"
b
b
b
b
b
b
b
b
b
b
b
b
b
b
b
b
b
b
b
b
b
b
b
b
b
b
b
b
b
b
b
b
b
b
b
b
b
b
b
b
b
b
b
b
b
b
b
b
b
b
b
b
"}
(52,1,1) = {"
b
b
b
b
b
b
b
b
b
b
b
b
b
b
b
b
b
b
b
b
b
b
b
b
b
b
b
b
b
b
b
b
b
b
b
b
b
b
b
b
b
b
b
b
b
b
b
b
b
b
b
b
"}
