//MAP CONVERTED BY dmm2tgm.py THIS HEADER COMMENT PREVENTS RECONVERSION, DO NOT REMOVE
"a" = (
/obj/effect/landmark/map_data{
	height = 3
	},
/turf/template_noop,
/area/template_noop)
"b" = (
/turf/template_noop,
/area/template_noop)
"c" = (
/obj/structure/lattice,
/turf/template_noop,
/area/template_noop)
"d" = (
/turf/simulated/floor/airless,
/area/template_noop)
"e" = (
/turf/simulated/wall/r_wall,
/area/construction/hallway)
"f" = (
/obj/machinery/alarm{
	frequency = 1439;
	locked = 0;
	pixel_y = 23
	},
/obj/machinery/power/apc{
	dir = 8;
	pixel_x = -24
	},
/obj/effect/floor_decal/industrial/warning/corner,
/obj/structure/cable{
	icon_state = "0-2";
	d2 = 2
	},
/turf/simulated/floor/tiled,
/area/construction/hallway)
"g" = (
/obj/effect/floor_decal/industrial/warning,
/turf/simulated/floor/tiled,
/area/construction/hallway)
"h" = (
/obj/effect/floor_decal/industrial/warning/corner{
	dir = 8
	},
/turf/simulated/floor/tiled,
/area/construction/hallway)
"i" = (
/obj/machinery/light{
	dir = 8
	},
/obj/effect/floor_decal/industrial/warning{
	dir = 4
	},
/obj/structure/cable{
	d1 = 1;
	d2 = 2;
	icon_state = "1-2"
	},
/turf/simulated/floor/tiled,
/area/construction/hallway)
"j" = (
/turf/simulated/open,
/area/construction/hallway)
"k" = (
/obj/structure/lattice/catwalk,
/turf/simulated/open,
/area/construction/hallway)
"l" = (
/obj/machinery/light{
	dir = 4
	},
/obj/effect/floor_decal/industrial/warning{
	dir = 8
	},
/turf/simulated/floor/tiled,
/area/construction/hallway)
"m" = (
/obj/effect/floor_decal/industrial/warning{
	dir = 4
	},
/obj/structure/cable{
	d1 = 1;
	d2 = 2;
	icon_state = "1-2"
	},
/turf/simulated/floor/tiled,
/area/construction/hallway)
"n" = (
/obj/effect/floor_decal/industrial/warning{
	dir = 8
	},
/turf/simulated/floor/tiled,
/area/construction/hallway)
"o" = (
/obj/structure/lattice/catwalk,
/obj/structure/lattice/catwalk,
/turf/simulated/open,
/area/construction/hallway)
"p" = (
/obj/structure/lattice/catwalk,
/obj/structure/lattice/catwalk,
/obj/structure/lattice/catwalk,
/turf/simulated/open,
/area/construction/hallway)
"q" = (
/obj/effect/floor_decal/industrial/warning{
	dir = 9
	},
/obj/effect/floor_decal/industrial/warning/corner,
/turf/simulated/floor/tiled,
/area/construction/hallway)
"r" = (
/obj/effect/floor_decal/industrial/warning,
/obj/effect/floor_decal/industrial/warning{
	dir = 1
	},
/turf/simulated/floor/tiled,
/area/construction/hallway)
"s" = (
/obj/effect/floor_decal/industrial/warning/corner{
	dir = 8
	},
/obj/effect/floor_decal/industrial/warning/corner{
	dir = 1
	},
/turf/simulated/floor/tiled,
/area/construction/hallway)
"t" = (
/obj/effect/floor_decal/industrial/warning{
	dir = 4
	},
/obj/effect/floor_decal/industrial/warning{
	dir = 8
	},
/turf/simulated/floor/tiled,
/area/construction/hallway)
"u" = (
/obj/effect/floor_decal/industrial/warning/corner{
	dir = 4
	},
/turf/simulated/floor/tiled,
/area/construction/hallway)
"v" = (
/obj/effect/floor_decal/industrial/warning{
	dir = 1
	},
/turf/simulated/floor/tiled,
/area/construction/hallway)
"w" = (
/obj/effect/floor_decal/industrial/warning/corner{
	dir = 4
	},
/obj/effect/floor_decal/industrial/warning/corner{
	dir = 1
	},
/turf/simulated/floor/tiled,
/area/construction/hallway)
"x" = (
/obj/effect/floor_decal/industrial/warning/corner{
	dir = 1
	},
/turf/simulated/floor/tiled,
/area/construction/hallway)
"z" = (
/obj/effect/floor_decal/industrial/warning{
	dir = 4
	},
/turf/simulated/floor/tiled,
/area/construction/hallway)
"E" = (
/obj/structure/cable{
	d1 = 4;
	d2 = 8;
	icon_state = "4-8"
	},
/obj/machinery/atmospherics/pipe/simple/hidden/supply{
	dir = 4
	},
/turf/simulated/wall/r_wall,
/area/construction/hallway)
"I" = (
/obj/effect/floor_decal/industrial/warning{
	dir = 4
	},
/obj/structure/cable{
	d1 = 1;
	d2 = 8;
	icon_state = "1-8"
	},
/obj/machinery/atmospherics/pipe/simple/hidden/supply{
	dir = 10
	},
/turf/simulated/floor/tiled,
/area/construction/hallway)
"N" = (
/obj/structure/cable{
	d1 = 32;
	d2 = 2;
	icon_state = "11-2"
	},
/obj/structure/lattice/catwalk,
/obj/machinery/atmospherics/pipe/zpipe/down/supply,
/turf/simulated/open,
/area/construction/hallway)
"U" = (
/obj/structure/cable{
	d1 = 1;
	d2 = 4;
	icon_state = "1-4"
	},
/obj/machinery/atmospherics/pipe/simple/hidden/supply{
	dir = 5
	},
/turf/simulated/floor/airless,
/area/construction/hallway)
"V" = (
/obj/effect/floor_decal/industrial/warning{
	dir = 4
	},
/obj/machinery/atmospherics/unary/vent_pump{
	dir = 1
	},
/turf/simulated/floor/tiled,
/area/construction/hallway)
"Y" = (
/obj/machinery/light{
	dir = 8
	},
/obj/effect/floor_decal/industrial/warning{
	dir = 4
	},
/turf/simulated/floor/tiled,
/area/construction/hallway)

(1,1,1) = {"
a
b
b
b
b
b
b
b
b
b
b
b
b
b
b
b
b
b
b
b
b
b
b
b
b
b
b
b
b
b
b
b
b
b
b
b
b
b
b
b
b
b
b
b
b
b
b
b
b
b
b
b
"}
(2,1,1) = {"
b
b
b
b
b
b
b
b
b
b
b
b
b
b
b
b
b
b
b
b
b
b
b
b
b
b
b
b
b
b
b
b
b
b
b
b
b
b
b
b
b
b
b
b
b
b
b
b
b
b
b
b
"}
(3,1,1) = {"
b
b
b
b
b
b
b
b
b
b
b
b
b
b
b
b
b
b
b
b
b
b
b
b
b
b
b
b
b
b
b
b
b
b
b
b
b
b
b
b
b
b
b
b
b
b
b
b
b
b
b
b
"}
(4,1,1) = {"
b
b
b
b
b
b
b
b
b
b
b
b
b
b
b
b
b
b
b
b
b
b
b
b
b
b
b
b
b
b
b
b
b
b
b
b
b
b
b
b
b
b
b
b
b
b
b
b
b
b
b
b
"}
(5,1,1) = {"
b
b
b
b
b
b
b
b
b
b
b
b
b
b
b
b
b
b
b
b
b
b
b
b
b
b
b
b
b
b
b
b
b
b
b
b
b
b
b
b
b
b
b
b
b
b
b
b
b
b
b
b
"}
(6,1,1) = {"
b
b
b
b
b
b
b
b
b
b
b
b
b
b
b
b
b
b
b
b
b
b
b
b
b
b
b
b
b
b
b
b
b
b
b
b
b
b
b
b
b
b
b
b
b
b
b
b
b
b
b
b
"}
(7,1,1) = {"
b
b
b
b
b
b
b
b
b
b
b
b
b
b
b
b
b
b
b
b
b
b
b
b
b
b
b
b
b
b
b
b
b
b
b
b
b
b
b
b
b
b
b
b
b
b
b
b
b
b
b
b
"}
(8,1,1) = {"
b
b
b
b
b
b
b
b
b
b
b
b
b
b
b
b
b
b
b
b
b
b
b
b
b
b
b
b
b
b
b
b
b
b
b
b
b
b
b
b
b
b
b
b
b
b
b
b
b
b
b
b
"}
(9,1,1) = {"
b
b
b
b
b
b
b
b
c
c
c
c
c
c
c
c
c
c
c
c
c
c
c
c
c
c
c
c
c
c
c
c
c
c
c
c
c
c
c
c
c
c
c
c
b
b
b
b
b
b
b
b
"}
(10,1,1) = {"
b
b
b
b
b
b
b
b
c
b
b
b
b
b
b
b
b
b
b
b
b
b
b
b
b
b
b
b
b
b
b
b
b
b
b
b
b
b
b
b
b
b
b
c
b
b
b
b
b
b
b
b
"}
(11,1,1) = {"
b
b
b
b
b
b
b
b
c
b
d
d
d
d
d
d
d
d
d
d
d
d
d
d
d
d
d
d
e
e
e
e
d
d
d
d
d
d
d
d
d
d
b
c
b
b
b
b
b
b
b
b
"}
(12,1,1) = {"
b
b
b
b
b
b
b
b
c
b
d
d
d
d
d
d
d
d
d
d
d
d
d
d
d
d
d
d
e
N
U
e
d
d
d
d
d
d
d
d
d
d
b
c
b
b
b
b
b
b
b
b
"}
(13,1,1) = {"
b
b
b
b
b
b
b
b
c
b
d
d
d
d
d
d
d
d
d
d
d
d
d
d
d
d
e
e
e
e
E
e
e
e
e
e
e
e
e
e
d
d
b
c
b
b
b
b
b
b
b
b
"}
(14,1,1) = {"
b
b
b
b
b
b
b
b
c
b
d
d
d
d
d
d
d
d
d
d
d
d
d
d
d
d
e
f
i
m
I
V
z
z
z
z
z
Y
u
e
d
d
b
c
b
b
b
b
b
b
b
b
"}
(15,1,1) = {"
b
b
b
b
b
b
b
b
c
b
d
d
d
d
d
d
d
d
d
d
d
d
d
d
d
d
e
g
j
j
j
k
j
j
k
j
j
j
v
e
d
d
b
c
b
b
b
b
b
b
b
b
"}
(16,1,1) = {"
b
b
b
b
b
b
b
b
c
b
d
d
d
d
d
d
d
d
d
d
d
d
d
d
d
d
e
g
j
j
j
k
j
j
k
j
j
j
v
e
d
d
b
c
b
b
b
b
b
b
b
b
"}
(17,1,1) = {"
b
b
b
b
b
b
b
b
c
b
d
d
d
d
d
d
d
d
d
d
d
d
d
d
d
d
e
g
j
j
j
k
j
j
k
j
j
j
v
e
d
d
b
c
b
b
b
b
b
b
b
b
"}
(18,1,1) = {"
b
b
b
b
b
b
b
b
c
b
d
d
d
d
d
d
d
d
d
d
d
d
d
d
d
d
e
g
k
k
k
o
k
k
o
o
k
k
v
e
d
d
b
c
b
b
b
b
b
b
b
b
"}
(19,1,1) = {"
b
b
b
b
b
b
b
b
c
b
d
d
d
d
d
d
d
d
d
d
d
d
d
d
d
d
e
g
j
j
j
k
j
j
k
j
j
j
v
e
d
d
b
c
b
b
b
b
b
b
b
b
"}
(20,1,1) = {"
b
b
b
b
b
b
b
b
c
b
d
d
d
d
d
d
d
d
d
d
d
d
d
d
d
d
e
g
j
j
j
k
j
j
k
j
j
j
v
e
d
d
b
c
b
b
b
b
b
b
b
b
"}
(21,1,1) = {"
b
b
b
b
b
b
b
b
c
b
d
d
d
d
d
d
d
d
d
d
d
d
d
d
d
d
e
g
k
k
k
o
k
k
o
k
k
k
v
e
d
d
b
c
b
b
b
b
b
b
b
b
"}
(22,1,1) = {"
b
b
b
b
b
b
b
b
c
b
d
d
d
d
d
d
d
d
d
d
d
d
d
d
d
d
e
g
j
j
j
k
j
j
p
j
j
j
v
e
d
d
b
c
b
b
b
b
b
b
b
b
"}
(23,1,1) = {"
b
b
b
b
b
b
b
b
c
b
d
d
d
d
d
d
d
d
d
d
d
d
d
d
d
d
e
g
j
j
j
k
j
j
k
q
t
t
w
e
d
d
b
c
b
b
b
b
b
b
b
b
"}
(24,1,1) = {"
b
b
b
b
b
b
b
b
c
b
d
d
d
d
d
d
d
d
d
d
d
d
d
d
d
d
e
g
j
j
j
k
j
j
k
r
j
j
v
e
d
d
b
c
b
b
b
b
b
b
b
b
"}
(25,1,1) = {"
b
b
b
b
b
b
b
b
c
b
d
d
d
d
d
d
d
d
d
d
d
d
d
d
d
d
e
h
l
n
n
n
n
n
n
s
n
l
x
e
d
d
b
c
b
b
b
b
b
b
b
b
"}
(26,1,1) = {"
b
b
b
b
b
b
b
b
c
b
d
d
d
d
d
d
d
d
d
d
d
d
d
d
d
d
e
e
e
e
e
e
e
e
e
e
e
e
e
e
d
d
b
c
b
b
b
b
b
b
b
b
"}
(27,1,1) = {"
b
b
b
b
b
b
b
b
c
b
d
d
d
d
d
d
d
d
d
d
d
d
d
d
d
d
d
d
d
d
d
d
d
d
d
d
d
d
d
d
d
d
b
c
b
b
b
b
b
b
b
b
"}
(28,1,1) = {"
b
b
b
b
b
b
b
b
c
b
d
d
d
d
d
d
d
d
d
d
d
d
d
d
d
d
d
d
d
d
d
d
d
d
d
d
d
d
d
d
d
d
b
c
b
b
b
b
b
b
b
b
"}
(29,1,1) = {"
b
b
b
b
b
b
b
b
c
b
d
d
d
d
d
d
d
d
d
d
d
d
d
d
d
d
d
d
d
d
d
d
d
d
d
d
d
d
d
d
d
d
b
c
b
b
b
b
b
b
b
b
"}
(30,1,1) = {"
b
b
b
b
b
b
b
b
c
b
d
d
d
d
d
d
d
d
d
d
d
d
d
d
d
d
d
d
d
d
d
d
d
d
d
d
d
d
d
d
d
d
b
c
b
b
b
b
b
b
b
b
"}
(31,1,1) = {"
b
b
b
b
b
b
b
b
c
b
d
d
d
d
d
d
d
d
d
d
d
d
d
d
d
d
d
d
d
d
d
d
d
d
d
d
d
d
d
d
d
d
b
c
b
b
b
b
b
b
b
b
"}
(32,1,1) = {"
b
b
b
b
b
b
b
b
c
b
d
d
d
d
d
d
d
d
d
d
d
d
d
d
d
d
d
d
d
d
d
d
d
d
d
d
d
d
d
d
d
d
b
c
b
b
b
b
b
b
b
b
"}
(33,1,1) = {"
b
b
b
b
b
b
b
b
c
b
d
d
d
d
d
d
d
d
d
d
d
d
d
d
d
d
d
d
d
d
d
d
d
d
d
d
d
d
d
d
d
d
b
c
b
b
b
b
b
b
b
b
"}
(34,1,1) = {"
b
b
b
b
b
b
b
b
c
b
d
d
d
d
d
d
d
d
d
d
d
d
d
d
d
d
d
d
d
d
d
d
d
d
d
d
d
d
d
d
d
d
b
c
b
b
b
b
b
b
b
b
"}
(35,1,1) = {"
b
b
b
b
b
b
b
b
c
b
d
d
d
d
d
d
d
d
d
d
d
d
d
d
d
d
d
d
d
d
d
d
d
d
d
d
d
d
d
d
d
d
b
c
b
b
b
b
b
b
b
b
"}
(36,1,1) = {"
b
b
b
b
b
b
b
b
c
b
d
d
d
d
d
d
d
d
d
d
d
d
d
d
d
d
d
d
d
d
d
d
d
d
d
d
d
d
d
d
d
d
b
c
b
b
b
b
b
b
b
b
"}
(37,1,1) = {"
b
b
b
b
b
b
b
b
c
b
d
d
d
d
d
d
d
d
d
d
d
d
d
d
d
d
d
d
d
d
d
d
d
d
d
d
d
d
d
d
d
d
b
c
b
b
b
b
b
b
b
b
"}
(38,1,1) = {"
b
b
b
b
b
b
b
b
c
b
d
d
d
d
d
d
d
d
d
d
d
d
d
d
d
d
d
d
d
d
d
d
d
d
d
d
d
d
d
d
d
d
b
c
b
b
b
b
b
b
b
b
"}
(39,1,1) = {"
b
b
b
b
b
b
b
b
c
b
d
d
d
d
d
d
d
d
d
d
d
d
d
d
d
d
d
d
d
d
d
d
d
d
d
d
d
d
d
d
d
d
b
c
b
b
b
b
b
b
b
b
"}
(40,1,1) = {"
b
b
b
b
b
b
b
b
c
b
d
d
d
d
d
d
d
d
d
d
d
d
d
d
d
d
d
d
d
d
d
d
d
d
d
d
d
d
d
d
d
d
b
c
b
b
b
b
b
b
b
b
"}
(41,1,1) = {"
b
b
b
b
b
b
b
b
c
b
d
d
d
d
d
d
d
d
d
d
d
d
d
d
d
d
d
d
d
d
d
d
d
d
d
d
d
d
d
d
d
d
b
c
b
b
b
b
b
b
b
b
"}
(42,1,1) = {"
b
b
b
b
b
b
b
b
c
b
d
d
d
d
d
d
d
d
d
d
d
d
d
d
d
d
d
d
d
d
d
d
d
d
d
d
d
d
d
d
d
d
b
c
b
b
b
b
b
b
b
b
"}
(43,1,1) = {"
b
b
b
b
b
b
b
b
c
b
b
b
b
b
b
b
b
b
b
b
b
b
b
b
b
b
b
b
b
b
b
b
b
b
b
b
b
b
b
b
b
b
b
c
b
b
b
b
b
b
b
b
"}
(44,1,1) = {"
b
b
b
b
b
b
b
b
c
c
c
c
c
c
c
c
c
c
c
c
c
c
c
c
c
c
c
c
c
c
c
c
c
c
c
c
c
c
c
c
c
c
c
c
b
b
b
b
b
b
b
b
"}
(45,1,1) = {"
b
b
b
b
b
b
b
b
b
b
b
b
b
b
b
b
b
b
b
b
b
b
b
b
b
b
b
b
b
b
b
b
b
b
b
b
b
b
b
b
b
b
b
b
b
b
b
b
b
b
b
b
"}
(46,1,1) = {"
b
b
b
b
b
b
b
b
b
b
b
b
b
b
b
b
b
b
b
b
b
b
b
b
b
b
b
b
b
b
b
b
b
b
b
b
b
b
b
b
b
b
b
b
b
b
b
b
b
b
b
b
"}
(47,1,1) = {"
b
b
b
b
b
b
b
b
b
b
b
b
b
b
b
b
b
b
b
b
b
b
b
b
b
b
b
b
b
b
b
b
b
b
b
b
b
b
b
b
b
b
b
b
b
b
b
b
b
b
b
b
"}
(48,1,1) = {"
b
b
b
b
b
b
b
b
b
b
b
b
b
b
b
b
b
b
b
b
b
b
b
b
b
b
b
b
b
b
b
b
b
b
b
b
b
b
b
b
b
b
b
b
b
b
b
b
b
b
b
b
"}
(49,1,1) = {"
b
b
b
b
b
b
b
b
b
b
b
b
b
b
b
b
b
b
b
b
b
b
b
b
b
b
b
b
b
b
b
b
b
b
b
b
b
b
b
b
b
b
b
b
b
b
b
b
b
b
b
b
"}
(50,1,1) = {"
b
b
b
b
b
b
b
b
b
b
b
b
b
b
b
b
b
b
b
b
b
b
b
b
b
b
b
b
b
b
b
b
b
b
b
b
b
b
b
b
b
b
b
b
b
b
b
b
b
b
b
b
"}
(51,1,1) = {"
b
b
b
b
b
b
b
b
b
b
b
b
b
b
b
b
b
b
b
b
b
b
b
b
b
b
b
b
b
b
b
b
b
b
b
b
b
b
b
b
b
b
b
b
b
b
b
b
b
b
b
b
"}
(52,1,1) = {"
b
b
b
b
b
b
b
b
b
b
b
b
b
b
b
b
b
b
b
b
b
b
b
b
b
b
b
b
b
b
b
b
b
b
b
b
b
b
b
b
b
b
b
b
b
b
b
b
b
b
b
b
"}
