"a" = (/turf/simulated/floor/exoplanet/grass/grove,/area/template_noop)
"b" = (/obj/structure/flora/ausbushes/sunnybush,/turf/simulated/floor/exoplanet/grass/grove,/area/template_noop)
"c" = (/turf/simulated/floor/exoplanet/water,/area/template_noop)
"d" = (/obj/structure/flora/tree/jungle/small,/turf/simulated/floor/exoplanet/grass/grove,/area/template_noop)
"e" = (/obj/structure/flora/tree/grove,/turf/simulated/floor/exoplanet/grass/grove,/area/template_noop)
"f" = (/mob/living/simple_animal/tindalos,/turf/simulated/floor/exoplanet/grass/grove,/area/template_noop)
"g" = (/turf/simulated/floor/exoplanet/water/shallow,/area/template_noop)
"h" = (/obj/structure/flora/ausbushes/reedbush,/turf/simulated/floor/exoplanet/water,/area/template_noop)
"i" = (/mob/living/carbon/human/stok,/turf/simulated/floor/exoplanet/grass/grove,/area/template_noop)
"j" = (/obj/structure/flora/ausbushes/sparsegrass,/turf/simulated/floor/exoplanet/grass/grove,/area/template_noop)
"k" = (/obj/structure/flora/ausbushes/fernybush,/turf/simulated/floor/exoplanet/grass/grove,/area/template_noop)
"l" = (/obj/structure/flora/tree/jungle,/turf/simulated/floor/exoplanet/grass/grove,/area/template_noop)
"m" = (/obj/structure/flora/rock/pile,/turf/simulated/floor/exoplanet/grass/grove,/area/template_noop)
"n" = (/obj/structure/flora/rock,/turf/simulated/floor/exoplanet/grass/grove,/area/template_noop)

(1,1,1) = {"
aaaaaaaaaaaaaaaaaaaa
aaaaaabaaaacccaaaada
adaeaaafaacggghcaaia
aaaaaaaaacggggggcaaa
aajjaaaaccgggggggcaa
aajakiacgggggggggcaa
ajjaaacggggggggggcaa
aaaaahggggggggggggca
aaaacgggggggggccccaa
alaacggggggggcaaaaaa
aamacgggggggcaaabaaa
aaafcgggggggghaaaaaa
ajaacggggggggcaaaeaa
adjacggggggggcaiaaaa
aajaahggggggcaaaaaja
aaaaaaccccccaaajjjaa
amaaaaaaaaaaaaajaaaa
aakaeaajjaajaanaalaa
aaaaaajjajjadaaafaaa
aaaaaaaaaaaaaaaaaaaa
"}
