//MAP CONVERTED BY dmm2tgm.py THIS HEADER COMMENT PREVENTS RECONVERSION, DO NOT REMOVE
"a" = (
/turf/simulated/floor/exoplanet/desert,
/area/template_noop)
"b" = (
/turf/simulated/floor/exoplanet/water/shallow,
/area/template_noop)
"l" = (
/obj/structure/flora/ausbushes/sunnybush,
/turf/simulated/floor/exoplanet/desert,
/area/template_noop)
"u" = (
/obj/structure/flora/ausbushes/reedbush,
/turf/simulated/floor/exoplanet/desert,
/area/template_noop)

(1,1,1) = {"
a
a
a
a
a
a
a
"}
(2,1,1) = {"
a
a
a
u
b
b
a
"}
(3,1,1) = {"
a
a
b
b
b
l
a
"}
(4,1,1) = {"
a
l
b
b
b
a
a
"}
(5,1,1) = {"
a
a
b
b
b
a
a
"}
(6,1,1) = {"
a
b
b
u
a
a
a
"}
(7,1,1) = {"
a
a
a
a
a
a
a
"}
