//MAP CONVERTED BY dmm2tgm.py THIS HEADER COMMENT PREVENTS RECONVERSION, DO NOT REMOVE
"a" = (
/obj/structure/flora/ausbushes/sparsegrass,
/turf/simulated/floor/exoplanet/desert,
/area/template_noop)
"r" = (
/obj/structure/flora/ausbushes/grassybush,
/turf/simulated/floor/exoplanet/desert,
/area/template_noop)
"w" = (
/turf/simulated/floor/exoplanet/desert,
/area/template_noop)
"z" = (
/mob/living/simple_animal/parrot,
/turf/simulated/floor/exoplanet/desert,
/area/template_noop)
"B" = (
/obj/effect/overlay/palmtree_l,
/turf/simulated/floor/exoplanet/desert,
/area/template_noop)
"E" = (
/obj/structure/flora/ausbushes/fernybush,
/turf/simulated/floor/exoplanet/desert,
/area/template_noop)
"L" = (
/obj/effect/overlay/palmtree_r,
/turf/simulated/floor/exoplanet/desert,
/area/template_noop)
"N" = (
/mob/living/simple_animal/yithian,
/turf/simulated/floor/exoplanet/desert,
/area/template_noop)
"P" = (
/turf/simulated/floor/exoplanet/water/shallow,
/area/template_noop)

(1,1,1) = {"
w
w
w
w
w
w
w
w
w
w
w
w
w
w
w
w
w
w
w
w
"}
(2,1,1) = {"
w
w
w
w
w
w
w
w
w
w
w
w
w
w
w
w
w
w
w
w
"}
(3,1,1) = {"
w
w
w
w
w
w
w
w
w
a
w
w
w
w
w
w
w
w
w
w
"}
(4,1,1) = {"
w
w
w
w
w
w
w
w
a
a
P
P
P
w
w
w
w
w
w
w
"}
(5,1,1) = {"
w
w
w
w
w
w
w
w
w
P
P
P
P
P
a
w
B
w
w
w
"}
(6,1,1) = {"
w
w
w
w
w
w
B
w
z
P
P
P
P
P
P
a
w
w
w
w
"}
(7,1,1) = {"
w
w
w
w
w
w
w
w
w
w
w
a
P
P
P
w
w
w
w
w
"}
(8,1,1) = {"
w
w
w
w
w
w
a
a
w
w
w
w
P
P
P
w
w
w
w
w
"}
(9,1,1) = {"
w
w
w
w
w
P
P
P
w
w
E
w
w
w
w
w
w
w
w
w
"}
(10,1,1) = {"
w
w
w
N
w
P
P
P
P
w
w
w
w
N
w
w
w
w
w
w
"}
(11,1,1) = {"
w
w
w
w
a
P
P
P
P
P
a
w
w
w
w
a
P
r
w
w
"}
(12,1,1) = {"
w
w
w
w
P
P
P
P
P
P
P
a
w
w
a
P
P
P
P
w
"}
(13,1,1) = {"
w
w
w
w
P
P
P
P
P
P
P
P
w
w
P
P
P
P
P
w
"}
(14,1,1) = {"
w
w
w
w
P
P
P
P
P
P
P
P
w
w
P
P
P
P
P
w
"}
(15,1,1) = {"
w
w
w
w
P
P
P
P
P
P
P
P
w
w
w
P
P
P
a
w
"}
(16,1,1) = {"
w
w
w
w
a
P
P
P
P
P
P
P
w
w
w
w
w
a
w
w
"}
(17,1,1) = {"
w
w
w
L
w
a
w
z
P
P
P
w
w
L
w
w
w
w
w
w
"}
(18,1,1) = {"
w
w
w
w
w
w
w
w
w
w
w
w
w
w
w
w
w
w
w
w
"}
(19,1,1) = {"
w
w
w
w
w
w
w
w
w
w
w
w
w
w
w
w
w
w
w
w
"}
(20,1,1) = {"
w
w
w
w
w
w
w
w
w
w
w
w
w
w
w
w
w
w
w
w
"}
