"bk" = (/turf/simulated/floor/wood,/area/overgrown_mining_station)
"bC" = (/obj/structure/flora/bush/mushroom,/turf/simulated/floor/exoplanet/konyang,/area/overgrown_mining_station)
"bE" = (/turf/simulated/wall/wood,/area/overgrown_mining_station)
"dB" = (/obj/structure/extinguisher_cabinet/west,/turf/simulated/floor/wood,/area/overgrown_mining_station)
"eN" = (/obj/structure/lattice/catwalk/indoor/planks,/obj/structure/railing/fence{dir = 8; pixel_x = -1},/obj/structure/railing/fence{name = "railing"},/turf/simulated/floor/exoplanet/dirt_konyang,/area/overgrown_mining_station)
"eP" = (/obj/structure/chainlink_fence{dir = 1; pixel_y = -5},/turf/simulated/floor/exoplanet/konyang,/area/overgrown_mining_station)
"fb" = (/obj/structure/closet/crate/bin/urban/dumpster,/obj/random/junk{pixel_x = 3; pixel_y = -4},/obj/random/junk{pixel_x = 3; pixel_y = -4},/obj/random/junk{pixel_x = 3; pixel_y = -4},/obj/random/junk{pixel_x = 3; pixel_y = -4},/obj/random/junk{pixel_x = 3; pixel_y = -4},/obj/random/junk{pixel_x = 3; pixel_y = -4},/obj/random/junk{pixel_x = 3; pixel_y = -4},/obj/random/junk{pixel_x = 3; pixel_y = -4},/obj/random/junk{pixel_x = 3; pixel_y = -4},/turf/simulated/floor/concrete/square,/area/overgrown_mining_station)
"fq" = (/obj/structure/cable/green{icon_state = "2-4"},/obj/structure/lattice/catwalk/indoor/grate,/turf/simulated/floor/concrete/square,/area/overgrown_mining_station)
"fw" = (/obj/structure/cable/green{icon_state = "4-8"},/obj/structure/cable/green{icon_state = "0-4"},/obj/machinery/power/solar_control/autostart{dir = 4; pixel_x = -5},/turf/simulated/floor/concrete/square,/area/overgrown_mining_station)
"fM" = (/obj/structure/cable/green{icon_state = "0-2"},/obj/machinery/power/apc/west,/turf/simulated/floor/lino/diamond,/area/overgrown_mining_station)
"fZ" = (/obj/structure/table/wood,/obj/machinery/recharger{pixel_x = -8; pixel_y = 9},/obj/machinery/cell_charger{pixel_x = 9; pixel_y = 8},/turf/simulated/floor/lino/diamond,/area/overgrown_mining_station)
"gw" = (/obj/structure/lattice/catwalk/indoor/planks,/obj/structure/railing/fence{dir = 1; pixel_y = 13},/turf/simulated/floor/exoplanet/dirt_konyang,/area/overgrown_mining_station)
"gJ" = (/obj/machinery/door/urban{dir = 4},/turf/simulated/floor/wood,/area/overgrown_mining_station)
"he" = (/turf/simulated/floor/lino/diamond,/area/overgrown_mining_station)
"hn" = (/obj/structure/cable/green{icon_state = "4-8"},/turf/simulated/floor/wood,/area/overgrown_mining_station)
"hJ" = (/turf/simulated/floor/exoplanet/dirt_konyang,/area/overgrown_mining_station)
"in" = (/obj/structure/rope_post{dir = 8; pixel_y = -4},/obj/structure/rope_post{pixel_y = -4},/obj/structure/rope_railing,/obj/effect/floor_decal/konyang_flowers,/turf/simulated/floor/exoplanet/konyang,/area/overgrown_mining_station)
"iY" = (/obj/structure/flora/rock/konyang/small,/turf/simulated/floor/exoplanet/dirt_konyang,/area/overgrown_mining_station)
"jJ" = (/obj/structure/lattice/catwalk/indoor/planks,/obj/structure/railing/fence{dir = 4; pixel_x = 2},/obj/structure/railing/fence{dir = 1; pixel_y = 13},/turf/simulated/floor/exoplanet/dirt_konyang,/area/overgrown_mining_station)
"lC" = (/obj/structure/closet/firecloset,/obj/item/crowbar/rescue_axe/red,/obj/item/material/twohanded/fireaxe,/obj/item/extinguisher/mini,/obj/item/extinguisher/mini,/obj/item/reagent_containers/extinguisher_refill/filled,/obj/item/reagent_containers/extinguisher_refill/filled,/obj/item/clothing/suit/fire,/obj/item/clothing/head/hardhat/firefighter,/obj/item/tank/oxygen/red,/obj/item/clothing/suit/storage/toggle/konyang/pants,/obj/item/device/suit_cooling_unit,/obj/item/clothing/shoes/jackboots,/obj/item/device/flashlight/heavy,/obj/item/cell/device/high,/obj/item/cell/device/high,/obj/item/cell/device/high,/obj/item/clothing/under/gearharness,/turf/simulated/floor/wood,/area/overgrown_mining_station)
"mq" = (/obj/structure/rope_post{dir = 8; pixel_y = -4},/obj/structure/rope_post{pixel_y = -4},/obj/structure/rope_railing,/turf/simulated/floor/exoplanet/konyang,/area/overgrown_mining_station)
"nc" = (/obj/structure/flora/bush/konyang_reeds,/turf/simulated/floor/exoplanet/konyang,/area/overgrown_mining_station)
"nE" = (/obj/structure/closet/secure_closet/freezer{pixel_x = -8},/obj/item/reagent_containers/food/snacks/meat/chicken,/obj/item/reagent_containers/food/snacks/meat/chicken,/obj/item/reagent_containers/food/snacks/meat/chicken,/obj/item/reagent_containers/food/snacks/fish,/obj/item/reagent_containers/food/snacks/fish,/obj/item/reagent_containers/food/snacks/fish,/obj/item/reagent_containers/food/snacks/fish,/obj/item/reagent_containers/food/snacks/fish,/obj/item/reagent_containers/food/snacks/fish,/obj/random_produce/box,/obj/random_produce/box,/obj/random_produce/box,/obj/random_produce/box,/obj/random_produce/box,/obj/random_produce/box,/obj/random_produce/box,/obj/random_produce/box,/obj/item/reagent_containers/food/drinks/carton/soymilk,/obj/item/reagent_containers/food/drinks/carton/soymilk,/obj/item/reagent_containers/food/drinks/carton/soymilk,/obj/item/reagent_containers/food/drinks/carton/soymilk,/obj/item/reagent_containers/food/condiment/shaker/salt,/obj/item/reagent_containers/food/condiment/shaker/peppermill,/obj/item/reagent_containers/food/condiment/shaker/spacespice,/obj/item/storage/box/fancy/egg_box,/obj/item/storage/box/fancy/egg_box,/turf/simulated/floor/lino/diamond,/area/overgrown_mining_station)
"nN" = (/obj/structure/flora/rock/konyang/small,/turf/simulated/floor/exoplanet/konyang,/area/overgrown_mining_station)
"pc" = (/obj/structure/chainlink_fence{dir = 4},/obj/structure/flora/bush/konyang_reeds,/turf/simulated/floor/exoplanet/konyang,/area/overgrown_mining_station)
"pX" = (/obj/machinery/appliance/cooker/oven,/turf/simulated/floor/lino/diamond,/area/overgrown_mining_station)
"rc" = (/obj/structure/cable/green{icon_state = "2-4"},/obj/structure/cable/green{icon_state = "1-2"},/obj/structure/lattice/catwalk/indoor/grate,/turf/simulated/floor/concrete/square,/area/overgrown_mining_station)
"vg" = (/obj/structure/bed{name = "bottom bunk"},/obj/effect/decal/fake_object{icon = 'icons/obj/structure/beds.dmi'; icon_state = "bed"; pixel_y = 13; name = "top bunk"; desc = "This is used to lie in, sleep in or strap on. This one is just out of reach."},/obj/structure/railing/mapped{dir = 8; pixel_x = -5},/obj/structure/railing/mapped{dir = 4; pixel_x = 4},/obj/item/bedsheet/red,/obj/item/bedsheet/red{pixel_y = 13},/turf/simulated/floor/wood,/area/overgrown_mining_station)
"wI" = (/obj/structure/automobile{desc = "A newer model car. This one's tires have been swapped out for ones better suited for offroad driving."},/turf/simulated/floor/exoplanet/dirt_konyang,/area/overgrown_mining_station)
"xX" = (/obj/effect/map_effect/window_spawner/full/wood,/turf/simulated/floor/wood,/area/overgrown_mining_station)
"yY" = (/obj/structure/cable/green{icon_state = "1-2"},/obj/structure/lattice/catwalk/indoor/grate,/turf/simulated/floor/concrete/square,/area/overgrown_mining_station)
"AA" = (/obj/structure/flora/rock/konyang/moss,/turf/simulated/floor/exoplanet/konyang,/area/overgrown_mining_station)
"BU" = (/obj/structure/reagent_dispensers/extinguisher,/turf/simulated/floor/concrete/square,/area/overgrown_mining_station)
"Cf" = (/obj/structure/cable/green{icon_state = "1-4"},/turf/simulated/floor/wood,/area/overgrown_mining_station)
"CT" = (/turf/simulated/floor/exoplanet/konyang/pink,/area/overgrown_mining_station)
"CY" = (/obj/structure/cable/green{icon_state = "1-2"},/obj/structure/cable/green{icon_state = "1-8"},/obj/structure/lattice/catwalk/indoor/grate,/turf/simulated/floor/concrete/square,/area/overgrown_mining_station)
"CZ" = (/turf/simulated/floor/concrete/square,/area/overgrown_mining_station)
"DP" = (/obj/structure/cable/green{icon_state = "1-4"},/obj/structure/lattice/catwalk/indoor/grate,/turf/simulated/floor/concrete/square,/area/overgrown_mining_station)
"ER" = (/obj/structure/chainlink_fence{dir = 4},/turf/simulated/floor/exoplanet/konyang,/area/overgrown_mining_station)
"Fe" = (/obj/structure/cable/green{icon_state = "0-8"},/obj/machinery/power/solar,/turf/simulated/floor/concrete/square,/area/overgrown_mining_station)
"FF" = (/turf/simulated/floor/exoplanet/konyang,/area/overgrown_mining_station)
"FH" = (/obj/structure/cable/green{icon_state = "2-8"},/obj/structure/cable/green{icon_state = "1-8"},/obj/structure/cable/green{icon_state = "4-8"},/obj/structure/lattice/catwalk/indoor/grate,/turf/simulated/floor/concrete/square,/area/overgrown_mining_station)
"FV" = (/obj/structure/lattice/catwalk/indoor/planks,/turf/simulated/floor/exoplanet/dirt_konyang,/area/overgrown_mining_station)
"Gk" = (/obj/structure/chainlink_fence{dir = 8},/turf/simulated/floor/concrete/square,/area/overgrown_mining_station)
"HR" = (/obj/structure/sink{dir = 4; pixel_x = 13},/turf/simulated/floor/lino/diamond,/area/overgrown_mining_station)
"HY" = (/obj/structure/lattice/catwalk/indoor/planks,/obj/structure/railing/fence{name = "railing"},/turf/simulated/floor/exoplanet/dirt_konyang,/area/overgrown_mining_station)
"Ib" = (/obj/structure/flora/tree/konyang/blossom,/turf/simulated/floor/exoplanet/konyang,/area/overgrown_mining_station)
"Ip" = (/obj/structure/cable/green{d2 = 2; icon_state = "0-2"},/obj/machinery/power/solar,/turf/simulated/floor/concrete/square,/area/overgrown_mining_station)
"IK" = (/obj/structure/flora/tree/konyang/spring,/turf/simulated/floor/exoplanet/konyang,/area/overgrown_mining_station)
"Kq" = (/obj/structure/chainlink_fence{dir = 8; pixel_y = -19},/obj/structure/chainlink_fence{dir = 8},/turf/simulated/floor/exoplanet/konyang,/area/overgrown_mining_station)
"KI" = (/obj/machinery/portable_atmospherics/canister/oxygen,/turf/simulated/floor/concrete/square,/area/overgrown_mining_station)
"LE" = (/obj/structure/lattice/catwalk/indoor/planks,/obj/structure/railing/fence{dir = 8; pixel_x = -1},/turf/simulated/floor/exoplanet/dirt_konyang,/area/overgrown_mining_station)
"Ms" = (/obj/structure/cable/green{icon_state = "4-8"},/obj/structure/table/rack{pixel_x = 4},/obj/item/material/kitchen/utensil/fork/chopsticks,/obj/item/material/kitchen/utensil/fork/chopsticks,/obj/item/material/kitchen/utensil/fork/chopsticks,/obj/item/material/kitchen/utensil/fork/chopsticks,/obj/item/material/kitchen/utensil/spoon{pixel_x = 9},/obj/item/material/kitchen/utensil/spoon{pixel_x = 9},/obj/item/material/kitchen/utensil/spoon{pixel_x = 9},/obj/item/material/kitchen/utensil/spoon{pixel_x = 9},/obj/item/material/kitchen/utensil/knife{pixel_x = 4},/obj/item/reagent_containers/food/condiment/flour{pixel_x = 7},/turf/simulated/floor/wood,/area/overgrown_mining_station)
"Mu" = (/obj/structure/chainlink_fence{layer = 9.1},/turf/simulated/floor/exoplanet/konyang,/area/overgrown_mining_station)
"Ni" = (/obj/machinery/appliance/cooker/stove,/turf/simulated/floor/lino/diamond,/area/overgrown_mining_station)
"Nq" = (/turf/simulated/floor/exoplanet/konyang/wilting,/area/overgrown_mining_station)
"NH" = (/obj/structure/lattice/catwalk/indoor/planks/stairs{dir = 4},/obj/structure/rope_post{dir = 8},/obj/structure/rope_railing{pixel_y = 4},/obj/structure/rope_post,/turf/simulated/floor/exoplanet/dirt_konyang,/area/overgrown_mining_station)
"NW" = (/obj/structure/cable/green{icon_state = "4-8"},/turf/simulated/wall/wood,/area/overgrown_mining_station)
"OL" = (/obj/structure/lattice/catwalk/indoor/planks/stairs{dir = 8},/obj/structure/rope_post,/obj/structure/rope_post{dir = 8},/obj/structure/rope_railing{pixel_y = 4},/turf/simulated/floor/exoplanet/konyang,/area/overgrown_mining_station)
"Qo" = (/obj/effect/floor_decal/konyang_flowers,/turf/simulated/floor/exoplanet/konyang,/area/overgrown_mining_station)
"Rr" = (/obj/structure/lattice/catwalk/indoor/planks,/obj/structure/railing/fence{dir = 1; pixel_y = 13},/obj/structure/railing/fence{dir = 8; pixel_x = -1},/turf/simulated/floor/exoplanet/dirt_konyang,/area/overgrown_mining_station)
"RK" = (/obj/structure/chainlink_fence{dir = 8},/obj/structure/closet/outhouse,/turf/simulated/floor/concrete,/area/overgrown_mining_station)
"Sz" = (/obj/structure/cable/green,/obj/machinery/power/solar,/turf/simulated/floor/concrete/square,/area/overgrown_mining_station)
"SI" = (/obj/structure/chainlink_fence{dir = 8},/turf/simulated/floor/exoplanet/konyang,/area/overgrown_mining_station)
"Tb" = (/obj/structure/cable/green{icon_state = "1-2"},/obj/structure/cable/green{icon_state = "1-4"},/obj/structure/lattice/catwalk/indoor/grate,/turf/simulated/floor/concrete/square,/area/overgrown_mining_station)
"Tr" = (/obj/machinery/recharge_station,/obj/item/toy/plushie/bearfire,/turf/simulated/floor/wood,/area/overgrown_mining_station)
"TR" = (/obj/structure/lattice/catwalk/indoor/planks,/obj/structure/railing/fence{name = "railing"},/obj/structure/railing/fence{dir = 4; pixel_x = 2},/turf/simulated/floor/exoplanet/dirt_konyang,/area/overgrown_mining_station)
"Uw" = (/obj/structure/flora/rock/konyang,/turf/simulated/floor/exoplanet/konyang,/area/overgrown_mining_station)
"Yf" = (/obj/machinery/mech_recharger,/mob/living/heavy_vehicle/premade/firefighter,/turf/simulated/floor/concrete/square,/area/overgrown_mining_station)
"Zr" = (/obj/structure/flora/tree/konyang/fall,/turf/simulated/floor/exoplanet/konyang/pink,/area/overgrown_mining_station)
"Zs" = (/obj/structure/cable/green{icon_state = "0-8"},/obj/machinery/power/tracker,/turf/simulated/floor/concrete/square,/area/overgrown_mining_station)

(1,1,1) = {"
FFFFFFQoFFFFQoncFFFFFFFFNqncFFFFFFFFnNFFFFncFFnNFFNqncFFFFFF
FFncFFFFFFFFFFFFFFNqUwMuMuMuMuMuMuMuMuMuMuMuMuMuMuMuMuMuMuMu
FFbCFFUwFFFFAAFFIKFFNqRKfbCZIpIpIpIpIpIpIpIpIpIpIpIpIpIpFFpc
FFQoFFFFFFFFFFFFncFFNqGkCZfqFHFHFHFHFHFHFHFHFHFHFHFHFHFHFeER
FFFFFFncFFFFQoFFFFUwQoSINqyYSzSzSzSzSzSzSzSzSzSzSzSzSzSzFFER
FFFFAAFFFFnNFFFFFFnNNqSIFFyYFFFFNqFFFFncFFNqFFFFncFFFFFFncER
FFFFFFNqFFFFQoFFQoFFFFKqQoyYIpIpIpIpIpIpIpIpIpIpIpIpIpIpFFER
FFIKFFFFFFFFFFFFFFFFFFFFFFrcFHFHFHFHFHFHFHFHFHFHFHFHFHFHFeER
FFFFQoFFRrgwgwgwgwgwgwjJmqyYSzSzSzSzSzSzSzSzSzSzSzSzSzSznNER
FFFFncFFLEFVFVFVFVFVFVFVNHyYFFFFFFncFFFFFFFFFFFFFFncFFNqQopc
FFFFncFFLEFVbExXxXxXxXbEFFyYIpIpIpIpIpIpIpIpIpIpIpIpIpIpFFER
FFUwFFFFLEFVxXNipXfZnEbEBUrcFHFHFHFHFHFHFHFHFHFHFHFHFHFHZsER
FFFFFFinLEFVbEfMheheHRbEYfyYSzSzSzSzSzSzSzSzSzSzSzSzSzSzncER
QoFFhJOLFVFVgJCfhnhnMsNWfwCYFFFFFFFFFFNqFFFFFFncFFQoFFFFFFER
FFFFhJQoLEFVbEdBbkbkbkbEBUyYIpIpIpIpIpIpIpIpIpIpIpIpIpIpnNER
FFFFhJQoLEFVxXTrlClCvgbEKITbFHFHFHFHFHFHFHFHFHFHFHFHFHFHFeER
nNFFhJQoLEFVbExXxXxXxXbEmqyYSzSzSzSzSzSzSzSzSzSzSzSzSzSzFFER
FFFFhJQoLEFVFVFVFVFVFVFVNHyYFFFFFFNqFFFFncQoFFFFFFNqFFFFFFER
FFFFhJQoeNHYHYHYHYHYHYTRFFyYIpIpIpIpIpIpIpIpIpIpIpIpIpIpncER
FFFFhJhJhJhJhJhJhJhJhJhJhJDPFHFHFHFHFHFHFHFHFHFHFHFHFHFHFeER
IKFFFFhJhJhJhJhJhJwIhJhJhJCZSzSzSzSzSzSzSzSzSzSzSzSzSzSzFFER
FFFFFFFFFFhJhJhJhJhJhJhJhJePePePePePePePePePePePePePePePePeP
FFFFUwFFFFFFFFFFhJhJhJhJhJhJhJFFFFFFQoFFncFFncFFFFFFUwbCFFFF
FFFFFFFFFFFFFFFFFFFFFFhJhJiYhJhJhJFFFFFFFFFFCTZrCTFFFFFFAAFF
FFFFFFncQoFFFFFFFFFFFFFFFFFFhJhJhJFFFFncFFFFnNCTFFFFFFnNFFQo
FFFFIKFFFFFFUwFFFFFFFFAAFFFFFFFFhJhJFFFFFFFFFFFFUwFFFFFFQoFF
FFFFFFbCFFnNFFFFFFFFFFFFFFCTFFFFhJhJhJhJFFFFQoFFFFFFIKFFFFFF
FFFFAAFFFFFFFFFFFFIbFFFFFFFFFFFFFFFFFFFFhJhJhJFFFFFFFFFFncFF
FFFFFFFFncFFCTFFFFUwFFFFncncFFFFFFFFFFFFFFFFFFFFhJFFFFFFFFQo
FFFFFFFFFFFFFFFFFFFFFFFFFFFFFFFFIKFFAAQoFFFFFFFFQoFFFFhJFFFF
"}
