"am" = (/obj/structure/chainlink_fence{layer = 9.1},/obj/structure/chainlink_fence{dir = 4},/turf/simulated/floor/exoplanet/konyang,/area/overgrown_mining_station)
"aw" = (/obj/structure/chainlink_fence{dir = 1},/obj/structure/flora/rock/konyang/water,/turf/simulated/floor/exoplanet/water/konyang,/area/overgrown_mining_station)
"aW" = (/obj/structure/flora/bush/konyang_reeds,/turf/simulated/floor/exoplanet/konyang,/area/overgrown_mining_station)
"bn" = (/obj/structure/window/urban{dir = 8; layer = 3.3},/obj/item/clothing/under/konyangdress{pixel_y = 8},/obj/item/clothing/under/konyangdress,/obj/structure/table/rack/clothing{layer = 3.1},/turf/simulated/floor/wood,/area/overgrown_mining_station)
"cn" = (/obj/structure/lattice/catwalk/indoor/planks/opaque,/obj/structure/railing/fence{dir = 1},/obj/structure/railing/fence{dir = 4},/turf/simulated/floor/exoplanet/konyang,/area/overgrown_mining_station)
"cv" = (/obj/machinery/appliance/cooker/oven,/turf/simulated/floor/lino/diamond,/area/overgrown_mining_station)
"cB" = (/turf/simulated/floor/exoplanet/dirt_konyang,/area/overgrown_mining_station)
"fe" = (/obj/structure/lattice/catwalk/indoor/planks/stairs{dir = 1},/turf/simulated/floor/exoplanet/konyang,/area/overgrown_mining_station)
"gJ" = (/obj/structure/railing/fence{dir = 4; pixel_x = 2},/turf/simulated/floor/exoplanet/konyang,/area/overgrown_mining_station)
"gP" = (/obj/effect/floor_decal/konyang_flowers,/turf/simulated/floor/exoplanet/konyang/pink,/area/overgrown_mining_station)
"hV" = (/obj/structure/chainlink_fence{dir = 4},/turf/simulated/floor/exoplanet/konyang,/area/overgrown_mining_station)
"kr" = (/obj/structure/closet/secure_closet/freezer/fridge{pixel_x = -8},/obj/item/reagent_containers/food/snacks/fish,/obj/item/reagent_containers/food/snacks/fish,/obj/item/reagent_containers/food/snacks/fish,/obj/item/reagent_containers/food/snacks/fish,/obj/item/reagent_containers/food/snacks/fish,/obj/item/reagent_containers/food/snacks/moss_dumplings,/obj/item/reagent_containers/food/snacks/moss_dumplings,/obj/item/reagent_containers/food/snacks/mossbowl,/obj/item/reagent_containers/food/snacks/mossbowl,/turf/simulated/floor/lino/diamond,/area/overgrown_mining_station)
"kw" = (/turf/simulated/floor/exoplanet/konyang/pink,/area/overgrown_mining_station)
"kI" = (/obj/machinery/door/urban{dir = 4},/turf/simulated/floor/wood,/area/overgrown_mining_station)
"mh" = (/turf/simulated/floor/exoplanet/konyang,/area/overgrown_mining_station)
"mJ" = (/obj/structure/flora/rock/konyang,/turf/simulated/floor/exoplanet/konyang,/area/overgrown_mining_station)
"mL" = (/obj/structure/closet/cabinet,/obj/item/clothing/head/konyang/army/officer,/obj/item/clothing/under/rank/konyang/navy/officer{pixel_y = -7},/obj/item/clothing/under/konyang/blue,/obj/item/clothing/suit/storage/toggle/konyang/pants,/obj/item/clothing/suit/storage/toggle/konyang/orange,/obj/item/clothing/suit/storage/toggle/konyang/blue,/obj/item/clothing/suit/storage/hooded/wintercoat/konyang,/obj/item/clothing/under/konyangdress,/turf/simulated/floor/wood,/area/overgrown_mining_station)
"oP" = (/obj/structure/table/rack{pixel_x = 5},/obj/item/material/kitchen/utensil/fork/chopsticks,/obj/item/material/kitchen/utensil/fork/chopsticks,/obj/item/material/kitchen/utensil/fork/chopsticks,/obj/item/material/kitchen/utensil/fork/chopsticks,/obj/item/reagent_containers/food/drinks/drinkingglass/newglass/coffeecup{pixel_x = 12; pixel_y = 4},/obj/item/reagent_containers/food/drinks/drinkingglass/newglass/coffeecup{pixel_x = 12; pixel_y = -3},/turf/simulated/floor/wood,/area/overgrown_mining_station)
"pX" = (/obj/structure/chainlink_fence{dir = 1},/turf/simulated/floor/exoplanet/konyang,/area/overgrown_mining_station)
"pZ" = (/obj/structure/flora/rock/konyang/small,/obj/effect/floor_decal/konyang_flowers,/turf/simulated/floor/exoplanet/konyang,/area/overgrown_mining_station)
"qj" = (/turf/simulated/floor/wood,/area/overgrown_mining_station)
"rl" = (/obj/structure/lattice/catwalk/indoor/tatami{dir = 8},/turf/simulated/floor/wood,/area/overgrown_mining_station)
"rA" = (/obj/structure/coatrack,/turf/simulated/floor/wood,/area/overgrown_mining_station)
"sg" = (/obj/structure/lattice/catwalk/indoor/planks/opaque,/obj/structure/railing/fence{dir = 4},/obj/structure/railing/fence,/turf/simulated/floor/exoplanet/konyang,/area/overgrown_mining_station)
"sl" = (/turf/simulated/floor/lino/diamond,/area/overgrown_mining_station)
"uN" = (/turf/simulated/floor/exoplanet/water/konyang,/area/overgrown_mining_station)
"uS" = (/obj/structure/railing/fence{dir = 8; pixel_x = -1},/turf/simulated/floor/exoplanet/konyang,/area/overgrown_mining_station)
"uT" = (/obj/structure/window/urban{dir = 8; layer = 3.3},/obj/structure/table/rack/clothing{layer = 3.1},/obj/item/clothing/under/konyangdresstraditional/red,/obj/item/clothing/under/konyangdresstraditional/national/vest,/turf/simulated/floor/wood,/area/overgrown_mining_station)
"vu" = (/obj/effect/map_effect/window_spawner/full/wood,/turf/simulated/floor/wood,/area/overgrown_mining_station)
"wd" = (/obj/structure/lattice/catwalk/indoor/planks/opaque,/obj/structure/railing/fence{dir = 4},/obj/structure/bed/stool/bamboo,/turf/simulated/floor/exoplanet/konyang,/area/overgrown_mining_station)
"ws" = (/obj/structure/lattice/catwalk/indoor/planks/opaque,/obj/structure/railing/fence{dir = 4},/obj/structure/table/rack/cafe_table,/turf/simulated/floor/exoplanet/konyang,/area/overgrown_mining_station)
"wO" = (/obj/structure/railing/fence,/obj/structure/lattice/catwalk/indoor/planks/opaque,/turf/simulated/floor/exoplanet/konyang,/area/overgrown_mining_station)
"xe" = (/obj/structure/table/rack{pixel_y = 8; pixel_x = 5},/obj/item/reagent_containers/cooking_container/board/bowl{pixel_x = 5; pixel_y = 17},/obj/item/reagent_containers/cooking_container/board/bowl{pixel_x = 5; pixel_y = 8},/turf/simulated/floor/wood,/area/overgrown_mining_station)
"xi" = (/obj/effect/floor_decal/konyang_flowers,/turf/simulated/floor/exoplanet/konyang,/area/overgrown_mining_station)
"xq" = (/obj/structure/window/urban{dir = 8},/obj/structure/table/rack/clothing{layer = 3.1},/obj/item/clothing/suit/storage/hooded/wintercoat/konyang{pixel_y = 9},/obj/item/clothing/suit/storage/hooded/wintercoat/konyang{pixel_y = 5},/turf/simulated/floor/wood,/area/overgrown_mining_station)
"xV" = (/obj/structure/lattice/catwalk/indoor/planks/stairs{dir = 8},/turf/simulated/floor/exoplanet/konyang,/area/overgrown_mining_station)
"yf" = (/obj/effect/map_effect/window_spawner/full/wood,/turf/simulated/floor/exoplanet/dirt_konyang,/area/overgrown_mining_station)
"yZ" = (/obj/machinery/door/urban,/turf/simulated/floor/tiled/white,/area/overgrown_mining_station)
"zM" = (/obj/structure/table/wood/bamboo,/obj/item/reagent_containers/glass/bucket/wood{pixel_x = -4; pixel_y = 11},/obj/item/reagent_containers/glass/bucket/wood{pixel_x = -6},/turf/simulated/floor/exoplanet/dirt_konyang,/area/overgrown_mining_station)
"zX" = (/obj/structure/chainlink_fence{dir = 1},/turf/simulated/floor/exoplanet/water/konyang,/area/overgrown_mining_station)
"zY" = (/obj/machinery/appliance/cooker/stove,/obj/machinery/appliance/cooker/stove,/turf/simulated/floor/lino/diamond,/area/overgrown_mining_station)
"BV" = (/obj/structure/flora/rock/konyang/small,/obj/structure/flora/bush/konyang_reeds,/turf/simulated/floor/exoplanet/konyang,/area/overgrown_mining_station)
"CG" = (/obj/structure/railing/fence{dir = 8},/obj/structure/lattice/catwalk/indoor/planks/opaque,/turf/simulated/floor/exoplanet/konyang,/area/overgrown_mining_station)
"Da" = (/obj/structure/lattice/catwalk/indoor/planks/opaque,/obj/structure/railing/fence{dir = 4},/obj/structure/bed/stool/bamboo{dir = 1},/turf/simulated/floor/exoplanet/konyang,/area/overgrown_mining_station)
"DR" = (/obj/structure/sink{dir = 4; pixel_x = 12},/turf/simulated/floor/lino/diamond,/area/overgrown_mining_station)
"Em" = (/obj/structure/table/rack{pixel_x = -5},/obj/item/toy/comic/inspector,/obj/item/toy/comic/inspector,/obj/item/toy/comic/inspector,/obj/item/toy/comic/inspector,/obj/item/melee/energy/sword/knife,/obj/item/material/knife/butterfly,/turf/simulated/floor/wood,/area/overgrown_mining_station)
"EA" = (/obj/structure/table/wood/bamboo,/obj/item/seeds/carrotseed,/obj/item/seeds/carrotseed,/obj/item/seeds/carrotseed,/obj/item/seeds/cabbageseed,/obj/item/seeds/cabbageseed,/obj/item/seeds/cabbageseed,/obj/item/seeds/chiliseed,/obj/item/seeds/chiliseed,/obj/item/seeds/chiliseed,/obj/item/seeds/cornseed,/obj/item/seeds/cornseed,/obj/item/seeds/cornseed,/obj/item/seeds/garlicseed,/obj/item/seeds/garlicseed,/obj/item/seeds/garlicseed,/obj/item/seeds/onionseed,/obj/item/seeds/onionseed,/obj/item/seeds/onionseed,/obj/item/seeds/peanutseed,/obj/item/seeds/peanutseed,/obj/item/seeds/peanutseed,/obj/item/seeds/potatoseed,/obj/item/seeds/potatoseed,/obj/item/seeds/potatoseed,/obj/item/seeds/seaweed,/obj/item/seeds/seaweed,/obj/item/seeds/seaweed,/obj/item/seeds/seaweed,/obj/item/seeds/seaweed,/obj/item/seeds/seaweed,/obj/item/seeds/mossseed,/obj/item/seeds/mossseed,/obj/item/seeds/mossseed,/obj/item/seeds/mossseed,/obj/item/seeds/mossseed,/obj/item/seeds/mossseed,/obj/item/seeds/mossseed,/obj/item/seeds/mossseed,/obj/item/seeds/mossseed,/obj/item/seeds/mossseed,/obj/item/seeds/mossseed,/obj/item/seeds/mossseed,/obj/item/seeds/wheatseed,/obj/item/seeds/wheatseed,/obj/item/seeds/wheatseed,/obj/item/storage/box/shotgunshells,/obj/item/storage/box/shotgunshells,/obj/item/gun/projectile/shotgun/doublebarrel/sawn,/turf/simulated/floor/exoplanet/dirt_konyang,/area/overgrown_mining_station)
"Fh" = (/obj/machinery/door/urban,/turf/simulated/floor/wood,/area/overgrown_mining_station)
"FD" = (/obj/structure/lattice/catwalk/indoor/planks/opaque,/obj/structure/railing/fence{dir = 1},/turf/simulated/floor/exoplanet/konyang,/area/overgrown_mining_station)
"FI" = (/obj/structure/chainlink_fence{layer = 9.1},/turf/simulated/floor/exoplanet/konyang,/area/overgrown_mining_station)
"FN" = (/obj/structure/flora/tree/konyang/blossom,/turf/simulated/floor/exoplanet/konyang,/area/overgrown_mining_station)
"FO" = (/obj/structure/table/wood/bamboo,/obj/item/reagent_containers/glass/fertilizer/ez{pixel_x = 9; pixel_y = 15},/obj/item/reagent_containers/glass/fertilizer/ez{pixel_x = 9; pixel_y = 10},/obj/item/reagent_containers/glass/fertilizer/ez{pixel_x = -6; pixel_y = 16},/obj/item/reagent_containers/glass/fertilizer/ez{pixel_x = -6; pixel_y = 10},/turf/simulated/floor/exoplanet/dirt_konyang,/area/overgrown_mining_station)
"Gp" = (/obj/structure/chainlink_fence{dir = 4},/obj/structure/chainlink_fence{dir = 1},/turf/simulated/floor/exoplanet/konyang,/area/overgrown_mining_station)
"Jc" = (/obj/structure/window/urban{dir = 4; layer = 3.3},/obj/machinery/washing_machine,/turf/simulated/floor/wood,/area/overgrown_mining_station)
"LG" = (/obj/structure/window/urban{dir = 4; layer = 3.3},/obj/structure/table/rack/cafe_table,/turf/simulated/floor/wood,/area/overgrown_mining_station)
"LQ" = (/obj/machinery/portable_atmospherics/hydroponics/soil,/turf/simulated/floor/exoplanet/dirt_konyang,/area/overgrown_mining_station)
"Ng" = (/obj/machinery/door/urban,/turf/simulated/floor/exoplanet/dirt_konyang,/area/overgrown_mining_station)
"Ni" = (/obj/structure/table/stone/marble,/obj/item/trash/dipbowl{pixel_x = 5; pixel_y = 10},/obj/item/material/kitchen/utensil/knife{pixel_x = -8},/turf/simulated/floor/lino/diamond,/area/overgrown_mining_station)
"NE" = (/obj/structure/flora/bush,/turf/simulated/floor/exoplanet/konyang,/area/overgrown_mining_station)
"Oj" = (/obj/structure/table/stone/marble,/obj/item/reagent_containers/food/condiment/flour{pixel_x = -6; pixel_y = 16},/obj/item/reagent_containers/food/condiment/shaker/salt{pixel_x = 6; pixel_y = 11},/obj/item/reagent_containers/food/condiment/shaker/peppermill{pixel_x = 14; pixel_y = 11},/obj/item/reagent_containers/food/condiment/shaker/spacespice{pixel_x = -11; pixel_y = 7},/turf/simulated/floor/lino/diamond,/area/overgrown_mining_station)
"OW" = (/obj/structure/toilet{pixel_x = -9; pixel_y = 12},/obj/structure/sink{pixel_x = 8; pixel_y = 29},/obj/machinery/shower{dir = 8; pixel_x = 1; pixel_y = -6},/turf/simulated/floor/tiled/white,/area/overgrown_mining_station)
"Pd" = (/obj/structure/flora/tree/konyang/spring,/turf/simulated/floor/exoplanet/konyang,/area/overgrown_mining_station)
"Pz" = (/turf/simulated/wall/wood,/area/overgrown_mining_station)
"QY" = (/obj/structure/flora/rock/konyang/moss,/turf/simulated/floor/exoplanet/konyang,/area/overgrown_mining_station)
"Ss" = (/obj/structure/flora/rock/konyang/small,/turf/simulated/floor/exoplanet/konyang,/area/overgrown_mining_station)
"Sz" = (/obj/structure/lattice/catwalk/indoor/planks/opaque,/obj/structure/railing/fence{dir = 4},/turf/simulated/floor/exoplanet/konyang,/area/overgrown_mining_station)
"SU" = (/obj/structure/window/urban{dir = 4; layer = 3.3},/obj/structure/bed/stool/bar/wood{dir = 8},/turf/simulated/floor/wood,/area/overgrown_mining_station)
"Tg" = (/obj/structure/bed/chair,/obj/structure/lattice/catwalk/indoor/tatami{dir = 4},/obj/item/bedsheet/random,/turf/simulated/floor/wood,/area/overgrown_mining_station)
"Vb" = (/obj/structure/table/wood/bamboo,/obj/item/reagent_containers/glass/fertilizer/rh{pixel_x = 9; pixel_y = 15},/obj/item/reagent_containers/glass/fertilizer/rh{pixel_x = -5; pixel_y = 15},/obj/item/reagent_containers/glass/fertilizer/rh{pixel_x = 9; pixel_y = 8},/obj/item/reagent_containers/glass/fertilizer/rh{pixel_x = -5; pixel_y = 8},/turf/simulated/floor/exoplanet/dirt_konyang,/area/overgrown_mining_station)
"Vt" = (/obj/structure/lattice/catwalk/indoor/planks/opaque,/turf/simulated/floor/exoplanet/konyang,/area/overgrown_mining_station)
"VU" = (/obj/structure/flora/rock/konyang/water,/turf/simulated/floor/exoplanet/water/konyang,/area/overgrown_mining_station)
"WQ" = (/obj/structure/table/rack{pixel_x = -5},/turf/simulated/floor/wood,/area/overgrown_mining_station)
"Zc" = (/obj/structure/flora/tree/konyang/fall,/turf/simulated/floor/exoplanet/konyang,/area/overgrown_mining_station)

(1,1,1) = {"
aWaWmhmhmhmhmhmhmhmhmhmhmhmhmhmhmhmhSsmhmhmhQYmhmhSsmhmhmhmh
mhmhximhkwmhmhximhmhmhmhmhmhmJmhmhkwmhmhmhaWaWaWmhximhaWkwmh
mhmhmhZcmhaWaWmhmhmhximhPdmhaWmhmhmhaWaWSsmhmhmhmhmhmhSsaWmh
mhmhmhaWmhmhmhmJmhmhmhmhmhmhaWaWaWmhaWaWmhmhmhPdmhmhmhmhQYmh
mhSsaWaWmhmhaWmhmhmhkwmhmhpZmhmhximhSsmhmhkwmJmhaWaWaWaWmhmh
mhQYmhmhNEmhaWaWaWmhmhmhaWaWmhmhmhPzPzyfPzPzmhmhmhmhuNVUmhmh
mhmhmhximhaWmhmhmhmhximhmhmhmhmhmhPzzMcBFOPzmhmhuNuNuNuNmhmh
mhSsaWmhmhmhmJSsmhPzPzPzPzvuvuvuPzPzEAcBVbPzpXawzXzXzXGpmhSs
mhmhmhmhmhmhmhmhmhPzOWPzcvOjzYNikrPzPzNgyfPzmhmhmhmhmhhVmhmh
mhaWaWmhPdmhmhmhmhPzyZPzslslslslDRPzmhmhmhmhcBLQLQLQmhhVmhaW
mhaWaWmhmhmhmhmhQYPzqjqjqjqjqjqjoPPzmhcBcBcBcBcBcBcBmhhVmhaW
mhkwmhSsmhmhkwximhPzqjqjqjqjqjqjxePzgJfeuScBcBLQLQLQmhhVBVmh
mhmhximhmhmhmhmhmhPzWQqjqjrAqjqjqjSUFDVtcnmhcBcBcBcBmhhVaWmh
mhmhmhmJmhaWmhSsmhPzPzPzFhPzqjqjqjLGVtVtwdmhcBLQLQLQmhhVmhxi
mhmhmhmhmhmhmhximhmhmhCGVtPzqjqjqjJcVtVtwsmhcBcBcBcBmhhVmhmh
aWaWmhmhmhmhaWmhmhcBxVwOwOPzqjqjqjPzVtVtDamhcBLQLQLQmhhVmhBV
aWaWmhFNmhcBcBcBcBcBmhmhmhxqqjqjqjPzVtVtSzmhcBcBcBcBmhhVaWmh
aWaWmhmhcBxiaWaWmhmhmhmhmhbnqjqjqjkIVtVtSzmhcBLQLQLQmhhVaWmh
mhcBcBmhmhmhaWaWmhmhmhmJmhuTqjqjqjPzVtVtsgmhcBcBcBcBmhhVBVmJ
mhmhmhmhmhmhmhmhPdmhmhmhmhPzPzFhPzPzPzPzmhmhcBLQLQLQmhhVmhmh
mhmhmhPdmhmhSsmhmhmhmhmhmhPzmLqjqjrlTgPzmhmhmhmhmhmhmhhVaWxi
mhmhmhmhmhmhmhaWmhmhSsmhmhPzqjqjqjrlTgPzmhmhmhmhmhmhmhhVaWSs
mhmhkwmhmhQYmhmhmhaWmhmhmhPzEmqjqjqjqjPzmhmhmhmhmhmhmhhVaWmh
aWaWmhmhmhmhmhmhmhmhkwmhxiPzPzvuvuvuPzPzFIFIFIFIFIFIFIamxiaW
mhmhximhmhmhmhximhmhmhmhmhmhmhmhmhmhmhmhmhmhmhmhmhmhmhmhmhmh
mhmhmhZcmhaWaWmhmhximhSsmhmhmhmhmhmhaWmhSsmhxiaWmhmhSsmhmhmh
mJmhmhaWmhmhmhmJmhmhaWmhmhmhPdmhaWmhmhmhmhmhaWaWmhaWmhmhPdmh
mhSsaWaWmhmhaWmhmhmhmhmhmhmhmhmhximhFNmhmhaWmhmhmhaWQYmhmhmh
mhmhmhmhNEmhaWaWaWximhmhmhmhmhmhSsmhmhmJmhmhmhmhPdmhmhSsaWmh
mhmhmhmhmhmhmhmhmhmhmhmhPdmhmhgPkwmhmhaWaWaWaWmhmhmhmhmhmhmh
"}
