//MAP CONVERTED BY dmm2tgm.py THIS HEADER COMMENT PREVENTS RECONVERSION, DO NOT REMOVE
"al" = (
/obj/structure/table/rack,
/obj/item/material/minihoe,
/obj/item/material/minihoe,
/obj/item/material/minihoe,
/obj/item/material/minihoe,
/turf/simulated/floor/exoplanet/wood/birch{
	temperature = 315.15
	},
/area/template_noop)
"bK" = (
/obj/machinery/light{
	dir = 4;
	status = 2
	},
/turf/simulated/floor/exoplanet/desert{
	temperature = 315.15
	},
/area/template_noop)
"bO" = (
/obj/machinery/light{
	dir = 8
	},
/turf/simulated/floor/exoplanet/desert{
	temperature = 315.15
	},
/area/template_noop)
"ch" = (
/obj/structure/table/rack,
/obj/item/material/hatchet,
/obj/machinery/light,
/turf/simulated/floor/exoplanet/wood/birch{
	temperature = 315.15
	},
/area/template_noop)
"cp" = (
/obj/structure/flora/log_bench,
/turf/simulated/floor/exoplanet/desert{
	temperature = 315.15
	},
/area/template_noop)
"cJ" = (
/obj/structure/railing/fence{
	dir = 8
	},
/turf/simulated/floor/exoplanet/desert{
	temperature = 315.15
	},
/area/template_noop)
"cL" = (
/obj/structure/table/wood,
/obj/item/device/flashlight/lantern,
/obj/item/device/flashlight/lantern,
/turf/simulated/floor/exoplanet/wood/birch{
	temperature = 315.15
	},
/area/template_noop)
"dc" = (
/obj/structure/bed/padded,
/obj/structure/curtain/open/bed,
/obj/item/bedsheet/black,
/turf/simulated/floor/exoplanet/wood/birch{
	temperature = 315.15
	},
/area/template_noop)
"dp" = (
/obj/structure/bed/stool/chair/wood{
	dir = 4
	},
/turf/simulated/floor/exoplanet/desert{
	temperature = 315.15
	},
/area/template_noop)
"dI" = (
/obj/item/material/stool/chair/wood,
/turf/simulated/floor/exoplanet/wood/birch{
	temperature = 315.15
	},
/area/template_noop)
"dQ" = (
/obj/structure/table/rack,
/obj/item/reagent_containers/glass/bucket/wood,
/turf/simulated/floor/exoplanet/wood/birch{
	temperature = 315.15
	},
/area/template_noop)
"fb" = (
/mob/living/simple_animal/threshbeast,
/turf/simulated/floor/exoplanet/desert{
	temperature = 315.15
	},
/area/template_noop)
"fG" = (
/obj/structure/bed/stool/chair/wood,
/turf/simulated/floor/exoplanet/desert{
	temperature = 315.15
	},
/area/template_noop)
"gj" = (
/obj/machinery/portable_atmospherics/hydroponics/soil,
/turf/simulated/floor/exoplanet/desert{
	temperature = 315.15
	},
/area/template_noop)
"go" = (
/obj/structure/simple_door/wood,
/turf/simulated/floor/exoplanet/wood/birch{
	temperature = 315.15
	},
/area/template_noop)
"gF" = (
/obj/structure/bed/stool/chair/sofa/left/brown,
/turf/simulated/floor/exoplanet/wood/birch{
	temperature = 315.15
	},
/area/template_noop)
"hm" = (
/turf/simulated/floor/exoplanet/tiled/white{
	temperature = 315.15
	},
/area/template_noop)
"ig" = (
/obj/machinery/light{
	dir = 1
	},
/turf/simulated/floor/exoplanet/tiled/white{
	temperature = 315.15
	},
/area/template_noop)
"iZ" = (
/turf/simulated/wall/sandstone,
/area/template_noop)
"kz" = (
/obj/structure/table/standard,
/obj/item/material/hatchet/butch,
/turf/simulated/floor/exoplanet/tiled/white{
	temperature = 315.15
	},
/area/template_noop)
"lo" = (
/obj/machinery/light,
/turf/simulated/floor/exoplanet/desert{
	temperature = 315.15
	},
/area/template_noop)
"lB" = (
/obj/structure/simple_door/sandstone,
/turf/simulated/floor/exoplanet/marble,
/area/template_noop)
"lI" = (
/obj/structure/railing/fence{
	dir = 4
	},
/obj/structure/railing/fence{
	dir = 8
	},
/turf/simulated/floor/exoplanet/wood/birch{
	temperature = 315.15
	},
/area/template_noop)
"mE" = (
/obj/item/bedsheet/black,
/turf/simulated/floor/exoplanet/desert{
	temperature = 315.15
	},
/area/template_noop)
"nJ" = (
/obj/structure/table/wood,
/obj/item/material/twohanded/pike/pitchfork,
/turf/simulated/floor/exoplanet/wood/birch{
	temperature = 315.15
	},
/area/template_noop)
"nZ" = (
/obj/machinery/light{
	dir = 1
	},
/obj/structure/coatrack,
/turf/simulated/floor/exoplanet/wood/birch{
	temperature = 315.15
	},
/area/template_noop)
"oo" = (
/obj/structure/railing/fence{
	dir = 8
	},
/obj/structure/railing/fence,
/turf/simulated/floor/exoplanet/desert{
	temperature = 315.15
	},
/area/template_noop)
"pb" = (
/obj/structure/railing/fence,
/obj/machinery/portable_atmospherics/hydroponics/soil,
/turf/simulated/floor/exoplanet/desert{
	temperature = 315.15
	},
/area/template_noop)
"pZ" = (
/obj/structure/table/stone/marble,
/obj/item/reagent_containers/cooking_container/board/bowl,
/obj/item/reagent_containers/glass/beaker{
	pixel_x = -6;
	pixel_y = 8
	},
/obj/item/reagent_containers/food/condiment/sugar{
	pixel_x = 7;
	pixel_y = 8
	},
/obj/machinery/light/small{
	dir = 4
	},
/turf/simulated/floor/exoplanet/wood/birch{
	temperature = 315.15
	},
/area/template_noop)
"qi" = (
/obj/structure/bed/stool/chair/wood{
	dir = 1
	},
/turf/simulated/floor/exoplanet/wood/birch{
	temperature = 315.15
	},
/area/template_noop)
"qJ" = (
/obj/structure/railing/fence{
	dir = 1
	},
/turf/simulated/floor/exoplanet/desert{
	temperature = 315.15
	},
/area/template_noop)
"rq" = (
/mob/living/simple_animal/threshbeast,
/turf/simulated/floor/exoplanet/concrete{
	temperature = 315.15
	},
/area/template_noop)
"rY" = (
/obj/structure/closet/cabinet,
/obj/item/gun/projectile/shotgun/doublebarrel,
/obj/item/storage/box/shotgunshells,
/obj/item/storage/box/shotgunshells,
/obj/item/clothing/accessory/storage/bandolier,
/turf/simulated/floor/exoplanet/wood/birch{
	temperature = 315.15
	},
/area/template_noop)
"sH" = (
/turf/simulated/floor/exoplanet/desert{
	temperature = 315.15
	},
/area/template_noop)
"tm" = (
/obj/structure/bed/padded,
/obj/structure/curtain/open/bed,
/obj/item/bedsheet/black,
/turf/simulated/floor/exoplanet/desert{
	temperature = 315.15
	},
/area/template_noop)
"tw" = (
/obj/structure/railing/fence{
	dir = 4
	},
/turf/simulated/floor/exoplanet/desert{
	temperature = 315.15
	},
/area/template_noop)
"tJ" = (
/obj/structure/closet/cabinet,
/obj/item/clothing/under/unathi/himation,
/obj/item/clothing/under/unathi/himation,
/obj/item/clothing/under/unathi{
	color = "#4a3407"
	},
/obj/item/clothing/under/unathi,
/obj/item/clothing/under/unathi/huytai{
	color = "#4a3407"
	},
/turf/simulated/floor/exoplanet/wood/birch{
	temperature = 315.15
	},
/area/template_noop)
"tY" = (
/obj/structure/table/wood,
/obj/item/reagent_containers/glass/bucket/wood,
/turf/simulated/floor/exoplanet/wood/birch{
	temperature = 315.15
	},
/area/template_noop)
"uB" = (
/obj/structure/coatrack,
/turf/simulated/floor/exoplanet/wood/birch{
	temperature = 315.15
	},
/area/template_noop)
"uF" = (
/obj/structure/railing/fence,
/obj/structure/railing/fence{
	dir = 4
	},
/turf/simulated/floor/exoplanet/desert{
	temperature = 315.15
	},
/area/template_noop)
"uN" = (
/obj/structure/table/wood,
/obj/item/device/flashlight/lamp,
/turf/simulated/floor/exoplanet/wood/birch{
	temperature = 315.15
	},
/area/template_noop)
"uR" = (
/obj/structure/table/rack,
/obj/item/reagent_containers/glass/bottle/ammonia,
/obj/item/reagent_containers/glass/bottle/ammonia,
/obj/item/reagent_containers/glass/bottle/ammonia,
/obj/item/reagent_containers/glass/bottle/ammonia,
/obj/item/reagent_containers/glass/bottle/ammonia,
/obj/item/reagent_containers/glass/bottle/ammonia,
/obj/item/reagent_containers/glass/bottle/ammonia,
/obj/item/reagent_containers/glass/bucket/wood,
/obj/item/reagent_containers/glass/bucket/wood,
/turf/simulated/floor/exoplanet/wood/birch{
	temperature = 315.15
	},
/area/template_noop)
"vb" = (
/obj/machinery/light{
	dir = 1
	},
/turf/simulated/floor/exoplanet/carpet/orange{
	temperature = 315.15
	},
/area/template_noop)
"vB" = (
/obj/item/material/stool/chair/wood,
/turf/simulated/floor/exoplanet/desert{
	temperature = 315.15
	},
/area/template_noop)
"wc" = (
/obj/structure/bonfire,
/turf/simulated/floor/exoplanet/desert{
	temperature = 315.15
	},
/area/template_noop)
"xH" = (
/obj/structure/flora/log_bench{
	dir = 4
	},
/turf/simulated/floor/exoplanet/desert{
	temperature = 315.15
	},
/area/template_noop)
"AH" = (
/obj/item/material/stool/chair/wood{
	dir = 4
	},
/turf/simulated/floor/exoplanet/desert{
	temperature = 315.15
	},
/area/template_noop)
"Bg" = (
/obj/machinery/light,
/turf/simulated/floor/exoplanet/wood/birch{
	temperature = 315.15
	},
/area/template_noop)
"BA" = (
/obj/structure/simple_door/wood,
/turf/simulated/floor/exoplanet/desert{
	temperature = 315.15
	},
/area/template_noop)
"BU" = (
/obj/item/material/stool/chair/wood{
	dir = 4
	},
/turf/simulated/floor/exoplanet/wood/birch{
	temperature = 315.15
	},
/area/template_noop)
"Ck" = (
/obj/structure/simple_door/wood,
/turf/simulated/floor/exoplanet/barren{
	temperature = 303.15
	},
/area/template_noop)
"Cu" = (
/obj/machinery/appliance/cooker/oven,
/turf/simulated/floor/exoplanet/wood/birch{
	temperature = 315.15
	},
/area/template_noop)
"DB" = (
/obj/structure/bed/stool/chair/sofa/right/yellow{
	dir = 1
	},
/turf/simulated/floor/exoplanet/carpet/orange{
	temperature = 315.15
	},
/area/template_noop)
"DO" = (
/obj/structure/table/stone/marble,
/obj/item/reagent_containers/cooking_container/board/bowl,
/obj/item/reagent_containers/glass/beaker{
	pixel_x = -6;
	pixel_y = 8
	},
/obj/item/reagent_containers/food/condiment/sugar{
	pixel_x = 7;
	pixel_y = 8
	},
/obj/machinery/light/small{
	dir = 4
	},
/obj/machinery/light{
	dir = 1
	},
/turf/simulated/floor/exoplanet/wood/birch{
	temperature = 315.15
	},
/area/template_noop)
"ED" = (
/obj/structure/table/stone/marble,
/obj/item/clothing/wrists/unathi/maxtlatl,
/obj/item/clothing/accessory/poncho/maxtlatl,
/obj/item/clothing/head/unathi/maxtlatl,
/obj/item/nullrod/shaman,
/turf/simulated/floor/exoplanet/marble/dark{
	temperature = 315.15
	},
/area/template_noop)
"EM" = (
/obj/structure/railing/fence{
	dir = 4
	},
/obj/structure/railing/fence{
	dir = 1
	},
/turf/simulated/floor/exoplanet/desert{
	temperature = 315.15
	},
/area/template_noop)
"Fd" = (
/obj/structure/table/wood,
/obj/item/saddle,
/obj/item/saddle,
/turf/simulated/floor/exoplanet/wood/birch{
	temperature = 315.15
	},
/area/template_noop)
"FP" = (
/obj/structure/closet/crate/hydroponics,
/obj/machinery/light{
	dir = 1
	},
/turf/simulated/floor/exoplanet/wood/birch{
	temperature = 315.15
	},
/area/template_noop)
"GR" = (
/obj/structure/bed/stool/chair/wood{
	dir = 8
	},
/turf/simulated/floor/exoplanet/desert{
	temperature = 315.15
	},
/area/template_noop)
"HF" = (
/obj/structure/table/rack,
/obj/item/wirecutters/clippers,
/obj/item/wirecutters/clippers,
/turf/simulated/floor/exoplanet/desert{
	temperature = 315.15
	},
/area/template_noop)
"Il" = (
/turf/simulated/wall/birchwood,
/area/template_noop)
"Iy" = (
/turf/simulated/floor/exoplanet/marble/dark{
	temperature = 315.15
	},
/area/template_noop)
"IY" = (
/turf/simulated/floor/exoplanet/carpet/orange{
	temperature = 315.15
	},
/area/template_noop)
"IZ" = (
/obj/structure/bed/stool/chair/wood{
	dir = 4
	},
/turf/simulated/floor/exoplanet/wood/birch{
	temperature = 315.15
	},
/area/template_noop)
"Jj" = (
/obj/structure/table/wood,
/turf/simulated/floor/exoplanet/carpet/orange{
	temperature = 315.15
	},
/area/template_noop)
"JA" = (
/obj/structure/railing/fence,
/turf/simulated/floor/exoplanet/desert{
	temperature = 315.15
	},
/area/template_noop)
"Ks" = (
/obj/machinery/light{
	dir = 1
	},
/obj/structure/bed/stool/chair/sofa/right/brown,
/turf/simulated/floor/exoplanet/wood/birch{
	temperature = 315.15
	},
/area/template_noop)
"KY" = (
/obj/structure/closet/crate/hydroponics,
/turf/simulated/floor/exoplanet/wood/birch{
	temperature = 315.15
	},
/area/template_noop)
"Lu" = (
/obj/structure/railing/fence{
	dir = 1
	},
/obj/structure/railing/fence{
	dir = 8
	},
/turf/simulated/floor/exoplanet/desert{
	temperature = 315.15
	},
/area/template_noop)
"MD" = (
/obj/structure/table/wood,
/turf/simulated/floor/exoplanet/wood/birch{
	temperature = 315.15
	},
/area/template_noop)
"MO" = (
/obj/structure/flora/log_bench{
	dir = 8
	},
/turf/simulated/floor/exoplanet/desert{
	temperature = 315.15
	},
/area/template_noop)
"Nc" = (
/obj/structure/bed/stool/chair/wood,
/turf/simulated/floor/exoplanet/wood/birch{
	temperature = 315.15
	},
/area/template_noop)
"Nm" = (
/obj/structure/table/stone/marble,
/obj/item/reagent_containers/food/condiment/enzyme{
	pixel_x = -9;
	pixel_y = 9
	},
/obj/item/reagent_containers/food/condiment/shaker/peppermill{
	pixel_x = -4;
	pixel_y = 11
	},
/obj/item/reagent_containers/food/condiment/shaker/spacespice{
	pixel_x = 3;
	pixel_y = 7
	},
/obj/item/reagent_containers/food/condiment/shaker/salt{
	pixel_x = 8;
	pixel_y = 11
	},
/obj/item/reagent_containers/food/condiment/shaker/peppermill{
	pixel_x = -4;
	pixel_y = 7
	},
/obj/item/reagent_containers/food/condiment/shaker/salt{
	pixel_x = 8;
	pixel_y = 7
	},
/obj/item/reagent_containers/food/condiment/shaker/spacespice{
	pixel_x = 3;
	pixel_y = 1
	},
/obj/item/reagent_containers/food/condiment/enzyme{
	pixel_x = -9;
	pixel_y = 5
	},
/obj/machinery/reagentgrinder,
/obj/machinery/light{
	dir = 4
	},
/turf/simulated/floor/exoplanet/wood/birch{
	temperature = 315.15
	},
/area/template_noop)
"NV" = (
/turf/simulated/floor/exoplanet/concrete{
	temperature = 315.15
	},
/area/template_noop)
"Pz" = (
/obj/structure/table/stone,
/obj/item/flame/candle,
/turf/simulated/floor/exoplanet/marble/dark{
	temperature = 315.15
	},
/area/template_noop)
"UL" = (
/obj/structure/bed/stool/chair/wood{
	dir = 8
	},
/turf/simulated/floor/exoplanet/wood/birch{
	temperature = 315.15
	},
/area/template_noop)
"VM" = (
/obj/structure/table/wood,
/turf/simulated/floor/exoplanet/desert{
	temperature = 315.15
	},
/area/template_noop)
"XZ" = (
/obj/structure/flora/log_bench{
	dir = 1;
	pixel_y = 15
	},
/turf/simulated/floor/exoplanet/desert{
	temperature = 315.15
	},
/area/template_noop)
"Yg" = (
/turf/simulated/floor/exoplanet/wood/birch{
	temperature = 315.15
	},
/area/template_noop)
"YA" = (
/obj/structure/table/rack,
/obj/item/material/hatchet/lumber,
/obj/item/material/hatchet/lumber,
/turf/simulated/floor/exoplanet/wood/birch{
	temperature = 315.15
	},
/area/template_noop)

(1,1,1) = {"
sH
sH
sH
sH
sH
sH
sH
sH
sH
sH
sH
sH
sH
sH
sH
sH
sH
sH
sH
sH
sH
sH
sH
sH
sH
sH
sH
sH
sH
sH
sH
sH
"}
(2,1,1) = {"
sH
sH
sH
sH
sH
sH
sH
sH
sH
sH
sH
NV
sH
Il
Il
Il
Il
sH
sH
sH
sH
Il
sH
sH
sH
Lu
cJ
sH
cJ
sH
oo
sH
"}
(3,1,1) = {"
sH
sH
sH
sH
sH
sH
sH
sH
sH
sH
sH
NV
sH
Il
Cu
Yg
Yg
Yg
Yg
Yg
Bg
Il
Il
Il
Il
qJ
gj
sH
gj
sH
pb
sH
"}
(4,1,1) = {"
sH
sH
sH
Il
Il
Il
Il
Il
sH
sH
sH
NV
sH
Il
Nm
Yg
Yg
dp
AH
IZ
Yg
Il
tJ
uN
Il
qJ
sH
sH
gj
sH
pb
sH
"}
(5,1,1) = {"
sH
sH
sH
sH
sH
sH
sH
Il
sH
sH
sH
sH
sH
Il
DO
Yg
Yg
Jj
Jj
MD
Yg
sH
Yg
sH
Il
qJ
gj
sH
sH
sH
JA
sH
"}
(6,1,1) = {"
sH
Il
sH
sH
sH
sH
sH
Il
sH
sH
sH
NV
sH
sH
Yg
sH
Yg
Jj
MD
MD
Yg
Il
tm
mE
sH
qJ
gj
sH
gj
sH
gj
sH
"}
(7,1,1) = {"
sH
Il
sH
sH
sH
sH
sH
sH
sH
sH
sH
NV
sH
sH
sH
Yg
Yg
IY
GR
vB
Yg
Il
sH
sH
sH
qJ
sH
sH
gj
sH
sH
sH
"}
(8,1,1) = {"
sH
Il
Yg
sH
sH
sH
sH
sH
sH
sH
sH
NV
sH
Il
sH
sH
Yg
Yg
Yg
Yg
Yg
Il
sH
sH
sH
qJ
gj
sH
sH
sH
sH
sH
"}
(9,1,1) = {"
sH
Il
Yg
Yg
sH
sH
sH
sH
sH
sH
sH
NV
sH
sH
sH
Il
Ks
dI
Yg
Yg
Bg
Il
sH
sH
sH
qJ
gj
sH
gj
sH
pb
sH
"}
(10,1,1) = {"
sH
Il
go
lI
lI
lI
Yg
sH
sH
sH
sH
NV
sH
sH
sH
Il
gF
Yg
Yg
uB
VM
sH
sH
sH
sH
EM
tw
sH
tw
tw
uF
sH
"}
(11,1,1) = {"
sH
Il
Yg
Yg
Yg
Yg
Yg
sH
NV
sH
NV
NV
sH
sH
sH
Il
Il
Il
go
Il
sH
Il
sH
sH
sH
sH
sH
NV
sH
NV
sH
sH
"}
(12,1,1) = {"
sH
Il
Yg
Yg
Yg
Yg
Yg
Ck
NV
NV
sH
NV
sH
sH
sH
sH
sH
bO
NV
bO
sH
sH
sH
sH
sH
NV
NV
NV
NV
NV
NV
sH
"}
(13,1,1) = {"
sH
Il
Yg
Yg
Yg
Yg
nJ
Il
sH
sH
sH
NV
sH
sH
sH
sH
sH
sH
NV
sH
sH
sH
sH
sH
sH
NV
sH
sH
sH
sH
sH
sH
"}
(14,1,1) = {"
sH
Il
cL
Fd
Yg
Yg
tY
Il
sH
sH
sH
NV
sH
sH
sH
sH
sH
sH
NV
NV
rq
sH
NV
NV
NV
NV
Il
Il
Il
Il
Il
sH
"}
(15,1,1) = {"
sH
Il
sH
sH
BA
Il
Il
Il
sH
sH
sH
NV
sH
sH
MO
sH
sH
sH
NV
sH
sH
sH
sH
sH
sH
sH
Il
dc
dc
MD
Il
sH
"}
(16,1,1) = {"
sH
sH
sH
hm
hm
hm
Il
sH
sH
sH
sH
NV
sH
XZ
wc
cp
sH
sH
NV
sH
sH
sH
sH
sH
sH
sH
Il
Yg
Yg
Yg
Il
sH
"}
(17,1,1) = {"
sH
sH
sH
ig
hm
sH
sH
sH
sH
sH
sH
NV
sH
sH
xH
sH
sH
sH
NV
sH
sH
sH
sH
Il
sH
Il
Il
rY
tJ
Yg
Il
sH
"}
(18,1,1) = {"
sH
sH
sH
kz
hm
sH
sH
sH
sH
sH
sH
sH
sH
sH
sH
sH
sH
sH
NV
sH
sH
sH
sH
sH
sH
DB
Il
Il
Il
go
Il
sH
"}
(19,1,1) = {"
sH
sH
sH
Il
Il
Il
sH
sH
sH
sH
sH
NV
sH
sH
sH
sH
sH
sH
NV
sH
sH
sH
sH
sH
sH
sH
Yg
BU
BU
Bg
Il
sH
"}
(20,1,1) = {"
sH
sH
sH
sH
sH
sH
sH
sH
sH
sH
sH
NV
sH
sH
sH
sH
sH
sH
NV
sH
fb
sH
lo
Il
vb
sH
fG
MD
MD
Yg
Il
sH
"}
(21,1,1) = {"
sH
sH
sH
sH
sH
sH
sH
sH
sH
sH
sH
NV
NV
NV
NV
sH
NV
NV
NV
NV
NV
NV
NV
Yg
Yg
Yg
Yg
MD
MD
Yg
Il
sH
"}
(22,1,1) = {"
sH
sH
sH
sH
sH
sH
sH
sH
sH
sH
sH
NV
sH
sH
sH
sH
sH
sH
NV
sH
sH
sH
lo
Il
nZ
Yg
Nc
MD
MD
qi
Il
sH
"}
(23,1,1) = {"
sH
sH
sH
sH
sH
sH
sH
sH
sH
sH
sH
NV
sH
sH
sH
sH
sH
sH
NV
sH
sH
sH
sH
sH
MD
Yg
Yg
UL
dI
Bg
Il
sH
"}
(24,1,1) = {"
sH
iZ
iZ
iZ
iZ
iZ
iZ
iZ
sH
sH
sH
NV
sH
sH
sH
sH
sH
sH
NV
sH
sH
sH
sH
sH
sH
Il
go
Il
Il
Il
Il
sH
"}
(25,1,1) = {"
sH
iZ
Iy
Pz
Iy
Pz
Iy
iZ
sH
sH
sH
NV
sH
sH
sH
sH
sH
bK
NV
bK
sH
sH
sH
sH
sH
Yg
Yg
Yg
Yg
Il
sH
sH
"}
(26,1,1) = {"
sH
iZ
Iy
Iy
Iy
Iy
Iy
iZ
sH
sH
sH
NV
sH
sH
sH
sH
Il
Il
sH
Il
sH
sH
sH
sH
Il
sH
sH
Yg
Yg
Il
sH
sH
"}
(27,1,1) = {"
sH
iZ
Iy
ED
Iy
Iy
Iy
lB
sH
sH
sH
NV
sH
sH
sH
sH
sH
sH
Yg
Yg
dQ
sH
sH
sH
Il
Yg
Cu
Nm
pZ
Il
sH
sH
"}
(28,1,1) = {"
sH
iZ
Iy
Iy
Iy
Iy
Iy
iZ
sH
sH
sH
sH
sH
sH
sH
Il
FP
Yg
Yg
Yg
ch
Il
sH
sH
Il
Il
Il
Il
Il
Il
sH
sH
"}
(29,1,1) = {"
sH
iZ
Iy
Pz
Iy
Pz
Iy
iZ
sH
sH
sH
sH
sH
sH
sH
Il
KY
Yg
Yg
sH
HF
sH
sH
sH
sH
sH
sH
sH
sH
sH
sH
sH
"}
(30,1,1) = {"
sH
iZ
iZ
iZ
iZ
iZ
iZ
iZ
sH
sH
sH
sH
sH
sH
sH
Il
Il
YA
al
uR
Il
Il
sH
sH
sH
sH
sH
sH
sH
sH
sH
sH
"}
(31,1,1) = {"
sH
sH
sH
sH
sH
sH
sH
sH
sH
sH
sH
sH
sH
sH
sH
sH
Il
Il
Il
Il
Il
sH
sH
sH
sH
sH
sH
sH
sH
sH
sH
sH
"}
(32,1,1) = {"
sH
sH
sH
sH
sH
sH
sH
sH
sH
sH
sH
sH
sH
sH
sH
sH
sH
sH
sH
sH
sH
sH
sH
sH
sH
sH
sH
sH
sH
sH
sH
sH
"}
