//MAP CONVERTED BY dmm2tgm.py THIS HEADER COMMENT PREVENTS RECONVERSION, DO NOT REMOVE
"a" = (
/turf/simulated/floor/exoplanet/grass/moghes/dirt,
/area/space)
"b" = (
/obj/structure/flora/tree/jungle/random,
/turf/simulated/floor/exoplanet/grass/moghes,
/area/space)
"c" = (
/obj/structure/unathi_pillar,
/turf/simulated/floor/exoplanet/grass/moghes/dirt,
/area/space)
"d" = (
/turf/simulated/floor/exoplanet/grass/moghes,
/area/space)
"e" = (
/obj/effect/floor_decal/carpet{
	dir = 4
	},
/turf/simulated/floor/exoplanet/wood/walnut,
/area/space)
"f" = (
/obj/structure/platform_deco{
	dir = 4
	},
/turf/simulated/floor/exoplanet/wood/walnut,
/area/space)
"g" = (
/obj/item/stack/material/sandstone,
/turf/simulated/floor/exoplanet/grass/moghes,
/area/space)
"h" = (
/obj/structure/bed/chair,
/obj/item/bedsheet/black,
/obj/structure/curtain/open/bed,
/turf/simulated/floor/exoplanet/wood/walnut,
/area/space)
"i" = (
/obj/structure/flora/grass/junglegrass/random,
/turf/simulated/floor/exoplanet/grass/moghes,
/area/space)
"j" = (
/turf/simulated/floor/exoplanet/grass/moghes/dirt{
	icon_state = "edge";
	dir = 8
	},
/area/space)
"k" = (
/obj/structure/platform{
	dir = 8
	},
/turf/simulated/floor/exoplanet/wood/walnut,
/area/space)
"l" = (
/obj/structure/platform,
/obj/effect/floor_decal/carpet{
	dir = 10
	},
/turf/simulated/floor/exoplanet/wood/walnut,
/area/space)
"m" = (
/turf/simulated/floor/carpet,
/area/space)
"n" = (
/obj/structure/simple_door/sandstone,
/turf/simulated/floor/exoplanet/wood/walnut,
/area/space)
"o" = (
/obj/structure/platform{
	dir = 4
	},
/turf/simulated/floor/exoplanet/wood/walnut,
/area/space)
"q" = (
/turf/simulated/floor/exoplanet/grass/moghes/dirt{
	icon_state = "edge";
	dir = 10
	},
/area/space)
"s" = (
/turf/simulated/floor/exoplanet/grass/moghes/dirt{
	icon_state = "edge";
	dir = 1
	},
/area/space)
"t" = (
/turf/simulated/floor/exoplanet/grass/moghes/dirt{
	icon_state = "corner";
	dir = 4
	},
/area/space)
"u" = (
/obj/structure/bed/stool/chair/sofa/pew/left{
	dir = 1
	},
/turf/simulated/floor/exoplanet/wood/walnut,
/area/space)
"v" = (
/turf/simulated/floor/exoplanet/grass/moghes/dirt{
	icon_state = "edge";
	dir = 4
	},
/area/space)
"w" = (
/obj/structure/bed/stool/chair/sofa/pew{
	dir = 1
	},
/turf/simulated/floor/exoplanet/wood/walnut,
/area/space)
"x" = (
/obj/structure/platform_stairs{
	dir = 4
	},
/turf/simulated/floor/exoplanet/wood/walnut,
/area/space)
"y" = (
/turf/simulated/floor/exoplanet/wood/walnut,
/area/space)
"z" = (
/obj/structure/platform,
/obj/effect/floor_decal/carpet,
/turf/simulated/floor/exoplanet/wood/walnut,
/area/space)
"A" = (
/turf/simulated/floor/exoplanet/grass/moghes/dirt{
	icon_state = "corner"
	},
/area/space)
"E" = (
/turf/simulated/floor/exoplanet/water/shallow/moghes,
/area/space)
"F" = (
/obj/structure/unathi_pillar,
/turf/simulated/floor/exoplanet/grass/moghes/dirt{
	icon_state = "edge";
	dir = 5
	},
/area/space)
"J" = (
/obj/item/stack/material/sandstone,
/obj/effect/decal/cleanable/floor_damage/tiled_broken3,
/obj/effect/decal/cleanable/floor_damage/tiled_broken2,
/turf/simulated/floor/exoplanet/grass/moghes,
/area/space)
"K" = (
/obj/structure/platform,
/obj/effect/floor_decal/carpet{
	dir = 6
	},
/turf/simulated/floor/exoplanet/wood/walnut,
/area/space)
"L" = (
/obj/structure/platform_stairs{
	dir = 8
	},
/turf/simulated/floor/exoplanet/wood/walnut,
/area/space)
"M" = (
/obj/structure/table/wood/walnut,
/turf/simulated/floor/exoplanet/wood/walnut,
/area/space)
"O" = (
/turf/simulated/floor/exoplanet/grass/moghes/dirt{
	icon_state = "edge";
	dir = 5
	},
/area/space)
"P" = (
/obj/structure/platform_deco{
	dir = 8
	},
/turf/simulated/floor/exoplanet/wood/walnut,
/area/space)
"R" = (
/obj/effect/floor_decal/carpet{
	dir = 8
	},
/turf/simulated/floor/exoplanet/wood/walnut,
/area/space)
"S" = (
/turf/simulated/wall/sandstone,
/area/space)
"T" = (
/turf/simulated/floor/exoplanet/grass/moghes/dirt{
	icon_state = "edge";
	dir = 9
	},
/area/space)
"U" = (
/obj/item/stack/material/sandstone,
/obj/effect/decal/cleanable/floor_damage/tiled_broken1,
/turf/simulated/floor/exoplanet/grass/moghes/dirt,
/area/space)
"V" = (
/obj/structure/flora/grass/junglegrass/random,
/obj/structure/flora/tree/jungle/random,
/turf/simulated/floor/exoplanet/grass/moghes,
/area/space)
"W" = (
/turf/simulated/floor/exoplanet/grass/moghes/dirt{
	icon_state = "edge";
	dir = 6
	},
/area/space)
"Y" = (
/obj/structure/bed/stool/chair/sofa/pew/right{
	dir = 1
	},
/turf/simulated/floor/exoplanet/wood/walnut,
/area/space)

(1,1,1) = {"
d
d
d
d
d
d
d
d
d
d
d
d
d
d
d
d
d
d
d
d
d
d
d
d
d
d
d
d
d
d
d
d
"}
(2,1,1) = {"
d
d
d
d
d
d
d
d
i
d
d
d
d
d
i
b
d
d
d
d
d
d
d
d
d
d
E
d
d
d
d
d
"}
(3,1,1) = {"
d
d
d
d
d
d
d
d
d
d
d
d
d
d
d
d
d
d
d
d
d
d
d
d
d
d
E
d
d
i
d
d
"}
(4,1,1) = {"
d
d
d
d
d
d
d
d
d
d
d
d
i
d
d
d
d
d
d
d
i
d
d
d
d
E
E
E
d
d
d
d
"}
(5,1,1) = {"
d
d
d
d
b
d
d
d
d
S
S
S
S
S
S
d
i
d
d
d
d
d
d
d
d
E
E
E
E
d
d
d
"}
(6,1,1) = {"
d
d
d
i
d
d
d
d
d
S
y
y
y
y
S
d
d
d
d
d
d
d
d
d
d
d
E
E
E
E
d
i
"}
(7,1,1) = {"
d
d
d
d
d
d
d
d
d
S
y
y
y
y
S
d
d
d
i
d
d
d
d
d
d
d
d
d
d
E
d
d
"}
(8,1,1) = {"
d
d
d
d
d
d
i
d
d
S
y
y
y
y
S
d
d
d
d
d
d
d
d
d
d
i
b
d
d
d
d
d
"}
(9,1,1) = {"
d
d
d
d
d
d
d
d
d
S
y
y
y
y
S
d
d
d
d
d
d
d
d
i
d
d
d
d
d
d
d
i
"}
(10,1,1) = {"
d
d
d
d
S
S
S
S
S
S
n
S
S
S
S
S
S
S
d
d
d
d
i
d
d
d
d
d
d
d
d
d
"}
(11,1,1) = {"
d
d
d
d
S
y
y
y
y
y
y
y
y
y
y
y
y
S
d
d
d
d
d
d
d
d
d
d
d
d
d
d
"}
(12,1,1) = {"
d
S
S
S
S
y
y
y
u
y
u
y
u
y
u
y
y
S
d
d
b
d
d
d
d
d
d
d
d
d
d
d
"}
(13,1,1) = {"
d
S
y
y
y
y
y
y
w
y
w
y
w
y
w
y
y
S
v
a
a
c
s
A
a
F
d
i
d
d
d
d
"}
(14,1,1) = {"
d
S
L
L
k
P
y
y
Y
y
Y
y
Y
y
Y
y
y
S
a
a
a
a
a
a
a
a
d
d
d
i
d
d
"}
(15,1,1) = {"
i
S
y
y
M
K
e
e
e
e
e
e
e
e
e
e
e
S
a
a
a
a
a
a
a
a
d
d
d
d
d
d
"}
(16,1,1) = {"
d
S
y
y
M
z
m
m
m
m
m
m
m
m
m
m
m
n
a
a
a
a
a
a
a
a
W
a
a
s
d
d
"}
(17,1,1) = {"
d
S
y
y
M
z
m
m
m
m
m
m
m
m
m
m
m
n
a
a
a
a
a
a
a
a
j
q
a
t
d
d
"}
(18,1,1) = {"
d
S
y
y
M
l
R
R
R
R
R
R
R
R
R
R
R
S
a
a
a
a
a
a
a
T
d
d
d
d
d
d
"}
(19,1,1) = {"
d
S
x
x
o
f
y
y
u
y
u
y
u
y
u
y
y
S
a
a
a
a
a
a
a
s
d
d
b
d
d
d
"}
(20,1,1) = {"
d
S
y
y
y
y
y
y
w
y
w
y
w
y
w
y
y
S
a
a
a
U
O
j
q
c
d
d
d
d
d
d
"}
(21,1,1) = {"
d
S
S
S
S
y
y
y
Y
y
Y
y
Y
y
Y
y
y
S
d
d
J
d
d
d
d
d
d
i
d
d
d
d
"}
(22,1,1) = {"
d
d
d
d
S
y
y
y
y
y
y
y
y
y
y
y
y
S
d
d
d
d
d
d
d
d
d
d
d
d
i
d
"}
(23,1,1) = {"
d
d
i
d
S
S
S
S
S
S
n
S
S
S
S
S
S
S
d
i
d
d
d
d
d
d
d
d
d
d
d
d
"}
(24,1,1) = {"
d
d
d
d
d
d
d
d
d
S
y
y
y
y
S
d
d
d
d
d
d
d
d
d
d
d
d
d
d
d
d
d
"}
(25,1,1) = {"
d
d
d
d
d
d
d
d
d
S
y
y
y
y
S
d
d
d
d
d
d
d
i
d
i
d
d
d
d
d
d
d
"}
(26,1,1) = {"
d
d
d
d
d
i
d
d
d
S
y
y
y
g
g
d
d
d
d
d
d
d
d
b
d
d
d
d
d
d
d
d
"}
(27,1,1) = {"
d
d
d
d
d
d
d
i
d
S
h
M
y
y
d
g
d
d
d
d
i
d
d
d
d
d
d
i
d
d
d
d
"}
(28,1,1) = {"
d
d
d
d
d
d
d
b
d
S
S
S
S
S
S
d
d
d
d
d
d
d
d
d
d
d
d
d
d
d
d
d
"}
(29,1,1) = {"
d
i
d
d
d
d
d
d
d
d
d
d
d
d
d
d
d
i
d
d
d
d
d
d
d
d
d
d
d
d
d
d
"}
(30,1,1) = {"
d
d
d
d
d
d
i
d
d
d
d
d
d
d
d
d
d
d
d
d
d
d
d
d
d
d
d
d
i
d
d
d
"}
(31,1,1) = {"
d
d
d
d
d
d
d
d
d
d
i
d
d
d
d
V
d
d
d
d
d
d
d
d
d
d
d
d
d
d
d
d
"}
(32,1,1) = {"
d
d
d
d
d
d
d
d
d
d
d
d
d
d
d
d
d
d
d
d
d
d
d
d
d
d
d
d
d
d
d
d
"}
