//MAP CONVERTED BY dmm2tgm.py THIS HEADER COMMENT PREVENTS RECONVERSION, DO NOT REMOVE
"a" = (
/turf/simulated/floor/exoplanet/grass/moghes,
/area/exoplanet/moghes)
"b" = (
/turf/template_noop,
/area/exoplanet/moghes)
"c" = (
/obj/structure/flora/tree/jungle/small/random,
/turf/simulated/floor/exoplanet/grass/moghes,
/area/exoplanet/moghes)
"e" = (
/obj/structure/flora/grass/junglegrass/random,
/turf/simulated/floor/exoplanet/grass/moghes,
/area/exoplanet/moghes)
"K" = (
/mob/living/simple_animal/threshbeast,
/turf/simulated/floor/exoplanet/grass/moghes,
/area/exoplanet/moghes)
"W" = (
/obj/structure/flora/grass/junglegrass/random,
/mob/living/simple_animal/threshbeast,
/turf/simulated/floor/exoplanet/grass/moghes,
/area/exoplanet/moghes)

(1,1,1) = {"
b
b
b
a
a
a
a
a
b
b
b
b
b
b
b
b
"}
(2,1,1) = {"
b
b
a
a
a
a
a
a
a
a
a
b
b
b
b
b
"}
(3,1,1) = {"
b
b
a
a
a
a
c
a
e
a
a
a
a
b
b
b
"}
(4,1,1) = {"
b
a
a
a
e
e
a
a
a
K
a
a
a
a
a
b
"}
(5,1,1) = {"
b
a
a
K
a
e
W
a
a
a
a
a
c
a
a
b
"}
(6,1,1) = {"
b
a
e
a
a
a
a
e
e
a
a
a
a
a
a
b
"}
(7,1,1) = {"
b
a
a
a
a
a
a
a
e
e
e
a
a
a
a
b
"}
(8,1,1) = {"
b
b
a
a
a
a
a
a
K
a
a
a
a
a
b
b
"}
(9,1,1) = {"
b
b
K
a
a
K
a
a
a
a
a
a
a
a
b
b
"}
(10,1,1) = {"
b
b
a
a
e
a
a
a
a
a
a
W
e
a
b
b
"}
(11,1,1) = {"
b
a
c
a
a
a
a
a
a
e
e
a
a
a
b
b
"}
(12,1,1) = {"
b
a
a
a
a
a
a
e
e
e
K
a
a
a
a
b
"}
(13,1,1) = {"
b
a
a
a
K
a
K
e
a
a
a
a
a
a
a
b
"}
(14,1,1) = {"
b
a
a
a
a
a
a
a
a
a
a
a
a
a
b
b
"}
(15,1,1) = {"
b
b
a
a
a
a
a
a
a
c
a
a
a
b
b
b
"}
(16,1,1) = {"
b
b
b
b
b
a
a
a
a
a
a
a
b
b
b
b
"}
