//MAP CONVERTED BY dmm2tgm.py THIS HEADER COMMENT PREVENTS RECONVERSION, DO NOT REMOVE
"a" = (
/turf/simulated/floor/exoplanet/grass/moghes,
/area/exoplanet/moghes)
"b" = (
/obj/structure/flora/grass/junglegrass/random,
/turf/simulated/floor/exoplanet/grass/moghes,
/area/exoplanet/moghes)
"x" = (
/mob/living/simple_animal/otzek,
/turf/simulated/floor/exoplanet/grass/moghes,
/area/exoplanet/moghes)
"A" = (
/turf/template_noop,
/area/exoplanet/moghes)
"X" = (
/obj/structure/flora/grass/junglegrass/random,
/mob/living/simple_animal/otzek,
/turf/simulated/floor/exoplanet/grass/moghes,
/area/exoplanet/moghes)

(1,1,1) = {"
A
A
A
A
a
a
A
A
A
a
a
a
a
A
A
A
"}
(2,1,1) = {"
A
A
b
a
a
a
a
a
a
a
b
a
a
a
A
A
"}
(3,1,1) = {"
A
A
a
a
a
a
x
a
a
a
a
a
a
a
A
A
"}
(4,1,1) = {"
A
a
a
a
a
a
b
a
a
a
x
a
b
a
a
A
"}
(5,1,1) = {"
A
a
a
a
x
a
a
a
a
a
a
a
b
x
a
A
"}
(6,1,1) = {"
A
a
b
a
a
a
a
a
a
a
a
a
a
a
a
A
"}
(7,1,1) = {"
A
a
X
a
a
a
a
a
a
a
a
a
a
b
a
A
"}
(8,1,1) = {"
A
a
a
a
a
x
a
a
a
a
a
a
a
a
a
A
"}
(9,1,1) = {"
A
b
a
a
b
a
a
a
x
a
b
a
a
a
a
A
"}
(10,1,1) = {"
A
a
a
a
a
a
a
a
a
a
a
a
x
a
a
A
"}
(11,1,1) = {"
A
a
a
a
a
a
a
a
b
a
a
a
a
a
a
A
"}
(12,1,1) = {"
A
a
a
x
a
a
a
a
a
a
a
a
a
a
b
A
"}
(13,1,1) = {"
A
a
b
a
a
b
a
x
a
a
a
a
a
a
b
A
"}
(14,1,1) = {"
A
A
b
a
a
a
a
a
a
a
a
a
a
a
A
A
"}
(15,1,1) = {"
A
A
A
a
a
a
a
a
a
a
a
a
A
A
A
A
"}
(16,1,1) = {"
A
A
A
A
A
A
A
A
A
A
A
A
A
A
A
A
"}
