//MAP CONVERTED BY dmm2tgm.py THIS HEADER COMMENT PREVENTS RECONVERSION, DO NOT REMOVE
"a" = (
/turf/simulated/floor/exoplanet/desert{
	temperature = 315.15
	},
/area/moghes/kataphract_wasteland)
"b" = (
/obj/structure/bonfire/light_up,
/turf/simulated/floor/exoplanet/desert{
	temperature = 315.15
	},
/area/moghes/kataphract_wasteland)
"c" = (
/obj/structure/railing/fence{
	dir = 1
	},
/turf/simulated/floor/exoplanet/desert{
	temperature = 315.15
	},
/area/moghes/kataphract_wasteland)
"d" = (
/obj/structure/closet/crate/freezer,
/obj/item/storage/box/fancy/mre/menu10,
/obj/item/storage/box/fancy/mre/menu10,
/obj/item/storage/box/fancy/mre/menu10,
/obj/item/storage/box/fancy/mre/menu10,
/obj/item/storage/box/fancy/mre/menu10,
/obj/item/reagent_containers/food/drinks/waterbottle,
/obj/item/reagent_containers/food/drinks/waterbottle,
/obj/item/reagent_containers/food/drinks/waterbottle,
/obj/item/reagent_containers/food/drinks/waterbottle,
/obj/item/reagent_containers/food/drinks/waterbottle,
/obj/item/reagent_containers/food/drinks/waterbottle,
/obj/item/reagent_containers/food/drinks/waterbottle,
/obj/item/reagent_containers/food/drinks/waterbottle,
/obj/item/reagent_containers/food/drinks/waterbottle,
/turf/simulated/floor/exoplanet/carpet/orange,
/area/moghes/kataphract_wasteland/tent)
"e" = (
/obj/effect/floor_decal/spline/plain/blue,
/obj/random/dirt_75,
/turf/simulated/floor/exoplanet/carpet/lightblue,
/area/moghes/kataphract_wasteland/tent)
"g" = (
/obj/random/dirt_75,
/obj/effect/decal/cleanable/generic,
/turf/simulated/floor/exoplanet/carpet/orange,
/area/moghes/kataphract_wasteland/tent)
"h" = (
/turf/simulated/wall/rusty,
/area/moghes/kataphract_wasteland)
"j" = (
/obj/structure/closet/crate/medical,
/obj/item/storage/firstaid/radiation,
/obj/item/storage/firstaid/radiation,
/obj/item/storage/firstaid/combat,
/obj/item/storage/firstaid/combat,
/obj/item/stack/medical/bruise_pack/full,
/obj/item/stack/medical/bruise_pack/full,
/obj/item/stack/medical/ointment/full,
/obj/item/stack/medical/ointment/full,
/obj/item/clothing/accessory/stethoscope,
/obj/item/reagent_containers/pill/thetamycin,
/obj/item/reagent_containers/pill/thetamycin,
/obj/item/reagent_containers/pill/thetamycin,
/turf/simulated/floor/exoplanet/carpet/orange,
/area/moghes/kataphract_wasteland/tent)
"k" = (
/obj/effect/decal/cleanable/cobweb,
/turf/simulated/floor/exoplanet/desert{
	temperature = 315.15
	},
/area/moghes/kataphract_wasteland)
"l" = (
/obj/item/bedsheet/orange,
/obj/effect/ghostspawpoint{
	name = "igs - moghes_kataphract_wasteland";
	identifier = "moghes_kataphract_wasteland"
	},
/obj/structure/sign/flag/hegemony/large/west{
	pixel_x = -32
	},
/turf/simulated/floor/exoplanet/carpet/orange,
/area/moghes/kataphract_wasteland/tent)
"n" = (
/obj/item/device/flashlight/lamp/box,
/turf/simulated/floor/exoplanet/carpet/lightblue,
/area/moghes/kataphract_wasteland/tent)
"o" = (
/obj/structure/closet/crate,
/obj/item/saddle,
/obj/item/clothing/suit/armor/unathi/hegemony,
/obj/item/clothing/head/helmet/unathi/hegemony,
/obj/item/device/radio,
/obj/item/device/geiger,
/obj/item/device/gps,
/obj/item/gun/energy/pistol/hegemony,
/turf/simulated/floor/exoplanet/carpet/orange,
/area/moghes/kataphract_wasteland/tent)
"p" = (
/obj/structure/bed/stool/wood,
/turf/simulated/floor/exoplanet/desert{
	temperature = 315.15
	},
/area/moghes/kataphract_wasteland)
"q" = (
/turf/simulated/floor/exoplanet/tiled{
	temperature = 315.15
	},
/area/moghes/kataphract_wasteland)
"r" = (
/turf/simulated/floor/exoplanet/carpet/lightblue,
/area/moghes/kataphract_wasteland/tent)
"s" = (
/obj/structure/closet/crate,
/obj/item/clothing/accessory/poncho/red,
/obj/item/clothing/shoes/sandals/caligae,
/turf/simulated/floor/exoplanet/carpet/orange,
/area/moghes/kataphract_wasteland/tent)
"t" = (
/obj/structure/railing/fence,
/mob/living/simple_animal/hostile/retaliate/hegeranzi,
/turf/simulated/floor/exoplanet/desert{
	temperature = 315.15
	},
/area/moghes/kataphract_wasteland)
"u" = (
/obj/structure/railing/fence,
/obj/structure/sink/puddle,
/turf/simulated/floor/exoplanet/desert{
	temperature = 315.15
	},
/area/moghes/kataphract_wasteland)
"v" = (
/obj/structure/reagent_dispensers/watertank,
/turf/simulated/floor/exoplanet/carpet/lightblue,
/area/moghes/kataphract_wasteland/tent)
"w" = (
/obj/structure/curtain/open,
/obj/random/dirt_75,
/turf/simulated/floor/exoplanet/carpet/orange,
/area/moghes/kataphract_wasteland/tent)
"x" = (
/mob/living/simple_animal/hostile/retaliate/hegeranzi,
/turf/simulated/floor/exoplanet/desert{
	temperature = 315.15
	},
/area/moghes/kataphract_wasteland)
"y" = (
/obj/effect/floor_decal/spline/plain/blue{
	dir = 8
	},
/turf/simulated/floor/exoplanet/carpet/lightblue,
/area/moghes/kataphract_wasteland/tent)
"z" = (
/obj/structure/railing/fence{
	dir = 8
	},
/turf/simulated/floor/exoplanet/desert{
	temperature = 315.15
	},
/area/moghes/kataphract_wasteland)
"A" = (
/obj/structure/railing/fence,
/obj/structure/railing/fence{
	dir = 8
	},
/turf/simulated/floor/exoplanet/desert{
	temperature = 315.15
	},
/area/moghes/kataphract_wasteland)
"D" = (
/obj/random/dirt_75,
/turf/simulated/floor/exoplanet/carpet/orange,
/area/moghes/kataphract_wasteland/tent)
"E" = (
/obj/machinery/door/urban{
	dir = 4;
	pixel_x = -3
	},
/turf/simulated/floor/exoplanet/desert{
	temperature = 315.15
	},
/area/moghes/kataphract_wasteland)
"F" = (
/obj/effect/floor_decal/spline/plain/blue{
	dir = 10
	},
/turf/simulated/floor/exoplanet/carpet/lightblue,
/area/moghes/kataphract_wasteland/tent)
"G" = (
/obj/structure/railing/fence,
/obj/structure/railing/fence{
	dir = 4
	},
/turf/simulated/floor/exoplanet/desert{
	temperature = 315.15
	},
/area/moghes/kataphract_wasteland)
"H" = (
/turf/simulated/floor/exoplanet/carpet/orange,
/area/moghes/kataphract_wasteland/tent)
"I" = (
/obj/structure/railing/fence{
	dir = 1
	},
/obj/structure/railing/fence{
	dir = 8
	},
/turf/simulated/floor/exoplanet/desert{
	temperature = 315.15
	},
/area/moghes/kataphract_wasteland)
"J" = (
/obj/random/dirt_75,
/turf/simulated/floor/exoplanet/tiled{
	temperature = 315.15
	},
/area/moghes/kataphract_wasteland)
"K" = (
/obj/structure/railing/fence{
	dir = 4
	},
/turf/simulated/floor/exoplanet/desert{
	temperature = 315.15
	},
/area/moghes/kataphract_wasteland)
"L" = (
/obj/structure/railing/fence,
/turf/simulated/floor/exoplanet/desert{
	temperature = 315.15
	},
/area/moghes/kataphract_wasteland)
"M" = (
/obj/item/bedsheet/red,
/obj/effect/ghostspawpoint{
	name = "igs - moghes_kataphract_wasteland_knight";
	identifier = "moghes_kataphract_wasteland_knight"
	},
/turf/simulated/floor/exoplanet/carpet/lightblue,
/area/moghes/kataphract_wasteland/tent)
"N" = (
/obj/random/dirt_75,
/obj/item/device/flashlight/lamp/box,
/turf/simulated/floor/exoplanet/carpet/orange,
/area/moghes/kataphract_wasteland/tent)
"O" = (
/obj/random/dirt_75,
/obj/item/device/flashlight/lantern,
/turf/simulated/floor/exoplanet/carpet/orange,
/area/moghes/kataphract_wasteland/tent)
"Q" = (
/obj/structure/railing/fence{
	dir = 4
	},
/obj/structure/railing/fence{
	dir = 1
	},
/turf/simulated/floor/exoplanet/desert{
	temperature = 315.15
	},
/area/moghes/kataphract_wasteland)
"R" = (
/turf/simulated/wall/cloth,
/area/moghes/kataphract_wasteland/tent)
"S" = (
/obj/structure/sign/flag/hegemony/large/north{
	pixel_y = 32
	},
/turf/simulated/floor/exoplanet/desert{
	temperature = 315.15
	},
/area/moghes/kataphract_wasteland)
"T" = (
/obj/effect/floor_decal/spline/plain/blue,
/turf/simulated/floor/exoplanet/carpet/lightblue,
/area/moghes/kataphract_wasteland/tent)
"V" = (
/obj/item/bedsheet/orange,
/obj/effect/ghostspawpoint{
	name = "igs - moghes_kataphract_wasteland";
	identifier = "moghes_kataphract_wasteland"
	},
/turf/simulated/floor/exoplanet/carpet/orange,
/area/moghes/kataphract_wasteland/tent)
"W" = (
/obj/item/device/flashlight/lantern,
/turf/simulated/floor/exoplanet/carpet/orange,
/area/moghes/kataphract_wasteland/tent)
"X" = (
/obj/structure/closet/crate,
/obj/item/clothing/accessory/poncho,
/obj/item/clothing/accessory/poncho,
/obj/item/clothing/accessory/poncho,
/obj/item/clothing/suit/armor/unathi/hegemony,
/obj/item/clothing/suit/armor/unathi/hegemony,
/obj/item/clothing/suit/armor/unathi/hegemony,
/obj/item/clothing/head/helmet/unathi/hegemony,
/obj/item/clothing/head/helmet/unathi/hegemony,
/obj/item/clothing/head/helmet/unathi/hegemony,
/obj/item/device/radio,
/obj/item/device/radio,
/obj/item/device/radio,
/obj/item/device/geiger,
/obj/item/device/geiger,
/obj/item/device/geiger,
/obj/item/device/gps,
/obj/item/gun/energy/pistol/hegemony,
/obj/item/gun/energy/pistol/hegemony,
/obj/item/gun/energy/pistol/hegemony,
/turf/simulated/floor/exoplanet/carpet/orange,
/area/moghes/kataphract_wasteland/tent)
"Z" = (
/obj/effect/floor_decal/spline/plain/blue{
	dir = 8
	},
/obj/random/dirt_75,
/turf/simulated/floor/exoplanet/carpet/lightblue,
/area/moghes/kataphract_wasteland/tent)

(1,1,1) = {"
a
a
a
a
a
a
a
a
a
a
a
a
a
a
a
a
a
a
a
a
a
a
a
a
a
a
a
a
a
a
"}
(2,1,1) = {"
a
a
a
a
a
a
a
a
a
a
a
a
a
a
a
a
a
a
a
a
a
a
a
a
a
a
a
a
a
a
"}
(3,1,1) = {"
a
a
a
a
a
a
a
a
a
a
a
a
a
a
a
a
a
a
a
a
a
a
a
a
a
a
a
a
a
a
"}
(4,1,1) = {"
a
a
a
a
a
a
a
a
a
a
a
a
a
a
a
a
a
a
a
a
a
a
a
a
a
a
a
a
a
a
"}
(5,1,1) = {"
a
a
a
a
a
a
a
a
h
h
h
h
h
a
a
a
a
a
a
a
a
a
a
a
a
a
a
a
a
a
"}
(6,1,1) = {"
a
a
a
a
a
a
h
h
a
a
I
z
z
z
A
a
a
a
a
a
a
a
a
a
a
a
a
a
a
a
"}
(7,1,1) = {"
a
a
a
a
a
a
h
k
a
a
c
x
a
a
L
a
a
a
a
J
a
a
a
a
a
a
a
a
a
a
"}
(8,1,1) = {"
a
h
h
h
h
a
a
a
a
a
c
a
a
x
L
a
a
a
a
a
a
a
a
h
a
a
a
a
a
a
"}
(9,1,1) = {"
a
a
a
a
a
a
a
a
a
a
c
a
a
a
u
J
a
a
a
a
a
J
a
a
a
a
a
a
a
a
"}
(10,1,1) = {"
a
a
a
a
a
a
a
a
a
a
c
a
x
a
t
a
a
a
a
a
a
a
J
J
a
a
a
a
a
a
"}
(11,1,1) = {"
a
a
a
a
a
a
J
J
a
a
Q
K
E
K
G
a
a
a
a
a
a
a
a
a
h
a
a
a
a
a
"}
(12,1,1) = {"
a
a
J
a
a
a
a
a
a
a
a
a
a
a
a
a
a
a
a
a
a
a
a
a
a
a
a
a
a
a
"}
(13,1,1) = {"
a
a
a
a
R
R
R
R
R
a
a
a
a
a
a
a
R
R
R
R
R
a
a
a
a
a
a
a
a
a
"}
(14,1,1) = {"
a
a
a
R
R
s
o
d
R
R
S
a
a
a
a
R
R
V
l
V
R
R
a
a
a
a
a
a
a
a
"}
(15,1,1) = {"
a
a
a
R
y
Z
F
H
H
R
a
a
p
a
a
R
O
H
H
H
X
R
a
a
a
a
a
h
a
a
"}
(16,1,1) = {"
a
a
a
R
M
r
e
D
D
w
a
p
b
p
a
w
g
D
N
D
j
R
a
a
a
a
a
h
a
a
"}
(17,1,1) = {"
a
a
a
R
r
n
T
H
W
R
a
a
p
a
a
R
D
D
D
D
H
R
a
a
a
a
a
h
a
a
"}
(18,1,1) = {"
a
a
a
R
R
v
T
H
R
R
a
a
a
a
a
R
R
H
H
g
R
R
a
a
a
a
a
a
a
a
"}
(19,1,1) = {"
a
a
a
a
R
R
R
R
R
a
a
a
a
a
a
a
R
R
R
R
R
a
a
a
a
a
h
a
a
a
"}
(20,1,1) = {"
a
a
a
a
a
a
a
a
a
a
a
a
a
a
a
a
a
a
a
J
a
a
a
a
J
a
h
a
a
a
"}
(21,1,1) = {"
a
a
a
a
a
a
a
a
a
J
q
J
a
a
a
a
a
a
a
a
a
a
J
a
J
a
a
a
a
a
"}
(22,1,1) = {"
a
a
a
a
a
a
a
a
a
q
J
J
a
a
a
a
a
a
a
a
a
a
a
a
a
a
a
a
a
a
"}
(23,1,1) = {"
a
a
a
a
a
a
a
a
a
a
a
a
a
a
a
a
a
a
a
a
a
h
h
a
a
a
a
a
a
a
"}
(24,1,1) = {"
a
a
a
a
h
h
h
h
h
h
h
h
a
a
a
a
a
a
a
a
a
h
h
a
a
a
a
a
a
a
"}
(25,1,1) = {"
a
a
a
a
a
a
a
a
a
a
a
a
a
a
a
a
a
a
a
a
a
a
a
a
a
a
a
a
a
a
"}
(26,1,1) = {"
a
a
a
a
a
a
a
a
a
a
a
a
a
a
a
a
a
a
a
a
a
a
a
a
a
a
a
a
a
a
"}
(27,1,1) = {"
a
a
a
a
a
a
a
a
a
a
a
a
a
a
a
a
a
a
a
a
a
a
a
a
a
a
a
a
a
a
"}
(28,1,1) = {"
a
a
a
a
a
a
a
a
a
a
a
a
a
a
a
a
a
a
a
a
a
a
a
a
a
a
a
a
a
a
"}
(29,1,1) = {"
a
a
a
a
a
a
a
a
a
a
a
a
a
a
a
a
a
a
a
a
a
a
a
a
a
a
a
a
a
a
"}
(30,1,1) = {"
a
a
a
a
a
a
a
a
a
a
a
a
a
a
a
a
a
a
a
a
a
a
a
a
a
a
a
a
a
a
"}
