//MAP CONVERTED BY dmm2tgm.py THIS HEADER COMMENT PREVENTS RECONVERSION, DO NOT REMOVE
"aO" = (
/obj/machinery/door/airlock/medical{
	name = "Botany - Secure"
	},
/turf/simulated/floor/exoplanet/tiled/white,
/area/moghes_klax)
"cR" = (
/obj/machinery/light{
	dir = 1
	},
/turf/simulated/floor/exoplanet/desert{
	temperature = 315.15
	},
/area/moghes_klax)
"ea" = (
/obj/machinery/light,
/turf/simulated/floor/exoplanet/tiled/white,
/area/moghes_klax)
"ep" = (
/obj/machinery/vending/hydroseeds,
/obj/machinery/light{
	dir = 8
	},
/turf/simulated/floor/exoplanet/tiled/white,
/area/moghes_klax)
"eA" = (
/obj/structure/table/rack,
/obj/item/gun/energy/vaurca/blaster,
/obj/item/gun/energy/vaurca/blaster,
/obj/item/clothing/accessory/holster/hip,
/obj/item/clothing/accessory/holster/hip,
/turf/simulated/floor/exoplanet/tiled,
/area/moghes_klax)
"eH" = (
/obj/structure/window/reinforced{
	dir = 1
	},
/obj/structure/window/reinforced{
	dir = 4
	},
/turf/simulated/floor/exoplanet/tiled/white,
/area/moghes_klax)
"fh" = (
/obj/structure/table/rack,
/obj/item/gun/energy/net,
/obj/item/gun/energy/net,
/turf/simulated/floor/exoplanet/tiled,
/area/moghes_klax)
"fl" = (
/obj/machinery/portable_atmospherics/hydroponics,
/turf/simulated/floor/exoplanet/tiled/white,
/area/moghes_klax)
"fm" = (
/obj/machinery/clonepod{
	name = "Bio-Stasis Unit"
	},
/turf/simulated/floor/exoplanet/tiled/white,
/area/moghes_klax)
"fw" = (
/obj/structure/closet/crate/hydroponics,
/turf/simulated/floor/exoplanet/tiled/white,
/area/moghes_klax)
"fz" = (
/obj/structure/sink{
	dir = 8;
	pixel_x = -15
	},
/obj/item/reagent_containers/glass/bucket,
/obj/item/reagent_containers/glass/bucket,
/turf/simulated/floor/exoplanet/tiled/white,
/area/moghes_klax)
"fL" = (
/obj/machinery/door/airlock/medical{
	name = "Bioscience";
	dir = 4
	},
/turf/simulated/floor/exoplanet/tiled/white,
/area/moghes_klax)
"ib" = (
/obj/structure/window/reinforced{
	dir = 1
	},
/turf/simulated/floor/exoplanet/tiled/white,
/area/moghes_klax)
"iD" = (
/obj/machinery/bodyscanner{
	dir = 8
	},
/turf/simulated/floor/exoplanet/tiled/white,
/area/moghes_klax)
"mn" = (
/turf/simulated/floor/exoplanet/tiled/white,
/area/moghes_klax)
"ox" = (
/obj/structure/table/rack,
/obj/item/melee/energy/vaurca_zweihander,
/obj/item/melee/energy/vaurca,
/obj/item/melee/energy/vaurca,
/obj/machinery/light,
/turf/simulated/floor/exoplanet/tiled,
/area/moghes_klax)
"oO" = (
/obj/machinery/door/window{
	dir = 4;
	name = "Live Specimen Containment"
	},
/turf/simulated/floor/exoplanet/tiled/white,
/area/moghes_klax)
"py" = (
/obj/structure/table/rack,
/obj/item/gun/energy/rifle/hegemony,
/obj/item/gun/energy/rifle/hegemony,
/obj/item/gun/energy/rifle/hegemony,
/turf/simulated/floor/exoplanet/tiled,
/area/moghes_klax)
"qx" = (
/obj/machinery/door/airlock{
	name = "Habitation";
	dir = 4
	},
/turf/simulated/floor/exoplanet/tiled,
/area/moghes_klax)
"ss" = (
/obj/structure/closet/crate/large{
	name = "Biological Subjects"
	},
/obj/item/storage/box/monkeycubes/vkrexicubes,
/obj/item/storage/box/monkeycubes/vkrexicubes,
/turf/simulated/floor/exoplanet/tiled/white,
/area/moghes_klax)
"tf" = (
/obj/structure/closet/crate,
/obj/item/vaurca/box,
/turf/simulated/floor/exoplanet/tiled,
/area/moghes_klax)
"vd" = (
/obj/machinery/light{
	dir = 4
	},
/turf/simulated/floor/exoplanet/tiled,
/area/moghes_klax)
"vq" = (
/obj/item/storage/box/freezer/organcooler,
/obj/structure/closet/crate/freezer,
/turf/simulated/floor/exoplanet/tiled/white,
/area/moghes_klax)
"wN" = (
/obj/machinery/portable_atmospherics/hydroponics,
/obj/machinery/light{
	dir = 8
	},
/turf/simulated/floor/exoplanet/tiled/white,
/area/moghes_klax)
"wV" = (
/obj/machinery/portable_atmospherics/hydroponics,
/obj/machinery/light{
	dir = 4
	},
/turf/simulated/floor/exoplanet/tiled/white,
/area/moghes_klax)
"wX" = (
/obj/structure/table/rack,
/obj/machinery/recharger/wallcharger{
	pixel_y = 25;
	pixel_x = 5
	},
/obj/item/device/healthanalyzer,
/obj/item/device/healthanalyzer,
/turf/simulated/floor/exoplanet/tiled,
/area/moghes_klax)
"xv" = (
/obj/machinery/door/airlock/highsecurity{
	name = "SECURE RESEARCH AREA - DO NOT ENTER"
	},
/turf/simulated/floor/exoplanet/tiled,
/area/moghes_klax)
"xI" = (
/obj/structure/plasticflaps/airtight,
/turf/simulated/floor/exoplanet/tiled,
/area/moghes_klax)
"xK" = (
/obj/structure/table/steel,
/obj/item/storage/box/fancy/tray,
/obj/item/clothing/gloves/latex/nitrile/vaurca,
/obj/item/clothing/gloves/latex/nitrile/vaurca,
/obj/item/stack/nanopaste,
/obj/item/stack/nanopaste,
/turf/simulated/floor/exoplanet/tiled/white,
/area/moghes_klax)
"xY" = (
/obj/structure/table/rack,
/obj/item/clothing/glasses/sunglasses/blinders,
/obj/item/clothing/glasses/sunglasses/blinders,
/obj/item/clothing/glasses/sunglasses/blinders,
/obj/item/clothing/glasses/sunglasses/blinders,
/turf/simulated/floor/exoplanet/tiled,
/area/moghes_klax)
"AQ" = (
/obj/structure/closet/crate/medical,
/obj/item/reagent_containers/inhaler/phoron_special,
/obj/item/reagent_containers/inhaler/phoron_special,
/obj/item/reagent_containers/inhaler/phoron_special,
/obj/item/storage/firstaid/radiation,
/obj/item/storage/firstaid/adv,
/obj/item/storage/firstaid/adv,
/turf/simulated/floor/exoplanet/tiled/white,
/area/moghes_klax)
"BA" = (
/obj/structure/table/rack,
/obj/item/device/analyzer/plant_analyzer,
/obj/item/device/analyzer/plant_analyzer,
/turf/simulated/floor/exoplanet/tiled,
/area/moghes_klax)
"BX" = (
/obj/effect/ghostspawpoint{
	name = "igs - moghes_wasteland_klax";
	identifier = "moghes_wasteland_klax"
	},
/turf/simulated/floor/exoplanet/tiled,
/area/moghes_klax)
"CZ" = (
/obj/machinery/hologram/holopad/long_range,
/turf/simulated/floor/exoplanet/tiled,
/area/moghes_klax)
"Dh" = (
/obj/structure/table/rack,
/obj/item/clothing/suit/storage/toggle/labcoat,
/obj/item/clothing/suit/storage/toggle/labcoat,
/obj/item/clothing/suit/storage/toggle/labcoat,
/obj/item/clothing/suit/storage/toggle/labcoat,
/turf/simulated/floor/exoplanet/tiled,
/area/moghes_klax)
"Et" = (
/obj/structure/reagent_dispensers/watertank,
/turf/simulated/floor/exoplanet/tiled,
/area/moghes_klax)
"Fe" = (
/obj/structure/closet/crate,
/obj/item/reagent_containers/food/drinks/waterbottle,
/obj/item/reagent_containers/food/drinks/waterbottle,
/obj/item/reagent_containers/food/drinks/waterbottle,
/obj/item/reagent_containers/food/drinks/waterbottle,
/obj/item/reagent_containers/food/drinks/waterbottle,
/turf/simulated/floor/exoplanet/tiled,
/area/moghes_klax)
"Gi" = (
/obj/structure/closet/crate,
/obj/item/clothing/under/vaurca/gearharness/black,
/obj/item/clothing/under/vaurca/gearharness/black,
/obj/item/clothing/under/vaurca/gearharness/black,
/obj/item/clothing/shoes/vaurca,
/obj/item/clothing/shoes/vaurca,
/obj/item/clothing/shoes/vaurca,
/obj/item/clothing/shoes/vaurca,
/obj/item/clothing/suit/vaurca/brown,
/obj/item/clothing/suit/vaurca/brown,
/obj/item/clothing/suit/vaurca/brown,
/obj/item/clothing/suit/vaurca/brown,
/obj/item/clothing/under/vaurca,
/obj/item/clothing/under/vaurca,
/obj/item/clothing/under/vaurca,
/obj/item/clothing/under/vaurca,
/obj/item/clothing/mask/gas/vaurca/filter,
/obj/item/clothing/mask/gas/vaurca/filter,
/obj/item/clothing/mask/gas/vaurca/filter,
/turf/simulated/floor/exoplanet/tiled,
/area/moghes_klax)
"GJ" = (
/obj/structure/closet/crate,
/obj/item/reagent_containers/food/snacks/koisbar_clean,
/obj/item/reagent_containers/food/snacks/koisbar_clean,
/obj/item/reagent_containers/food/snacks/koisbar_clean,
/obj/item/reagent_containers/food/snacks/koisbar_clean,
/obj/item/reagent_containers/food/snacks/koisbar_clean,
/obj/item/reagent_containers/food/snacks/koisbar_clean,
/obj/machinery/light{
	dir = 1
	},
/turf/simulated/floor/exoplanet/tiled,
/area/moghes_klax)
"Hu" = (
/obj/effect/ghostspawpoint{
	name = "igs - moghes_wasteland_klax";
	identifier = "moghes_wasteland_klax"
	},
/obj/machinery/light{
	dir = 4
	},
/turf/simulated/floor/exoplanet/tiled,
/area/moghes_klax)
"Iu" = (
/obj/machinery/portable_atmospherics/hydroponics,
/obj/machinery/light{
	dir = 1
	},
/turf/simulated/floor/exoplanet/tiled/white,
/area/moghes_klax)
"IK" = (
/obj/machinery/optable,
/turf/simulated/floor/exoplanet/tiled/white,
/area/moghes_klax)
"JO" = (
/obj/structure/closet/crate/large{
	name = "Biological Subjects"
	},
/obj/item/storage/box/monkeycubes/stokcubes,
/obj/item/storage/box/monkeycubes/stokcubes,
/turf/simulated/floor/exoplanet/tiled/white,
/area/moghes_klax)
"Kx" = (
/obj/structure/plasticflaps/airtight,
/turf/simulated/floor/exoplanet/tiled/white,
/area/moghes_klax)
"LL" = (
/obj/structure/sink{
	dir = 1;
	pixel_y = 20
	},
/obj/machinery/light{
	dir = 1
	},
/turf/simulated/floor/exoplanet/tiled/white,
/area/moghes_klax)
"MO" = (
/obj/structure/table/rack,
/obj/machinery/recharger/wallcharger{
	pixel_y = 25;
	pixel_x = 5
	},
/obj/item/device/mass_spectrometer/adv,
/obj/item/device/mass_spectrometer/adv,
/turf/simulated/floor/exoplanet/tiled,
/area/moghes_klax)
"Oa" = (
/obj/structure/closet/crate/hydroponics,
/obj/machinery/light{
	dir = 4
	},
/turf/simulated/floor/exoplanet/tiled/white,
/area/moghes_klax)
"Ob" = (
/turf/simulated/floor/exoplanet/tiled,
/area/moghes_klax)
"On" = (
/obj/structure/table/rack,
/obj/item/clothing/suit/space/void/scout,
/obj/item/clothing/suit/space/void/scout,
/obj/item/clothing/head/helmet/space/void/scout,
/obj/item/clothing/head/helmet/space/void/scout,
/turf/simulated/floor/exoplanet/tiled,
/area/moghes_klax)
"Pb" = (
/obj/structure/closet/crate/hydroponics,
/obj/item/clothing/gloves/botanic_leather/vaurca,
/obj/item/clothing/gloves/botanic_leather/vaurca,
/obj/item/material/hatchet,
/obj/item/material/hatchet,
/obj/item/wirecutters/clippers,
/obj/item/wirecutters/clippers,
/obj/item/material/minihoe,
/obj/item/material/minihoe,
/turf/simulated/floor/exoplanet/tiled/white,
/area/moghes_klax)
"Pf" = (
/obj/structure/table/rack,
/obj/item/storage/toolbox/mechanical,
/turf/simulated/floor/exoplanet/tiled,
/area/moghes_klax)
"Pt" = (
/obj/structure/closet/crate,
/obj/item/reagent_containers/food/snacks/koisbar_clean,
/obj/item/reagent_containers/food/snacks/koisbar_clean,
/obj/item/reagent_containers/food/snacks/koisbar_clean,
/obj/item/reagent_containers/food/snacks/koisbar_clean,
/obj/item/reagent_containers/food/snacks/koisbar_clean,
/obj/item/reagent_containers/food/snacks/koisbar_clean,
/obj/item/reagent_containers/food/snacks/koisbar_clean,
/turf/simulated/floor/exoplanet/tiled,
/area/moghes_klax)
"RR" = (
/obj/machinery/door/airlock/security{
	name = "Secure Equipment";
	dir = 4
	},
/turf/simulated/floor/exoplanet/tiled,
/area/moghes_klax)
"SK" = (
/obj/structure/table/rack,
/obj/machinery/recharger/wallcharger{
	pixel_y = 25;
	pixel_x = 5
	},
/obj/item/device/reagent_scanner/adv,
/obj/item/device/reagent_scanner/adv,
/turf/simulated/floor/exoplanet/tiled,
/area/moghes_klax)
"TB" = (
/turf/simulated/wall/r_wall,
/area/moghes_klax)
"TK" = (
/turf/simulated/floor/exoplanet/desert{
	temperature = 315.15
	},
/area/moghes_klax)
"TO" = (
/obj/machinery/body_scanconsole{
	dir = 4
	},
/turf/simulated/floor/exoplanet/tiled/white,
/area/moghes_klax)
"Vt" = (
/obj/structure/closet/crate/hydroponics,
/obj/item/seeds/koisspore,
/obj/item/seeds/koisspore,
/obj/item/seeds/koisspore,
/obj/item/seeds/koisspore,
/turf/simulated/floor/exoplanet/tiled/white,
/area/moghes_klax)
"Xh" = (
/obj/machinery/vending/hydronutrients,
/turf/simulated/floor/exoplanet/tiled/white,
/area/moghes_klax)
"Yh" = (
/obj/structure/table/rack,
/obj/item/device/analyzer,
/obj/item/device/analyzer,
/turf/simulated/floor/exoplanet/tiled,
/area/moghes_klax)
"Yy" = (
/obj/structure/table/rack,
/obj/item/gun/energy/vaurca/thermaldrill,
/turf/simulated/floor/exoplanet/tiled,
/area/moghes_klax)
"YA" = (
/obj/machinery/light{
	dir = 1
	},
/turf/simulated/floor/exoplanet/tiled/white,
/area/moghes_klax)
"ZJ" = (
/obj/machinery/door/airlock/medical{
	name = "Botany";
	dir = 4
	},
/turf/simulated/floor/exoplanet/tiled/white,
/area/moghes_klax)

(1,1,1) = {"
TK
TK
TK
TK
TK
TK
TK
TK
TK
TK
TK
TK
TK
TK
TK
TK
TK
TK
TK
TK
TK
TK
TK
TK
TK
TK
TK
TK
TK
TK
"}
(2,1,1) = {"
TK
TK
TK
TK
TK
TK
TK
TK
TK
TK
TK
TK
TK
TK
TK
TK
TK
TK
TK
TK
TK
TK
TK
TK
TK
TK
TK
TK
TK
TK
"}
(3,1,1) = {"
TK
TK
TK
TK
TK
TK
TK
TK
TK
TK
TK
TK
TK
TK
TK
TK
TK
TK
TK
TK
TK
TK
TK
TK
TK
TK
TK
TK
TK
TK
"}
(4,1,1) = {"
TK
TK
TK
TK
TK
TK
TK
TK
TK
TK
TK
TK
TK
TK
TK
TK
TK
TK
TK
TK
TK
TK
TK
TK
TK
TK
TK
TK
TK
TK
"}
(5,1,1) = {"
TK
TK
TK
TK
TK
TK
TB
TB
TB
TB
TB
TB
TB
TB
TB
TB
TB
TB
TB
TB
TB
TB
TB
TK
TK
TK
TK
TK
TK
TK
"}
(6,1,1) = {"
TK
TK
TK
TK
TK
TB
TB
TB
TB
TB
TB
TB
TB
TB
TB
TB
TB
TB
TB
TB
TB
TB
TB
TB
TK
TK
TK
TK
TK
TK
"}
(7,1,1) = {"
TK
TK
TK
TK
TB
TB
Iu
mn
mn
ea
TB
ep
mn
fz
fl
wN
fl
fl
fl
wN
fl
fl
mn
TB
TB
TK
TK
TK
TK
TK
"}
(8,1,1) = {"
TK
TK
TK
TK
TB
TB
fl
mn
mn
Vt
TB
Xh
mn
mn
mn
mn
mn
mn
mn
mn
mn
mn
mn
TB
TB
TK
TK
TK
TK
TK
"}
(9,1,1) = {"
TK
TK
TK
TK
TB
TB
fl
mn
mn
TB
TB
Pb
mn
mn
mn
mn
mn
mn
mn
mn
mn
mn
ea
TB
TB
TK
TK
TK
TK
TK
"}
(10,1,1) = {"
TK
TK
TK
TK
TB
TB
Iu
mn
mn
Kx
aO
mn
mn
mn
fl
fl
fl
fl
fl
fl
fl
fl
mn
TB
TB
TK
TK
TK
TK
TK
"}
(11,1,1) = {"
TK
TK
TK
TK
TB
TB
fl
mn
mn
TB
TB
mn
mn
mn
mn
mn
mn
mn
mn
mn
mn
mn
ea
TB
TB
TK
TK
TK
TK
TK
"}
(12,1,1) = {"
TK
TK
TK
TK
TB
TB
fl
mn
mn
mn
TB
fw
mn
mn
mn
mn
mn
mn
mn
mn
mn
mn
mn
TB
TB
TK
TK
TK
TK
TK
"}
(13,1,1) = {"
TK
TK
TK
TK
TB
TB
Iu
mn
mn
ea
TB
Oa
mn
mn
fl
fl
wV
fl
fl
wV
fl
fl
mn
TB
TB
TK
TK
TK
TK
TK
"}
(14,1,1) = {"
TK
TK
TK
TK
TB
TB
TB
TB
TB
TB
TB
TB
TB
ZJ
TB
TB
TB
TB
TB
TB
TB
TB
TB
TB
TB
cR
TK
TK
TK
TK
"}
(15,1,1) = {"
TK
TK
TK
TK
TB
TB
Ob
Ob
Ob
Ob
Ob
Ob
Ob
Ob
Ob
Ob
Ob
Ob
Ob
Ob
Ob
Ob
xI
xv
TK
TK
TK
TK
TK
TK
"}
(16,1,1) = {"
TK
TK
TK
TK
TB
TB
Ob
Ob
Ob
Ob
vd
Ob
Ob
Ob
vd
Ob
Ob
Ob
vd
Ob
Ob
Ob
xI
xv
TK
TK
TK
TK
TK
TK
"}
(17,1,1) = {"
TK
TK
TK
TK
TB
TB
TB
TB
qx
TB
TB
TB
TB
fL
TB
TB
TB
TB
TB
TB
TB
RR
TB
TB
TB
cR
TK
TK
TK
TK
"}
(18,1,1) = {"
TK
TK
TK
TK
TB
TB
Ob
Ob
Ob
Ob
Ob
Ob
TB
mn
mn
mn
mn
ib
ea
TB
Dh
Ob
Yy
TB
TB
TK
TK
TK
TK
TK
"}
(19,1,1) = {"
TK
TK
TK
TK
TB
TB
GJ
Ob
Ob
Ob
Ob
Ob
TB
LL
mn
mn
mn
ib
mn
TB
SK
Ob
py
TB
TB
TK
TK
TK
TK
TK
"}
(20,1,1) = {"
TK
TK
TK
TK
TB
TB
Pt
Ob
Ob
Ob
Ob
Ob
TB
fm
mn
mn
mn
eH
oO
TB
MO
Ob
fh
TB
TB
TK
TK
TK
TK
TK
"}
(21,1,1) = {"
TK
TK
TK
TK
TB
TB
Fe
Ob
Ob
CZ
Ob
Ob
TB
fm
mn
mn
mn
mn
mn
TB
wX
Ob
ox
TB
TB
TK
TK
TK
TK
TK
"}
(22,1,1) = {"
TK
TK
TK
TK
TB
TB
Gi
Ob
Ob
Ob
Ob
Ob
TB
ss
mn
mn
mn
mn
mn
TB
BA
Ob
On
TB
TB
TK
TK
TK
TK
TK
"}
(23,1,1) = {"
TK
TK
TK
TK
TB
TB
tf
Ob
Ob
Ob
Ob
Ob
TB
YA
mn
mn
mn
mn
TO
TB
Yh
Ob
xY
TB
TB
TK
TK
TK
TK
TK
"}
(24,1,1) = {"
TK
TK
TK
TK
TB
TB
Et
BX
Hu
BX
Hu
BX
TB
IK
xK
vq
AQ
JO
iD
TB
Pf
Ob
eA
TB
TB
TK
TK
TK
TK
TK
"}
(25,1,1) = {"
TK
TK
TK
TK
TK
TB
TB
TB
TB
TB
TB
TB
TB
TB
TB
TB
TB
TB
TB
TB
TB
TB
TB
TB
TK
TK
TK
TK
TK
TK
"}
(26,1,1) = {"
TK
TK
TK
TK
TK
TK
TB
TB
TB
TB
TB
TB
TB
TB
TB
TB
TB
TB
TB
TB
TB
TB
TB
TK
TK
TK
TK
TK
TK
TK
"}
(27,1,1) = {"
TK
TK
TK
TK
TK
TK
TK
TK
TK
TK
TK
TK
TK
TK
TK
TK
TK
TK
TK
TK
TK
TK
TK
TK
TK
TK
TK
TK
TK
TK
"}
(28,1,1) = {"
TK
TK
TK
TK
TK
TK
TK
TK
TK
TK
TK
TK
TK
TK
TK
TK
TK
TK
TK
TK
TK
TK
TK
TK
TK
TK
TK
TK
TK
TK
"}
(29,1,1) = {"
TK
TK
TK
TK
TK
TK
TK
TK
TK
TK
TK
TK
TK
TK
TK
TK
TK
TK
TK
TK
TK
TK
TK
TK
TK
TK
TK
TK
TK
TK
"}
(30,1,1) = {"
TK
TK
TK
TK
TK
TK
TK
TK
TK
TK
TK
TK
TK
TK
TK
TK
TK
TK
TK
TK
TK
TK
TK
TK
TK
TK
TK
TK
TK
TK
"}
