//MAP CONVERTED BY dmm2tgm.py THIS HEADER COMMENT PREVENTS RECONVERSION, DO NOT REMOVE
"a" = (
/turf/simulated/floor/exoplanet/grass/moghes/dirt,
/area/moghes_temple)
"b" = (
/obj/structure/flora/tree/jungle/random,
/turf/simulated/floor/exoplanet/grass/moghes,
/area/moghes_temple)
"c" = (
/obj/structure/unathi_pillar,
/turf/simulated/floor/exoplanet/grass/moghes/dirt,
/area/moghes_temple)
"d" = (
/turf/simulated/floor/exoplanet/grass/moghes,
/area/moghes_temple)
"e" = (
/obj/effect/floor_decal/carpet{
	dir = 4
	},
/turf/simulated/floor/exoplanet/wood/walnut,
/area/moghes_temple)
"f" = (
/obj/structure/platform_deco{
	dir = 4
	},
/turf/simulated/floor/exoplanet/wood/walnut,
/area/moghes_temple)
"g" = (
/obj/item/stack/material/sandstone,
/turf/simulated/floor/exoplanet/grass/moghes,
/area/moghes_temple)
"h" = (
/obj/structure/bed/chair,
/obj/item/bedsheet/black,
/obj/structure/curtain/open/bed,
/turf/simulated/floor/exoplanet/wood/walnut,
/area/moghes_temple)
"i" = (
/obj/structure/flora/grass/junglegrass/random,
/turf/simulated/floor/exoplanet/grass/moghes,
/area/moghes_temple)
"j" = (
/turf/simulated/floor/exoplanet/grass/moghes/dirt{
	icon_state = "edge";
	dir = 8
	},
/area/moghes_temple)
"k" = (
/obj/structure/platform{
	dir = 8
	},
/turf/simulated/floor/exoplanet/wood/walnut,
/area/moghes_temple)
"l" = (
/obj/structure/platform,
/obj/effect/floor_decal/carpet{
	dir = 10
	},
/turf/simulated/floor/exoplanet/wood/walnut,
/area/moghes_temple)
"m" = (
/obj/item/nullrod/shaman,
/turf/simulated/floor/carpet,
/area/moghes_temple)
"n" = (
/obj/structure/simple_door/sandstone,
/turf/simulated/floor/exoplanet/wood/walnut,
/area/moghes_temple)
"o" = (
/obj/structure/platform{
	dir = 4
	},
/turf/simulated/floor/exoplanet/wood/walnut,
/area/moghes_temple)
"p" = (
/obj/structure/closet/cabinet,
/obj/item/material/sword/axe,
/turf/simulated/floor/exoplanet/wood/walnut,
/area/moghes_temple)
"q" = (
/turf/simulated/floor/exoplanet/grass/moghes/dirt{
	icon_state = "edge";
	dir = 10
	},
/area/moghes_temple)
"r" = (
/turf/simulated/floor/carpet,
/area/moghes_temple)
"s" = (
/turf/simulated/floor/exoplanet/grass/moghes/dirt{
	icon_state = "edge";
	dir = 1
	},
/area/moghes_temple)
"t" = (
/turf/simulated/floor/exoplanet/grass/moghes/dirt{
	icon_state = "corner";
	dir = 4
	},
/area/moghes_temple)
"u" = (
/obj/structure/bed/stool/chair/sofa/pew/left{
	dir = 1
	},
/turf/simulated/floor/exoplanet/wood/walnut,
/area/moghes_temple)
"v" = (
/turf/simulated/floor/exoplanet/grass/moghes/dirt{
	icon_state = "edge";
	dir = 4
	},
/area/moghes_temple)
"w" = (
/obj/structure/bed/stool/chair/sofa/pew{
	dir = 1
	},
/turf/simulated/floor/exoplanet/wood/walnut,
/area/moghes_temple)
"x" = (
/obj/structure/platform_stairs{
	dir = 4
	},
/turf/simulated/floor/exoplanet/wood/walnut,
/area/moghes_temple)
"y" = (
/turf/simulated/floor/exoplanet/wood/walnut,
/area/moghes_temple)
"z" = (
/obj/structure/platform,
/obj/effect/floor_decal/carpet,
/turf/simulated/floor/exoplanet/wood/walnut,
/area/moghes_temple)
"A" = (
/turf/simulated/floor/exoplanet/grass/moghes/dirt{
	icon_state = "corner"
	},
/area/moghes_temple)
"B" = (
/obj/effect/decal/cleanable/blood/drip,
/turf/simulated/floor/carpet,
/area/moghes_temple)
"C" = (
/obj/effect/decal/cleanable/blood/drip,
/turf/simulated/floor/exoplanet/grass/moghes,
/area/moghes_temple)
"D" = (
/obj/structure/flora/stump/log,
/turf/simulated/floor/exoplanet/grass/moghes,
/area/moghes_temple)
"E" = (
/turf/simulated/floor/exoplanet/water/shallow/moghes,
/area/moghes_temple)
"F" = (
/obj/structure/unathi_pillar,
/turf/simulated/floor/exoplanet/grass/moghes/dirt{
	icon_state = "edge";
	dir = 5
	},
/area/moghes_temple)
"G" = (
/obj/structure/bonfire,
/turf/simulated/floor/exoplanet/wood/walnut,
/area/moghes_temple)
"H" = (
/obj/effect/decal/cleanable/blood/drip,
/turf/simulated/floor/exoplanet/grass/moghes/dirt,
/area/moghes_temple)
"I" = (
/obj/effect/floor_decal/carpet{
	dir = 8
	},
/mob/living/simple_animal/hostile/biglizard,
/turf/simulated/floor/exoplanet/wood/walnut,
/area/moghes_temple)
"J" = (
/obj/item/stack/material/sandstone,
/obj/effect/decal/cleanable/floor_damage/tiled_broken3,
/obj/effect/decal/cleanable/floor_damage/tiled_broken2,
/turf/simulated/floor/exoplanet/grass/moghes,
/area/moghes_temple)
"K" = (
/obj/structure/platform,
/obj/effect/floor_decal/carpet{
	dir = 6
	},
/turf/simulated/floor/exoplanet/wood/walnut,
/area/moghes_temple)
"L" = (
/obj/structure/platform_stairs{
	dir = 8
	},
/turf/simulated/floor/exoplanet/wood/walnut,
/area/moghes_temple)
"M" = (
/obj/structure/table/wood/walnut,
/turf/simulated/floor/exoplanet/wood/walnut,
/area/moghes_temple)
"N" = (
/obj/effect/landmark/corpse/moghes_priest_unknown,
/obj/effect/decal/cleanable/blood,
/turf/simulated/floor/carpet,
/area/moghes_temple)
"O" = (
/turf/simulated/floor/exoplanet/grass/moghes/dirt{
	icon_state = "edge";
	dir = 5
	},
/area/moghes_temple)
"P" = (
/obj/structure/platform_deco{
	dir = 8
	},
/turf/simulated/floor/exoplanet/wood/walnut,
/area/moghes_temple)
"Q" = (
/obj/structure/table/wood/walnut,
/obj/item/device/flashlight/flare/torch,
/obj/item/device/flashlight/flare/torch,
/obj/item/device/flashlight/flare/torch,
/turf/simulated/floor/exoplanet/wood/walnut,
/area/moghes_temple)
"R" = (
/obj/effect/floor_decal/carpet{
	dir = 8
	},
/turf/simulated/floor/exoplanet/wood/walnut,
/area/moghes_temple)
"S" = (
/turf/simulated/wall/sandstone,
/area/moghes_temple)
"T" = (
/turf/simulated/floor/exoplanet/grass/moghes/dirt{
	icon_state = "edge";
	dir = 9
	},
/area/moghes_temple)
"U" = (
/obj/item/stack/material/sandstone,
/obj/effect/decal/cleanable/floor_damage/tiled_broken1,
/turf/simulated/floor/exoplanet/grass/moghes/dirt,
/area/moghes_temple)
"V" = (
/obj/structure/flora/grass/junglegrass/random,
/obj/structure/flora/tree/jungle/random,
/turf/simulated/floor/exoplanet/grass/moghes,
/area/moghes_temple)
"W" = (
/turf/simulated/floor/exoplanet/grass/moghes/dirt{
	icon_state = "edge";
	dir = 6
	},
/area/moghes_temple)
"X" = (
/obj/structure/flora/tree/jungle/small{
	desc = "A pile of unassuming rocks.";
	icon = 'icons/obj/flora/largejungleflora.dmi';
	icon_state = "rocks3";
	layer = 2.5;
	name = "rocks";
	pixel_x = -16;
	pixel_y = -16
	},
/turf/simulated/floor/exoplanet/grass/moghes,
/area/moghes_temple)
"Y" = (
/obj/structure/bed/stool/chair/sofa/pew/right{
	dir = 1
	},
/turf/simulated/floor/exoplanet/wood/walnut,
/area/moghes_temple)
"Z" = (
/obj/structure/table/wood/walnut,
/obj/item/stack/material/wood/log/full,
/turf/simulated/floor/exoplanet/wood/walnut,
/area/moghes_temple)

(1,1,1) = {"
d
d
d
d
d
d
d
d
d
d
d
d
d
d
d
d
d
d
d
d
d
d
d
d
d
d
d
d
d
d
d
d
"}
(2,1,1) = {"
d
d
d
d
d
d
d
d
i
d
d
d
d
d
i
b
d
d
d
d
d
d
d
d
d
d
E
d
d
d
d
d
"}
(3,1,1) = {"
d
d
d
d
d
d
d
d
d
d
d
d
d
d
d
d
d
d
d
d
d
d
d
d
d
d
E
d
d
i
d
d
"}
(4,1,1) = {"
d
d
d
d
d
d
d
d
d
d
d
d
i
d
d
d
d
d
d
d
i
d
d
d
d
E
E
E
d
d
d
d
"}
(5,1,1) = {"
d
d
d
d
b
d
d
d
d
S
S
S
S
S
S
d
i
d
d
d
d
d
d
d
d
E
E
E
E
d
d
d
"}
(6,1,1) = {"
d
d
d
i
d
d
d
d
d
S
Q
M
Z
M
S
d
d
d
d
d
d
d
d
d
d
d
E
E
E
E
d
i
"}
(7,1,1) = {"
d
d
d
d
d
d
d
d
d
S
y
y
y
M
S
d
d
d
i
d
d
d
d
d
d
d
d
d
d
E
d
d
"}
(8,1,1) = {"
d
d
d
d
d
d
i
d
d
S
y
y
y
M
S
d
d
d
d
d
d
d
d
d
d
i
b
d
d
d
d
d
"}
(9,1,1) = {"
d
d
d
d
d
d
d
d
d
S
y
y
y
y
S
d
d
d
d
d
d
d
d
i
d
d
d
d
d
d
d
i
"}
(10,1,1) = {"
d
d
d
d
S
S
S
S
S
S
n
S
S
S
S
S
S
S
d
d
d
d
i
d
d
d
d
d
d
d
d
d
"}
(11,1,1) = {"
d
d
d
d
S
y
y
y
y
y
y
y
y
y
y
y
y
S
d
d
d
d
d
d
d
d
d
d
d
d
d
d
"}
(12,1,1) = {"
d
S
S
S
S
G
y
y
u
y
u
y
u
y
u
y
y
S
d
d
b
d
d
d
d
d
d
d
d
d
d
d
"}
(13,1,1) = {"
d
S
y
y
y
y
y
y
w
y
w
y
w
y
w
y
y
S
v
a
a
c
s
A
a
F
d
i
d
d
d
d
"}
(14,1,1) = {"
d
S
L
L
k
P
y
y
Y
y
Y
y
Y
y
Y
y
y
S
a
a
a
a
a
a
a
a
d
d
d
i
d
d
"}
(15,1,1) = {"
i
S
y
y
M
K
e
e
e
e
e
e
e
e
e
e
e
S
a
a
a
a
a
a
a
a
d
d
d
d
d
d
"}
(16,1,1) = {"
d
S
y
y
M
z
r
N
r
B
r
r
r
B
r
r
r
n
a
H
a
a
a
a
a
a
W
H
a
s
d
d
"}
(17,1,1) = {"
d
S
y
y
M
z
r
r
m
r
r
B
r
r
r
B
r
n
a
a
a
a
H
a
a
a
j
q
a
t
C
d
"}
(18,1,1) = {"
d
S
y
y
M
l
R
R
R
I
R
R
R
R
R
R
R
S
a
a
a
a
a
a
a
T
d
d
d
d
d
d
"}
(19,1,1) = {"
d
S
x
x
o
f
y
y
u
y
u
y
u
y
u
y
y
S
a
a
a
a
a
a
a
s
d
d
b
d
d
d
"}
(20,1,1) = {"
d
S
y
y
y
y
y
y
w
y
w
y
w
y
w
y
y
S
a
a
a
U
O
j
q
c
d
d
d
d
d
d
"}
(21,1,1) = {"
d
S
S
S
S
G
y
y
Y
y
Y
y
Y
y
Y
y
y
S
d
d
J
d
d
d
d
d
d
i
d
d
d
d
"}
(22,1,1) = {"
d
d
d
d
S
y
y
y
y
y
y
y
y
y
y
y
y
S
d
d
d
d
d
d
d
d
d
d
d
d
i
d
"}
(23,1,1) = {"
d
d
i
d
S
S
S
S
S
S
n
S
S
S
S
S
S
S
d
i
D
d
d
d
d
d
d
d
d
d
d
d
"}
(24,1,1) = {"
d
d
d
d
d
d
d
d
d
S
y
y
y
p
S
d
d
d
d
d
d
d
d
d
d
d
d
d
d
d
d
d
"}
(25,1,1) = {"
d
d
d
d
d
d
d
d
d
S
y
y
y
y
S
d
d
d
d
d
d
d
i
d
i
d
d
d
d
d
d
d
"}
(26,1,1) = {"
d
d
d
d
d
i
d
d
d
S
y
y
y
g
g
d
d
d
X
d
d
d
d
b
d
d
d
d
d
d
d
d
"}
(27,1,1) = {"
d
d
d
d
d
d
d
i
d
S
h
M
y
y
d
g
d
d
d
d
i
d
d
d
d
d
d
i
d
d
d
d
"}
(28,1,1) = {"
d
d
d
d
d
d
d
b
d
S
S
S
S
S
S
d
d
d
d
d
d
d
d
d
d
d
d
d
d
d
d
d
"}
(29,1,1) = {"
d
i
d
d
d
d
d
d
d
d
d
d
d
d
d
d
d
i
d
d
d
d
d
d
d
d
d
d
d
d
d
d
"}
(30,1,1) = {"
d
d
d
d
d
d
i
d
d
d
d
d
d
d
d
d
d
d
d
d
d
d
d
d
d
d
d
d
i
d
d
d
"}
(31,1,1) = {"
d
d
d
d
d
d
d
d
d
d
i
d
d
d
d
V
d
d
d
d
d
d
d
d
d
d
d
d
d
d
d
d
"}
(32,1,1) = {"
d
d
d
d
d
d
d
d
d
d
d
d
d
d
d
d
d
d
d
d
d
d
d
d
d
d
d
d
d
d
d
d
"}
