//MAP CONVERTED BY dmm2tgm.py THIS HEADER COMMENT PREVENTS RECONVERSION, DO NOT REMOVE
"a" = (
/turf/simulated/floor/exoplanet/desert{
	temperature = 315.15
	},
/area/moghes_dorviza)
"b" = (
/obj/structure/curtain/open,
/obj/random/dirt_75,
/turf/simulated/floor/carpet/red,
/area/moghes_dorviza)
"c" = (
/obj/structure/closet/crate/medical,
/obj/item/reagent_containers/blood/OMinus,
/obj/item/reagent_containers/blood/OMinus,
/obj/item/reagent_containers/blood/OMinus,
/obj/item/roller,
/obj/item/roller,
/turf/simulated/floor/exoplanet/carpet/orange,
/area/moghes_dorviza)
"d" = (
/obj/structure/flora/grass/desert/bush,
/turf/simulated/floor/exoplanet/desert{
	temperature = 315.15
	},
/area/moghes_dorviza)
"e" = (
/obj/structure/closet/crate/medical,
/obj/item/storage/box/syringes,
/obj/item/storage/firstaid/radiation,
/obj/item/storage/firstaid/radiation,
/obj/random/firstaid,
/obj/random/firstaid,
/obj/random/firstaid,
/turf/simulated/floor/exoplanet/carpet/orange,
/area/moghes_dorviza)
"f" = (
/obj/machinery/iv_drip,
/turf/simulated/floor/exoplanet/carpet/orange,
/area/moghes_dorviza)
"h" = (
/obj/structure/bed/stool/wood,
/turf/simulated/floor/exoplanet/desert{
	temperature = 315.15
	},
/area/moghes_dorviza)
"k" = (
/obj/structure/flora/grass/desert/bush,
/obj/machinery/portable_atmospherics/hydroponics/soil,
/turf/simulated/floor/exoplanet/diona{
	temperature = 315.15
	},
/area/moghes_dorviza)
"l" = (
/obj/structure/curtain/open,
/turf/simulated/floor/exoplanet/desert{
	temperature = 315.15
	},
/area/moghes_dorviza)
"m" = (
/obj/structure/closet/crate,
/obj/item/clothing/suit/unathi/robe/beige,
/obj/item/clothing/suit/unathi/robe/beige,
/obj/item/clothing/suit/unathi/robe/kilt{
	color = "#DBC684"
	},
/obj/item/clothing/suit/unathi/robe/kilt{
	color = "#DBC684"
	},
/obj/item/clothing/under/unathi,
/obj/item/clothing/under/unathi,
/obj/item/clothing/under/unathi/himation,
/obj/item/clothing/under/unathi/himation,
/obj/item/clothing/head/unathi/deco/green,
/obj/item/clothing/head/unathi/deco/green,
/obj/item/clothing/glasses/safety/goggles/wasteland,
/obj/item/clothing/glasses/safety/goggles/wasteland,
/obj/item/clothing/glasses/safety/goggles/wasteland,
/obj/item/clothing/accessory/sinta_hood{
	color = "#DBC684"
	},
/obj/item/clothing/accessory/sinta_hood{
	color = "#DBC684"
	},
/turf/simulated/floor/carpet/red,
/area/moghes_dorviza)
"n" = (
/obj/effect/ghostspawpoint{
	identifier = "moghes_dorviza_diona";
	name = "igs - moghes_dorviza_diona"
	},
/turf/simulated/floor/exoplanet/diona{
	temperature = 315.15
	},
/area/moghes_dorviza)
"o" = (
/turf/simulated/floor/carpet/red,
/area/moghes_dorviza)
"p" = (
/obj/structure/sink/puddle,
/turf/simulated/floor/exoplanet/desert{
	temperature = 315.15
	},
/area/moghes_dorviza)
"q" = (
/obj/item/bedsheet/brown,
/obj/effect/ghostspawpoint{
	name = "igs - moghes_dorviza";
	identifier = "moghes_dorviza"
	},
/turf/simulated/floor/carpet/red,
/area/moghes_dorviza)
"r" = (
/obj/structure/closet/crate,
/obj/item/material/twohanded/spear/steel,
/obj/random/sword,
/obj/random/sword,
/obj/random/dirt_75,
/turf/simulated/floor/carpet/red,
/area/moghes_dorviza)
"s" = (
/obj/structure/flora/grass/desert,
/turf/simulated/floor/exoplanet/desert{
	temperature = 315.15
	},
/area/moghes_dorviza)
"t" = (
/obj/structure/table/rack/cafe_table,
/obj/item/storage/firstaid/surgery,
/obj/item/device/flashlight/lamp/box,
/turf/simulated/floor/exoplanet/carpet/orange,
/area/moghes_dorviza)
"u" = (
/obj/structure/closet/crate,
/obj/item/device/flashlight/lantern,
/obj/item/device/flashlight/lantern,
/obj/item/device/flashlight/lantern,
/turf/simulated/floor/exoplanet/desert{
	temperature = 315.15
	},
/area/moghes_dorviza)
"v" = (
/obj/structure/flora/tree/desert/small,
/turf/simulated/floor/exoplanet/desert{
	temperature = 315.15
	},
/area/moghes_dorviza)
"w" = (
/obj/structure/curtain/open,
/obj/random/dirt_75,
/turf/simulated/floor/exoplanet/carpet/orange,
/area/moghes_dorviza)
"x" = (
/obj/random/dirt_75,
/turf/simulated/floor/carpet/red,
/area/moghes_dorviza)
"y" = (
/obj/structure/closet/secure_closet/medical2{
	req_access = null
	},
/obj/item/clothing/mask/breath,
/obj/item/clothing/mask/breath,
/obj/item/tank/anesthetic,
/obj/item/tank/anesthetic,
/turf/simulated/floor/exoplanet/carpet/orange,
/area/moghes_dorviza)
"z" = (
/obj/structure/closet/crate/medical,
/obj/item/clothing/gloves/latex/nitrile/unathi,
/obj/item/clothing/gloves/latex/nitrile/unathi,
/obj/item/clothing/mask/surgical,
/obj/item/clothing/mask/surgical,
/obj/random/soap,
/obj/item/reagent_containers/glass/rag,
/turf/simulated/floor/exoplanet/carpet/orange,
/area/moghes_dorviza)
"A" = (
/turf/simulated/floor/exoplanet/water/shallow{
	temperature = 303.15
	},
/area/moghes_dorviza)
"B" = (
/obj/structure/bonfire,
/turf/simulated/floor/exoplanet/desert{
	temperature = 315.15
	},
/area/moghes_dorviza)
"C" = (
/turf/simulated/floor/exoplanet/carpet/orange,
/area/moghes_dorviza)
"D" = (
/obj/structure/bed,
/turf/simulated/floor/exoplanet/carpet/orange,
/area/moghes_dorviza)
"E" = (
/obj/item/device/versebook/thakh,
/obj/item/lore_radio,
/turf/simulated/floor/carpet/red,
/area/moghes_dorviza)
"F" = (
/obj/item/nullrod/shaman,
/obj/structure/closet/crate,
/obj/item/clothing/head/unathi/deco/green,
/obj/item/clothing/suit/unathi/robe/kilt{
	color = "#DBC684"
	},
/obj/item/clothing/accessory/poncho/unathimantle{
	color = "#42330f"
	},
/turf/simulated/floor/exoplanet/desert{
	temperature = 315.15
	},
/area/moghes_dorviza)
"G" = (
/obj/machinery/portable_atmospherics/hydroponics/soil,
/obj/structure/diona/bulb,
/turf/simulated/floor/exoplanet/diona{
	temperature = 315.15
	},
/area/moghes_dorviza)
"H" = (
/obj/item/device/flashlight/lamp/box,
/turf/simulated/floor/exoplanet/desert{
	temperature = 315.15
	},
/area/moghes_dorviza)
"I" = (
/obj/item/device/flashlight/lamp/box,
/turf/simulated/floor/carpet/red,
/area/moghes_dorviza)
"J" = (
/obj/item/bedsheet/brown,
/obj/effect/ghostspawpoint{
	name = "igs - moghes_dorviza";
	identifier = "moghes_dorviza"
	},
/obj/random/dirt_75,
/turf/simulated/floor/carpet/red,
/area/moghes_dorviza)
"K" = (
/obj/structure/flora/tree/desert/tiny,
/turf/simulated/floor/exoplanet/desert{
	temperature = 315.15
	},
/area/moghes_dorviza)
"L" = (
/obj/structure/closet/crate,
/obj/item/saddle,
/obj/item/saddle,
/turf/simulated/floor/exoplanet/desert{
	temperature = 315.15
	},
/area/moghes_dorviza)
"M" = (
/obj/structure/closet/crate,
/obj/item/nullrod/shaman,
/obj/item/clothing/accessory/poncho/unathimantle{
	color = "#42330f"
	},
/obj/item/clothing/accessory/poncho/unathimantle{
	color = "#42330f"
	},
/obj/item/clothing/accessory/poncho/unathimantle{
	color = "#42330f"
	},
/obj/item/flame/lighter/random,
/turf/simulated/floor/carpet/red,
/area/moghes_dorviza)
"N" = (
/obj/item/toy/desk/fan,
/turf/simulated/floor/carpet/red,
/area/moghes_dorviza)
"O" = (
/obj/structure/diona/bulb,
/turf/simulated/floor/exoplanet/diona{
	temperature = 315.15
	},
/area/moghes_dorviza)
"P" = (
/obj/structure/closet/crate,
/obj/random/civgun/rifle,
/obj/random/civgun/rifle,
/obj/item/clothing/accessory/holster/waist/brown,
/obj/item/clothing/accessory/holster/thigh/brown,
/obj/item/gun/projectile/pistol/spitter,
/obj/item/gun/projectile/pistol/spitter,
/obj/item/ammo_magazine/spitterpistol,
/obj/item/ammo_magazine/spitterpistol,
/turf/simulated/floor/carpet/red,
/area/moghes_dorviza)
"Q" = (
/obj/structure/closet/crate,
/turf/simulated/floor/exoplanet/desert{
	temperature = 315.15
	},
/area/moghes_dorviza)
"R" = (
/obj/random/seed,
/obj/random/seed,
/obj/item/seeds/clam,
/obj/item/seeds/clam,
/obj/structure/closet/crate/hydroponics,
/turf/simulated/floor/carpet/red,
/area/moghes_dorviza)
"S" = (
/obj/machinery/portable_atmospherics/hydroponics/soil,
/turf/simulated/floor/exoplanet/diona{
	temperature = 315.15
	},
/area/moghes_dorviza)
"T" = (
/obj/structure/closet/crate/hydroponics,
/obj/item/material/hatchet/lumber,
/obj/item/material/hatchet,
/obj/item/wirecutters/clippers,
/obj/item/material/minihoe,
/obj/item/material/minihoe,
/obj/item/reagent_containers/glass/bottle/ammonia,
/obj/item/reagent_containers/glass/bottle/ammonia,
/obj/item/reagent_containers/glass/bottle/ammonia,
/obj/item/reagent_containers/glass/bucket/wood,
/obj/item/reagent_containers/glass/bucket/wood,
/turf/simulated/floor/carpet/red,
/area/moghes_dorviza)
"U" = (
/obj/item/device/flashlight/lantern/on,
/turf/simulated/floor/exoplanet/desert{
	temperature = 315.15
	},
/area/moghes_dorviza)
"V" = (
/turf/simulated/wall/cloth,
/area/moghes_dorviza)
"W" = (
/obj/random/dirt_75,
/turf/simulated/floor/exoplanet/carpet/orange,
/area/moghes_dorviza)
"X" = (
/obj/structure/closet/crate/freezer,
/obj/item/reagent_containers/food/snacks/fish/fishfillet,
/obj/item/reagent_containers/food/snacks/fish/fishfillet,
/obj/item/reagent_containers/food/snacks/fish/fishfillet,
/obj/item/reagent_containers/food/snacks/fish/fishfillet,
/obj/item/reagent_containers/food/snacks/fish/fishfillet,
/obj/item/reagent_containers/food/snacks/fish/fishfillet,
/obj/item/reagent_containers/food/drinks/waterbottle,
/obj/item/reagent_containers/food/drinks/waterbottle,
/obj/item/reagent_containers/food/drinks/waterbottle,
/obj/item/reagent_containers/food/drinks/waterbottle,
/obj/item/reagent_containers/food/drinks/waterbottle,
/obj/item/reagent_containers/food/drinks/waterbottle,
/turf/simulated/floor/carpet/red,
/area/moghes_dorviza)
"Y" = (
/turf/simulated/floor/exoplanet/diona{
	temperature = 315.15
	},
/area/moghes_dorviza)
"Z" = (
/obj/structure/flora/grass/desert,
/obj/machinery/portable_atmospherics/hydroponics/soil,
/obj/structure/diona/bulb,
/turf/simulated/floor/exoplanet/diona{
	temperature = 315.15
	},
/area/moghes_dorviza)

(1,1,1) = {"
a
a
a
a
a
a
a
a
a
a
a
a
a
a
a
a
a
a
a
a
a
a
a
a
a
a
a
a
a
a
a
a
a
a
a
"}
(2,1,1) = {"
a
a
a
a
a
a
a
a
a
a
a
a
a
a
a
a
V
V
V
V
V
a
a
a
a
a
a
a
a
a
a
a
a
a
a
"}
(3,1,1) = {"
a
a
a
a
a
a
a
a
a
a
a
a
a
a
a
V
V
o
x
o
V
V
a
a
a
a
a
a
a
a
a
a
a
a
a
"}
(4,1,1) = {"
a
a
a
a
a
a
a
a
a
a
a
a
a
a
a
V
J
x
E
x
x
V
a
a
a
a
a
a
a
a
a
a
a
a
a
"}
(5,1,1) = {"
a
a
a
a
a
a
a
a
a
s
s
s
s
a
a
V
q
o
I
N
m
V
a
a
a
a
a
a
a
a
a
a
a
a
a
"}
(6,1,1) = {"
a
a
a
a
a
a
a
a
a
a
a
a
s
a
a
V
J
x
x
x
M
V
a
a
a
a
a
a
a
a
a
a
a
a
a
"}
(7,1,1) = {"
a
a
a
a
a
a
a
a
a
a
a
a
a
s
a
V
V
o
x
o
V
V
a
a
a
a
a
a
a
a
a
a
a
a
a
"}
(8,1,1) = {"
a
a
a
a
a
a
a
a
a
a
a
a
a
a
s
a
V
V
b
V
V
a
a
a
a
a
a
a
a
a
a
a
a
a
a
"}
(9,1,1) = {"
a
a
a
a
a
a
a
a
a
a
a
a
a
s
s
s
U
a
a
a
a
a
a
a
a
a
a
a
a
a
a
a
a
a
a
"}
(10,1,1) = {"
a
a
a
a
a
a
a
a
a
a
a
a
a
a
a
a
a
a
h
a
a
a
a
a
a
a
a
a
a
a
a
a
a
a
a
"}
(11,1,1) = {"
a
a
a
a
a
a
a
a
a
a
a
a
a
a
a
K
a
h
B
h
a
a
a
a
a
a
a
a
a
a
a
a
a
a
a
"}
(12,1,1) = {"
a
a
a
a
a
a
a
a
a
a
a
a
a
a
a
a
s
a
h
a
a
a
a
a
a
a
a
a
a
a
a
a
a
a
a
"}
(13,1,1) = {"
a
a
a
a
a
a
a
a
a
a
a
a
a
a
a
a
A
A
a
A
d
A
a
d
a
a
a
a
a
a
a
a
a
a
a
"}
(14,1,1) = {"
a
a
a
a
V
V
V
V
V
a
a
a
a
a
s
A
A
S
G
A
A
d
d
a
a
a
V
V
V
V
V
a
a
a
a
"}
(15,1,1) = {"
a
a
a
V
V
C
c
f
V
V
Q
a
a
s
A
A
A
A
A
A
A
a
a
K
a
V
V
r
P
R
V
V
a
a
a
"}
(16,1,1) = {"
a
a
a
V
y
C
W
C
W
V
a
a
p
s
A
A
A
A
A
A
A
a
a
a
H
V
x
o
x
o
X
V
a
a
a
"}
(17,1,1) = {"
a
a
a
V
D
W
C
C
C
w
a
s
A
A
A
A
A
A
A
A
A
Z
s
a
a
l
a
x
x
x
o
V
a
a
a
"}
(18,1,1) = {"
a
a
a
V
t
C
C
C
W
V
O
a
A
A
A
A
A
A
A
A
A
A
a
a
a
V
a
a
x
o
I
V
a
a
a
"}
(19,1,1) = {"
a
a
a
V
V
e
z
C
V
V
a
A
A
A
A
A
A
A
A
A
A
A
s
a
a
V
V
u
L
T
V
V
a
a
a
"}
(20,1,1) = {"
a
a
a
a
V
V
V
V
V
a
a
a
G
A
A
A
A
A
A
A
A
s
a
a
a
a
V
V
V
V
V
a
a
a
a
"}
(21,1,1) = {"
a
a
a
a
a
a
a
a
a
a
a
a
S
A
s
s
A
G
d
A
a
A
A
a
a
a
a
a
a
a
a
a
a
a
a
"}
(22,1,1) = {"
a
a
a
a
a
a
a
a
a
a
a
s
a
A
a
v
s
A
k
A
a
K
s
s
s
a
a
a
a
a
a
a
a
a
a
"}
(23,1,1) = {"
a
a
a
a
a
a
a
a
a
a
a
a
a
a
a
a
a
a
a
a
a
a
a
s
a
a
a
a
a
a
a
a
a
a
a
"}
(24,1,1) = {"
a
a
a
a
a
a
a
a
a
a
a
s
a
s
a
a
O
a
a
a
a
a
a
a
a
a
a
a
a
a
a
a
a
a
a
"}
(25,1,1) = {"
a
a
a
a
a
a
a
a
a
a
a
a
a
a
s
V
V
l
V
V
a
a
a
a
a
a
a
a
a
a
a
a
a
a
a
"}
(26,1,1) = {"
a
a
a
a
a
a
a
a
a
a
a
a
a
a
V
V
a
a
Y
V
V
a
a
a
a
a
a
a
a
a
a
a
a
a
a
"}
(27,1,1) = {"
a
a
a
a
a
a
a
a
a
a
a
a
a
a
V
a
a
Y
a
F
V
a
a
a
a
a
a
a
a
a
a
a
a
a
a
"}
(28,1,1) = {"
a
a
a
a
a
a
a
a
a
a
a
a
a
a
V
Y
a
n
O
a
V
a
a
a
a
a
a
a
a
a
a
a
a
a
a
"}
(29,1,1) = {"
a
a
a
a
a
a
a
a
a
a
a
a
a
a
V
a
O
a
a
Y
V
a
a
a
a
a
a
a
a
a
a
a
a
a
a
"}
(30,1,1) = {"
a
a
a
a
a
a
a
a
a
a
a
a
a
a
V
V
a
Y
a
V
V
a
a
a
a
a
a
a
a
a
a
a
a
a
a
"}
(31,1,1) = {"
a
a
a
a
a
a
a
a
a
a
a
a
a
a
a
V
V
V
V
V
a
a
a
a
a
a
a
a
a
a
a
a
a
a
a
"}
(32,1,1) = {"
a
a
a
a
a
a
a
a
a
a
a
a
a
a
a
a
a
a
a
a
a
a
a
a
a
a
a
a
a
a
a
a
a
a
a
"}
(33,1,1) = {"
a
a
a
a
a
a
a
a
a
a
a
a
a
a
a
a
a
a
a
a
a
a
a
a
a
a
a
a
a
a
a
a
a
a
a
"}
(34,1,1) = {"
a
a
a
a
a
a
a
a
a
a
a
a
a
a
a
a
a
a
a
a
a
a
a
a
a
a
a
a
a
a
a
a
a
a
a
"}
(35,1,1) = {"
a
a
a
a
a
a
a
a
a
a
a
a
a
a
a
a
a
a
a
a
a
a
a
a
a
a
a
a
a
a
a
a
a
a
a
"}
