//MAP CONVERTED BY dmm2tgm.py THIS HEADER COMMENT PREVENTS RECONVERSION, DO NOT REMOVE
"a" = (
/turf/simulated/floor/exoplanet/desert{
	temperature = 315.15
	},
/area/template_noop)
"m" = (
/obj/structure/flora/ausbushes/sparsegrass,
/turf/simulated/floor/exoplanet/desert{
	temperature = 315.15
	},
/area/template_noop)
"D" = (
/obj/structure/sink/puddle,
/turf/simulated/floor/exoplanet/desert{
	temperature = 315.15
	},
/area/template_noop)
"L" = (
/turf/simulated/floor/exoplanet/water/shallow{
	temperature = 303.15
	},
/area/template_noop)

(1,1,1) = {"
a
a
a
a
a
a
a
a
a
a
a
a
a
a
a
a
a
a
a
a
"}
(2,1,1) = {"
a
a
a
a
a
a
a
a
a
a
a
a
a
a
a
a
a
a
a
a
"}
(3,1,1) = {"
a
a
a
a
a
a
a
a
a
a
a
a
a
a
a
a
a
a
a
a
"}
(4,1,1) = {"
a
a
a
a
a
a
a
a
a
m
L
L
L
m
a
a
a
a
a
a
"}
(5,1,1) = {"
a
a
a
a
a
a
a
a
a
L
L
L
L
L
m
a
a
a
a
a
"}
(6,1,1) = {"
a
a
a
a
a
a
a
a
m
L
L
L
L
L
L
a
a
a
a
a
"}
(7,1,1) = {"
a
a
a
a
a
a
a
a
a
D
m
m
L
L
L
a
a
a
a
a
"}
(8,1,1) = {"
a
a
a
a
a
m
m
a
a
a
a
a
L
L
L
D
a
a
a
a
"}
(9,1,1) = {"
a
a
a
a
a
L
L
L
m
a
a
a
m
m
a
a
a
a
a
a
"}
(10,1,1) = {"
a
a
a
a
m
L
L
L
L
m
a
a
a
a
a
a
a
a
a
a
"}
(11,1,1) = {"
a
a
a
a
m
L
L
L
L
L
a
a
a
a
a
m
L
m
m
a
"}
(12,1,1) = {"
a
a
a
a
L
L
L
L
L
L
L
a
D
a
m
L
L
L
L
a
"}
(13,1,1) = {"
a
a
a
m
L
L
L
L
L
L
L
L
a
a
L
L
L
L
L
a
"}
(14,1,1) = {"
a
a
a
a
L
L
L
L
L
L
L
L
a
m
L
L
L
L
L
a
"}
(15,1,1) = {"
a
a
a
D
L
L
L
L
L
L
L
L
a
a
m
L
L
L
m
a
"}
(16,1,1) = {"
a
a
a
m
m
L
L
L
L
L
L
L
a
a
a
a
m
a
a
a
"}
(17,1,1) = {"
a
a
a
a
a
m
m
a
L
L
L
a
m
a
a
a
a
m
a
a
"}
(18,1,1) = {"
a
a
a
a
a
a
a
a
m
m
a
a
a
a
a
a
a
a
a
a
"}
(19,1,1) = {"
a
a
a
a
a
a
a
a
a
a
a
a
a
a
a
a
a
a
a
a
"}
(20,1,1) = {"
a
a
a
a
a
a
a
a
a
a
a
a
a
a
a
a
a
a
a
a
"}
