//MAP CONVERTED BY dmm2tgm.py THIS HEADER COMMENT PREVENTS RECONVERSION, DO NOT REMOVE
"a" = (
/turf/simulated/floor/exoplanet/desert{
	temperature = 315.15
	},
/area/moghes_reclaimer)
"e" = (
/obj/structure/curtain,
/turf/simulated/floor/exoplanet/tiled{
	temperature = 315.15
	},
/area/moghes_reclaimer)
"h" = (
/obj/item/bedsheet,
/obj/effect/ghostspawpoint{
	name = "igs - moghes_reclaimer";
	identifier = "moghes_reclaimer"
	},
/turf/simulated/floor/exoplanet/tiled{
	temperature = 315.15
	},
/area/moghes_reclaimer)
"i" = (
/turf/simulated/wall/cloth,
/area/moghes_reclaimer)
"m" = (
/obj/structure/bed/stool/bar/wood,
/turf/simulated/floor/exoplanet/tiled{
	temperature = 315.15
	},
/area/moghes_reclaimer)
"p" = (
/obj/structure/sink/puddle,
/turf/simulated/floor/exoplanet/desert{
	temperature = 315.15
	},
/area/moghes_reclaimer)
"s" = (
/obj/vehicle/bike/motor/sand,
/turf/simulated/floor/exoplanet/desert{
	temperature = 315.15
	},
/area/moghes_reclaimer)
"u" = (
/obj/machinery/recharger,
/turf/simulated/floor/exoplanet/tiled{
	temperature = 315.15
	},
/area/moghes_reclaimer)
"v" = (
/obj/machinery/light/colored/red{
	dir = 1
	},
/turf/simulated/floor/exoplanet/desert{
	temperature = 315.15
	},
/area/moghes_reclaimer)
"x" = (
/obj/structure/closet/crate,
/obj/structure/closet/crate,
/obj/item/gun/energy/plasmacutter,
/obj/item/gun/energy/plasmacutter,
/obj/item/gun/energy/plasmacutter,
/obj/random/civgun,
/obj/item/material/hatchet/machete/steel,
/obj/item/material/hatchet/machete/steel,
/obj/item/clothing/accessory/holster/utility/machete,
/obj/item/clothing/accessory/holster/utility/machete,
/obj/item/device/geiger,
/obj/item/device/geiger,
/obj/item/device/geiger,
/obj/item/device/geiger,
/obj/item/gun/projectile/pistol/spitter,
/obj/item/ammo_magazine/spitterpistol,
/obj/item/gun/projectile/shotgun/pump/rifle/magazine_fed/crackrifle,
/obj/item/ammo_magazine/tempestsmg,
/obj/item/gun/projectile/automatic/tempestsmg,
/turf/simulated/floor/exoplanet/tiled{
	temperature = 315.15
	},
/area/moghes_reclaimer)
"z" = (
/obj/structure/flora/grass/desert,
/turf/simulated/floor/exoplanet/desert{
	temperature = 315.15
	},
/area/moghes_reclaimer)
"C" = (
/obj/structure/reagent_dispensers/fueltank,
/turf/simulated/floor/exoplanet/tiled{
	temperature = 315.15
	},
/area/moghes_reclaimer)
"E" = (
/obj/item/bedsheet,
/obj/effect/ghostspawpoint{
	name = "igs - moghes_reclaimer";
	identifier = "moghes_reclaimer"
	},
/obj/machinery/light/colored/red{
	dir = 1
	},
/turf/simulated/floor/exoplanet/tiled{
	temperature = 315.15
	},
/area/moghes_reclaimer)
"F" = (
/turf/simulated/wall/rusty,
/area/moghes_reclaimer)
"J" = (
/obj/machinery/light/colored/red{
	dir = 1
	},
/turf/simulated/floor/exoplanet/tiled{
	temperature = 315.15
	},
/area/moghes_reclaimer)
"K" = (
/obj/structure/closet/crate,
/obj/item/reagent_containers/food/drinks/waterbottle,
/obj/item/reagent_containers/food/drinks/waterbottle,
/obj/item/reagent_containers/food/drinks/waterbottle,
/obj/item/reagent_containers/food/drinks/waterbottle,
/obj/item/reagent_containers/food/drinks/waterbottle,
/obj/item/reagent_containers/food/drinks/waterbottle,
/obj/item/reagent_containers/food/drinks/waterbottle,
/obj/item/reagent_containers/food/drinks/waterbottle,
/turf/simulated/floor/exoplanet/tiled{
	temperature = 315.15
	},
/area/moghes_reclaimer)
"P" = (
/obj/structure/closet/crate,
/obj/item/clothing/head/welding,
/obj/item/clothing/head/welding,
/obj/item/clothing/head/welding,
/obj/item/clothing/head/welding,
/obj/item/weldingtool/largetank,
/obj/item/weldingtool/largetank,
/obj/item/weldingtool/largetank,
/obj/item/storage/toolbox/mechanical,
/obj/item/storage/toolbox/mechanical,
/turf/simulated/floor/exoplanet/tiled{
	temperature = 315.15
	},
/area/moghes_reclaimer)
"Q" = (
/obj/structure/bed/stool/bar/wood,
/turf/simulated/floor/exoplanet/desert{
	temperature = 315.15
	},
/area/moghes_reclaimer)
"V" = (
/turf/simulated/floor/exoplanet/tiled{
	temperature = 315.15
	},
/area/moghes_reclaimer)
"Y" = (
/obj/structure/bonfire/light_up,
/turf/simulated/floor/exoplanet/desert{
	temperature = 315.15
	},
/area/moghes_reclaimer)

(1,1,1) = {"
a
a
a
a
a
a
a
a
a
a
a
a
a
a
a
a
a
a
a
a
"}
(2,1,1) = {"
a
a
a
a
a
a
a
a
a
a
a
a
a
a
a
a
a
a
a
a
"}
(3,1,1) = {"
a
a
a
a
a
a
a
a
a
a
a
a
a
a
a
a
a
a
a
a
"}
(4,1,1) = {"
a
a
a
a
a
a
a
F
F
a
a
a
a
a
a
a
a
a
a
a
"}
(5,1,1) = {"
a
a
a
a
a
a
F
V
V
i
z
a
a
a
a
a
a
a
a
a
"}
(6,1,1) = {"
a
a
a
a
F
F
C
V
V
i
a
z
z
z
a
a
a
a
a
a
"}
(7,1,1) = {"
a
a
a
F
h
V
V
V
V
i
z
p
z
a
a
a
a
a
a
a
"}
(8,1,1) = {"
a
a
a
F
h
V
V
V
V
i
v
z
a
Q
a
a
a
a
a
a
"}
(9,1,1) = {"
a
a
a
F
E
V
V
V
V
e
a
z
Q
Y
Q
a
a
a
a
a
"}
(10,1,1) = {"
a
a
a
F
V
V
V
V
V
e
V
V
a
m
a
a
a
a
a
a
"}
(11,1,1) = {"
a
a
a
F
J
V
V
V
V
i
J
a
a
a
a
a
a
a
a
a
"}
(12,1,1) = {"
a
a
a
F
u
V
V
V
V
i
a
a
a
a
a
a
a
a
a
a
"}
(13,1,1) = {"
a
a
a
a
F
u
x
P
K
i
V
a
V
a
V
a
a
a
a
a
"}
(14,1,1) = {"
a
a
a
a
a
F
F
F
F
F
a
V
a
V
a
a
V
a
a
a
"}
(15,1,1) = {"
a
a
a
a
a
a
a
a
a
a
F
s
s
s
s
a
a
a
a
a
"}
(16,1,1) = {"
a
a
a
a
a
a
a
a
a
a
a
F
F
F
F
a
a
a
a
a
"}
(17,1,1) = {"
a
a
a
a
a
a
a
a
a
a
a
a
a
a
a
a
a
a
a
a
"}
(18,1,1) = {"
a
a
a
a
a
a
a
a
a
a
a
a
a
a
a
a
a
a
V
a
"}
(19,1,1) = {"
a
a
a
a
a
a
a
a
a
a
a
a
a
a
a
a
a
a
a
a
"}
(20,1,1) = {"
a
a
a
a
a
a
a
a
a
a
a
a
a
a
a
a
a
a
a
a
"}
