//MAP CONVERTED BY dmm2tgm.py THIS HEADER COMMENT PREVENTS RECONVERSION, DO NOT REMOVE
"a" = (
/turf/simulated/floor/exoplanet/desert{
	temperature = 315.15
	},
/area/moghes/kataphract_wasteland)
"b" = (
/obj/structure/bonfire/light_up,
/turf/simulated/floor/exoplanet/desert{
	temperature = 315.15
	},
/area/moghes/kataphract_wasteland)
"d" = (
/obj/structure/closet/crate/freezer,
/obj/item/storage/box/fancy/mre/menu10,
/obj/item/storage/box/fancy/mre/menu10,
/obj/item/storage/box/fancy/mre/menu10,
/obj/item/storage/box/fancy/mre/menu10,
/obj/item/storage/box/fancy/mre/menu10,
/obj/item/reagent_containers/food/drinks/waterbottle,
/obj/item/reagent_containers/food/drinks/waterbottle,
/obj/item/reagent_containers/food/drinks/waterbottle,
/obj/item/reagent_containers/food/drinks/waterbottle,
/obj/item/reagent_containers/food/drinks/waterbottle,
/obj/item/reagent_containers/food/drinks/waterbottle,
/obj/item/reagent_containers/food/drinks/waterbottle,
/obj/item/reagent_containers/food/drinks/waterbottle,
/obj/item/reagent_containers/food/drinks/waterbottle,
/turf/simulated/floor/exoplanet/carpet/rubber{
	temperature = 303.15
	},
/area/moghes/kataphract_wasteland)
"h" = (
/turf/simulated/wall/rusty,
/area/moghes/kataphract_wasteland)
"j" = (
/obj/structure/closet/crate/medical,
/obj/item/storage/firstaid/radiation,
/obj/item/storage/firstaid/radiation,
/obj/item/storage/firstaid/combat,
/obj/item/storage/firstaid/combat,
/turf/simulated/floor/exoplanet/carpet/rubber{
	temperature = 303.15
	},
/area/moghes/kataphract_wasteland)
"l" = (
/obj/item/bedsheet/orange,
/obj/effect/ghostspawpoint{
	name = "igs - moghes_kataphract_wasteland";
	identifier = "moghes_kataphract_wasteland"
	},
/obj/structure/sign/flag/hegemony/large/west{
	pixel_x = -32
	},
/turf/simulated/floor/exoplanet/carpet/rubber{
	temperature = 303.15
	},
/area/moghes/kataphract_wasteland)
"o" = (
/obj/structure/closet/crate,
/obj/item/saddle,
/obj/item/clothing/suit/armor/unathi/hegemony,
/obj/item/clothing/head/helmet/unathi/hegemony,
/obj/item/device/radio,
/obj/item/device/geiger,
/turf/simulated/floor/exoplanet/carpet/rubber{
	temperature = 303.15
	},
/area/moghes/kataphract_wasteland)
"p" = (
/obj/structure/bed/stool/wood,
/turf/simulated/floor/exoplanet/desert{
	temperature = 315.15
	},
/area/moghes/kataphract_wasteland)
"q" = (
/turf/simulated/floor/exoplanet/tiled{
	temperature = 315.15
	},
/area/moghes/kataphract_wasteland)
"s" = (
/obj/structure/closet/crate,
/obj/item/clothing/accessory/poncho/red,
/turf/simulated/floor/exoplanet/carpet/rubber{
	temperature = 303.15
	},
/area/moghes/kataphract_wasteland)
"v" = (
/obj/structure/reagent_dispensers/watertank,
/turf/simulated/floor/exoplanet/carpet/rubber{
	temperature = 303.15
	},
/area/moghes/kataphract_wasteland)
"w" = (
/obj/structure/curtain/open,
/turf/simulated/floor/exoplanet/carpet/rubber{
	temperature = 303.15
	},
/area/moghes/kataphract_wasteland)
"H" = (
/obj/machinery/light/small{
	dir = 4
	},
/turf/simulated/floor/exoplanet/carpet/rubber{
	temperature = 303.15
	},
/area/moghes/kataphract_wasteland)
"M" = (
/obj/item/bedsheet/orange,
/obj/effect/ghostspawpoint{
	name = "igs - moghes_kataphract_wasteland_knight";
	identifier = "moghes_kataphract_wasteland_knight"
	},
/turf/simulated/floor/exoplanet/carpet/rubber{
	temperature = 303.15
	},
/area/moghes/kataphract_wasteland)
"R" = (
/turf/simulated/wall/cloth,
/area/moghes/kataphract_wasteland)
"S" = (
/obj/structure/sign/flag/hegemony/large/north{
	pixel_y = 32
	},
/turf/simulated/floor/exoplanet/desert{
	temperature = 315.15
	},
/area/moghes/kataphract_wasteland)
"T" = (
/turf/simulated/floor/exoplanet/carpet/rubber{
	temperature = 303.15
	},
/area/moghes/kataphract_wasteland)
"V" = (
/obj/item/bedsheet/orange,
/obj/effect/ghostspawpoint{
	name = "igs - moghes_kataphract_wasteland";
	identifier = "moghes_kataphract_wasteland"
	},
/turf/simulated/floor/exoplanet/carpet/rubber{
	temperature = 303.15
	},
/area/moghes/kataphract_wasteland)
"X" = (
/obj/structure/closet/crate,
/obj/item/clothing/accessory/poncho,
/obj/item/clothing/accessory/poncho,
/obj/item/clothing/accessory/poncho,
/obj/item/clothing/suit/armor/unathi/hegemony,
/obj/item/clothing/suit/armor/unathi/hegemony,
/obj/item/clothing/suit/armor/unathi/hegemony,
/obj/item/clothing/head/helmet/unathi/hegemony,
/obj/item/clothing/head/helmet/unathi/hegemony,
/obj/item/clothing/head/helmet/unathi/hegemony,
/obj/item/device/radio,
/obj/item/device/radio,
/obj/item/device/radio,
/obj/item/device/geiger,
/obj/item/device/geiger,
/obj/item/device/geiger,
/turf/simulated/floor/exoplanet/carpet/rubber{
	temperature = 303.15
	},
/area/moghes/kataphract_wasteland)

(1,1,1) = {"
a
a
a
a
a
a
a
a
a
a
a
a
a
a
a
a
a
a
a
a
a
a
a
a
a
a
a
a
a
a
"}
(2,1,1) = {"
a
a
a
a
a
a
a
a
a
a
a
a
a
a
a
a
a
a
a
a
a
a
a
a
a
a
a
a
a
a
"}
(3,1,1) = {"
a
a
a
a
a
a
a
a
a
a
a
a
a
a
a
a
a
a
a
a
a
a
a
a
a
a
a
a
a
a
"}
(4,1,1) = {"
a
a
a
a
a
a
a
a
a
a
a
a
a
a
a
a
a
a
a
a
a
a
a
a
a
a
a
a
a
a
"}
(5,1,1) = {"
a
a
a
a
a
a
a
a
h
h
h
h
h
a
a
a
a
a
a
a
a
a
a
a
a
a
a
a
a
a
"}
(6,1,1) = {"
a
a
a
a
a
a
h
h
a
a
a
a
a
a
a
a
a
a
a
a
a
a
a
a
a
a
a
a
a
a
"}
(7,1,1) = {"
a
a
a
a
a
a
h
a
a
a
a
a
a
a
a
a
a
a
a
q
a
a
a
a
a
a
a
a
a
a
"}
(8,1,1) = {"
a
h
h
h
h
a
a
a
a
a
a
a
a
a
a
a
a
a
a
a
a
a
a
h
a
a
a
a
a
a
"}
(9,1,1) = {"
a
a
a
a
a
a
a
a
a
a
q
a
a
a
a
q
a
a
a
a
a
q
a
a
a
a
a
a
a
a
"}
(10,1,1) = {"
a
a
a
a
a
a
a
a
a
a
a
a
a
a
a
a
a
a
a
a
a
a
q
q
a
a
a
a
a
a
"}
(11,1,1) = {"
a
a
a
a
a
a
q
q
a
a
a
a
a
a
a
a
a
a
a
a
a
a
a
a
h
a
a
a
a
a
"}
(12,1,1) = {"
a
a
q
a
a
a
a
a
a
a
a
a
a
a
a
a
a
a
a
a
a
a
a
a
a
a
a
a
a
a
"}
(13,1,1) = {"
a
a
a
a
R
R
R
R
R
a
a
a
a
a
a
a
R
R
R
R
R
a
a
a
a
a
a
a
a
a
"}
(14,1,1) = {"
a
a
a
R
R
s
o
d
R
R
S
a
a
a
a
R
R
V
l
V
R
R
a
a
a
a
a
a
a
a
"}
(15,1,1) = {"
a
a
a
R
T
T
T
T
T
R
a
a
p
a
a
R
T
T
T
T
X
R
a
a
a
a
a
h
a
a
"}
(16,1,1) = {"
a
a
a
R
M
T
T
T
T
w
a
p
b
p
a
w
T
T
T
T
j
R
a
a
a
a
a
h
a
a
"}
(17,1,1) = {"
a
a
a
R
T
T
T
T
T
R
a
a
p
a
a
R
T
T
T
T
T
R
a
a
a
a
a
h
a
a
"}
(18,1,1) = {"
a
a
a
R
R
v
H
T
R
R
a
a
a
a
a
R
R
T
H
T
R
R
a
a
a
a
a
a
a
a
"}
(19,1,1) = {"
a
a
a
a
R
R
R
R
R
a
a
a
a
a
a
a
R
R
R
R
R
a
a
a
a
a
h
a
a
a
"}
(20,1,1) = {"
a
a
a
a
a
a
a
a
a
a
a
a
a
a
a
a
a
a
a
q
a
a
a
a
q
a
h
a
a
a
"}
(21,1,1) = {"
a
a
a
a
a
a
a
a
a
q
q
q
a
a
a
a
a
a
a
a
a
a
q
a
q
a
a
a
a
a
"}
(22,1,1) = {"
a
a
a
a
a
a
a
a
a
q
q
q
a
a
a
a
a
a
a
a
a
a
a
a
a
a
a
a
a
a
"}
(23,1,1) = {"
a
a
a
a
a
a
a
a
a
a
a
a
a
a
a
a
a
a
a
a
a
h
h
a
a
a
a
a
a
a
"}
(24,1,1) = {"
a
a
a
a
h
h
h
h
h
h
h
h
a
a
a
a
a
a
a
a
a
h
h
a
a
a
a
a
a
a
"}
(25,1,1) = {"
a
a
a
a
a
a
a
a
a
a
a
a
a
a
a
a
a
a
a
a
a
a
a
a
a
a
a
a
a
a
"}
(26,1,1) = {"
a
a
a
a
a
a
a
a
a
a
a
a
a
a
a
a
a
a
a
a
a
a
a
a
a
a
a
a
a
a
"}
(27,1,1) = {"
a
a
a
a
a
a
a
a
a
a
a
a
a
a
a
a
a
a
a
a
a
a
a
a
a
a
a
a
a
a
"}
(28,1,1) = {"
a
a
a
a
a
a
a
a
a
a
a
a
a
a
a
a
a
a
a
a
a
a
a
a
a
a
a
a
a
a
"}
(29,1,1) = {"
a
a
a
a
a
a
a
a
a
a
a
a
a
a
a
a
a
a
a
a
a
a
a
a
a
a
a
a
a
a
"}
(30,1,1) = {"
a
a
a
a
a
a
a
a
a
a
a
a
a
a
a
a
a
a
a
a
a
a
a
a
a
a
a
a
a
a
"}
