//MAP CONVERTED BY dmm2tgm.py THIS HEADER COMMENT PREVENTS RECONVERSION, DO NOT REMOVE
"a" = (
/turf/simulated/floor/exoplanet/desert{
	temperature = 315.15
	},
/area/moghes_gawgaryn_bikers)
"b" = (
/turf/simulated/wall/rusty,
/area/moghes_gawgaryn_bikers)
"h" = (
/obj/structure/bed/stool/wood,
/obj/effect/ghostspawpoint{
	name = "igs - moghes_gawgaryn_biker";
	identifier = "moghes_gawgaryn_biker"
	},
/turf/simulated/floor/exoplanet/desert{
	temperature = 315.15
	},
/area/moghes_gawgaryn_bikers)
"n" = (
/obj/structure/bed/stool/wood,
/turf/simulated/floor/exoplanet/desert{
	temperature = 315.15
	},
/area/moghes_gawgaryn_bikers)
"p" = (
/obj/structure/bed/stool/wood,
/obj/effect/ghostspawpoint{
	identifier = "moghes_gawgaryn_biker_boss";
	name = "igs - moghes_gawgaryn_biker_boss"
	},
/turf/simulated/floor/exoplanet/desert{
	temperature = 315.15
	},
/area/moghes_gawgaryn_bikers)
"z" = (
/obj/structure/bonfire/light_up,
/turf/simulated/floor/exoplanet/desert{
	temperature = 315.15
	},
/area/moghes_gawgaryn_bikers)
"B" = (
/obj/item/trash/liquidfood,
/turf/simulated/floor/exoplanet/desert{
	temperature = 315.15
	},
/area/moghes_gawgaryn_bikers)
"E" = (
/turf/simulated/floor/exoplanet/tiled{
	temperature = 315.15
	},
/area/moghes_gawgaryn_bikers)
"H" = (
/turf/simulated/floor/exoplanet/tiled,
/area/moghes_gawgaryn_bikers)
"P" = (
/obj/structure/closet/crate/weapon,
/obj/item/material/sword/axe,
/obj/item/material/sword/longsword,
/obj/item/reagent_containers/food/drinks/waterbottle,
/obj/item/reagent_containers/food/drinks/waterbottle,
/obj/item/reagent_containers/food/snacks/liquidfood,
/obj/item/reagent_containers/food/snacks/liquidfood,
/obj/item/clothing/suit/armor/unathi,
/obj/item/clothing/suit/armor/unathi,
/obj/item/clothing/head/helmet/unathi,
/obj/item/clothing/head/helmet/unathi,
/obj/item/gun/projectile/automatic/tempestsmg,
/obj/item/ammo_magazine/tempestsmg,
/obj/item/ammo_magazine/crackrifle,
/obj/item/gun/projectile/shotgun/pump/rifle/magazine_fed/crackrifle,
/turf/simulated/floor/exoplanet/tiled{
	temperature = 315.15
	},
/area/moghes_gawgaryn_bikers)
"Q" = (
/obj/vehicle/bike/motor/sand,
/turf/simulated/floor/exoplanet/tiled,
/area/moghes_gawgaryn_bikers)
"R" = (
/obj/vehicle/bike/motor/sand,
/turf/simulated/floor/exoplanet/tiled{
	temperature = 315.15
	},
/area/moghes_gawgaryn_bikers)
"V" = (
/obj/vehicle/bike/motor/sand,
/turf/simulated/floor/exoplanet/desert{
	temperature = 315.15
	},
/area/moghes_gawgaryn_bikers)

(1,1,1) = {"
a
a
a
a
a
a
a
a
a
a
a
a
a
a
a
a
a
a
a
a
a
a
a
a
a
a
a
a
a
a
a
a
"}
(2,1,1) = {"
a
a
a
a
a
a
a
a
a
a
a
a
a
a
a
a
a
a
a
a
a
a
a
a
a
a
a
a
a
a
a
a
"}
(3,1,1) = {"
a
a
a
a
a
a
a
a
a
a
a
a
a
a
a
a
a
a
a
a
a
a
a
a
a
a
a
a
a
a
a
a
"}
(4,1,1) = {"
a
a
a
a
a
a
a
a
a
a
a
a
a
a
a
a
a
a
a
a
a
a
a
a
a
a
a
a
a
a
a
a
"}
(5,1,1) = {"
a
a
a
a
a
a
a
a
a
a
a
a
a
a
a
a
a
a
a
a
a
a
a
a
a
a
a
a
a
a
a
a
"}
(6,1,1) = {"
a
a
a
a
a
a
a
a
a
a
a
a
a
a
a
a
b
b
b
b
a
a
a
a
a
a
a
E
a
a
a
a
"}
(7,1,1) = {"
a
a
a
a
a
a
a
a
a
a
a
a
a
a
a
b
a
a
a
a
a
a
a
a
a
a
a
a
a
a
a
a
"}
(8,1,1) = {"
a
a
a
a
a
a
a
a
a
a
a
a
a
a
a
a
a
a
a
a
a
a
a
a
a
a
a
a
a
a
a
a
"}
(9,1,1) = {"
a
a
a
a
a
a
a
a
a
a
a
a
a
a
a
a
a
a
a
a
a
a
a
a
a
a
a
a
a
a
a
a
"}
(10,1,1) = {"
a
a
a
a
a
a
a
a
a
a
a
a
a
a
a
a
a
a
a
a
a
a
a
a
a
b
a
a
a
a
a
a
"}
(11,1,1) = {"
a
a
a
a
a
a
a
a
a
a
a
a
a
a
a
a
B
a
a
a
a
a
a
E
a
a
b
a
a
a
a
a
"}
(12,1,1) = {"
a
a
a
a
a
a
a
a
b
b
b
b
b
b
a
a
a
a
a
a
a
a
a
a
a
a
b
a
a
a
a
a
"}
(13,1,1) = {"
a
a
a
a
a
a
a
b
H
Q
V
R
V
a
a
n
a
a
a
a
a
a
a
a
a
E
b
a
a
a
a
a
"}
(14,1,1) = {"
a
a
a
a
a
a
a
b
a
E
a
a
E
a
a
a
a
a
h
a
a
E
a
a
a
a
b
a
a
a
a
a
"}
(15,1,1) = {"
a
a
a
a
a
a
a
b
E
a
a
E
a
a
p
a
z
a
a
a
a
a
a
a
E
a
a
b
a
a
a
a
"}
(16,1,1) = {"
a
a
a
a
a
a
a
b
a
E
a
a
a
a
a
a
a
a
h
a
a
a
E
a
E
a
a
b
a
a
a
a
"}
(17,1,1) = {"
a
a
a
a
a
a
a
b
a
a
E
a
a
E
a
a
h
a
a
a
a
a
a
a
a
a
a
b
a
a
a
a
"}
(18,1,1) = {"
a
a
a
a
a
a
a
a
b
b
a
a
a
P
a
a
a
E
a
a
a
a
a
a
a
a
a
b
a
a
a
a
"}
(19,1,1) = {"
a
a
a
a
a
a
a
a
a
a
b
b
b
a
a
a
a
E
a
E
E
a
E
E
a
a
b
a
a
a
a
a
"}
(20,1,1) = {"
a
a
a
a
a
a
a
a
a
a
a
a
a
b
a
a
a
a
a
a
E
a
E
E
a
a
b
a
a
a
a
a
"}
(21,1,1) = {"
a
a
a
a
a
a
a
a
a
a
a
a
a
a
a
a
a
a
a
a
a
a
a
a
E
a
b
a
a
a
a
a
"}
(22,1,1) = {"
a
a
a
a
a
a
a
a
a
a
a
a
a
a
a
a
a
a
a
a
a
a
a
a
a
a
b
a
a
a
a
a
"}
(23,1,1) = {"
a
a
a
a
a
a
a
a
a
a
a
a
a
a
a
a
a
a
a
a
E
a
a
a
a
b
a
a
a
a
a
a
"}
(24,1,1) = {"
a
a
a
a
a
a
a
a
a
a
a
a
a
b
a
a
a
a
a
a
a
a
a
a
b
a
a
a
a
a
a
a
"}
(25,1,1) = {"
a
a
a
a
a
a
a
a
a
a
a
a
a
a
a
E
a
a
a
a
a
a
a
b
a
a
a
a
a
a
a
a
"}
(26,1,1) = {"
a
a
a
a
a
a
a
a
a
a
a
a
a
a
a
a
a
a
a
a
a
a
a
a
a
a
a
a
a
a
a
a
"}
(27,1,1) = {"
a
a
a
a
a
a
a
a
a
a
a
a
a
a
a
a
a
a
a
a
a
a
a
a
a
a
a
a
a
a
a
a
"}
(28,1,1) = {"
a
a
a
a
a
a
a
a
a
a
a
a
a
a
a
a
a
a
a
a
a
a
a
a
a
a
a
a
a
a
a
a
"}
(29,1,1) = {"
a
a
a
a
a
a
a
a
a
a
a
a
a
a
a
a
a
a
a
a
a
a
a
b
a
a
a
a
a
a
a
a
"}
(30,1,1) = {"
a
a
a
a
a
a
a
a
a
a
a
a
a
a
a
a
a
a
a
a
a
a
a
a
a
a
a
a
a
a
a
a
"}
(31,1,1) = {"
a
a
a
a
a
a
a
a
a
a
a
a
a
a
a
a
a
a
a
a
a
a
a
a
a
a
a
a
a
a
a
a
"}
(32,1,1) = {"
a
a
a
a
a
a
a
a
a
a
a
a
a
a
a
a
a
a
a
a
a
a
a
a
a
a
a
a
a
a
a
a
"}
