//MAP CONVERTED BY dmm2tgm.py THIS HEADER COMMENT PREVENTS RECONVERSION, DO NOT REMOVE
"a" = (
/turf/simulated/floor/exoplanet/desert{
	temperature = 315.15
	},
/area/template_noop)
"h" = (
/obj/effect/landmark/scorcher,
/turf/simulated/floor/exoplanet/desert/rough{
	temperature = 315.15
	},
/area/template_noop)
"y" = (
/obj/effect/landmark/scorcher,
/obj/structure/sink/puddle,
/turf/simulated/floor/exoplanet/desert/rough{
	temperature = 315.15
	},
/area/template_noop)
"L" = (
/obj/effect/landmark/scorcher,
/obj/effect/decal/cleanable/greenglow/radioactive,
/turf/simulated/floor/exoplanet/desert/rough{
	temperature = 315.15
	},
/area/template_noop)
"S" = (
/obj/effect/decal/cleanable/greenglow/radioactive,
/turf/simulated/floor/exoplanet/desert/rough{
	temperature = 315.15
	},
/area/template_noop)
"X" = (
/turf/simulated/floor/exoplanet/desert/rough{
	temperature = 315.15
	},
/area/template_noop)
"Y" = (
/obj/effect/decal/cleanable/greenglow/radioactive,
/turf/simulated/floor/exoplanet/desert{
	temperature = 315.15
	},
/area/template_noop)

(1,1,1) = {"
a
a
a
a
a
a
a
a
a
a
a
a
a
a
a
a
a
a
a
a
a
a
a
a
a
"}
(2,1,1) = {"
a
a
a
a
a
a
a
a
a
a
a
a
a
a
a
a
a
a
a
a
a
a
a
a
a
"}
(3,1,1) = {"
a
a
a
a
a
a
a
a
a
a
a
a
a
a
a
a
a
a
a
a
a
a
a
a
a
"}
(4,1,1) = {"
a
a
a
a
a
a
a
a
a
a
a
a
a
a
a
a
a
a
a
a
a
a
a
a
a
"}
(5,1,1) = {"
a
a
a
a
a
a
a
a
a
a
a
a
a
a
a
Y
a
a
a
a
a
a
a
a
a
"}
(6,1,1) = {"
a
a
a
a
a
a
a
a
Y
a
a
a
a
a
a
a
a
a
a
a
a
a
a
a
a
"}
(7,1,1) = {"
a
a
a
Y
a
a
a
a
a
a
a
a
Y
a
a
a
a
a
a
a
a
a
a
a
a
"}
(8,1,1) = {"
a
a
a
a
a
a
X
X
X
X
S
X
a
a
a
a
a
a
a
a
a
a
a
a
a
"}
(9,1,1) = {"
a
a
a
a
a
Y
X
X
h
X
X
X
X
a
a
Y
a
a
a
a
a
a
a
a
a
"}
(10,1,1) = {"
a
a
a
a
a
X
X
S
X
h
X
S
h
X
a
a
a
a
a
a
a
a
a
a
a
"}
(11,1,1) = {"
a
a
Y
a
h
X
h
h
h
h
h
h
X
S
X
a
a
a
a
a
a
a
a
a
a
"}
(12,1,1) = {"
a
a
a
X
X
h
h
h
h
h
h
h
h
X
S
a
a
a
a
a
a
a
a
a
a
"}
(13,1,1) = {"
a
a
a
a
X
X
h
h
L
h
h
h
X
X
h
a
a
a
a
a
a
a
a
a
a
"}
(14,1,1) = {"
a
a
a
Y
X
h
h
h
h
y
h
h
h
X
S
X
a
a
a
a
a
a
a
a
a
"}
(15,1,1) = {"
a
a
a
a
X
h
h
h
h
h
h
h
X
X
S
a
a
a
a
a
a
a
a
a
a
"}
(16,1,1) = {"
a
a
a
a
h
X
h
h
h
h
h
h
X
X
S
a
a
a
a
a
a
a
a
a
a
"}
(17,1,1) = {"
a
a
a
X
a
X
X
h
X
h
X
h
h
a
a
a
a
a
a
a
a
a
a
a
a
"}
(18,1,1) = {"
a
a
a
a
a
Y
X
X
h
h
X
X
X
X
a
a
a
a
a
a
a
a
a
a
a
"}
(19,1,1) = {"
a
a
Y
a
a
a
X
X
X
X
X
X
Y
a
a
a
a
a
a
a
a
a
a
a
a
"}
(20,1,1) = {"
a
a
a
a
a
a
a
a
a
Y
a
a
a
a
a
a
a
a
a
a
a
a
a
a
a
"}
(21,1,1) = {"
a
a
a
a
a
a
a
Y
a
a
a
a
a
a
a
Y
a
a
a
a
a
a
a
a
a
"}
(22,1,1) = {"
a
a
a
a
a
a
a
a
a
a
a
a
Y
a
a
a
a
a
a
a
a
a
a
a
a
"}
(23,1,1) = {"
a
a
a
a
a
a
a
a
a
a
a
a
a
a
a
a
a
a
a
a
a
a
a
a
a
"}
(24,1,1) = {"
a
a
a
a
a
a
a
a
a
a
a
Y
a
a
a
a
a
a
a
a
a
a
a
a
a
"}
(25,1,1) = {"
a
a
a
a
a
a
a
a
a
a
a
a
a
a
a
a
a
a
a
a
a
a
a
a
a
"}
