//MAP CONVERTED BY dmm2tgm.py THIS HEADER COMMENT PREVENTS RECONVERSION, DO NOT REMOVE
"a" = (
/turf/simulated/floor/exoplanet/desert{
	temperature = 315.15
	},
/area/exoplanet/moghes)
"c" = (
/obj/effect/landmark/corpse/moghes_dead_guwandi,
/obj/effect/decal/cleanable/blood/splatter,
/turf/simulated/floor/exoplanet/desert{
	temperature = 315.15
	},
/area/exoplanet/moghes)
"g" = (
/obj/effect/decal/cleanable/blood/splatter,
/obj/effect/landmark/corpse/moghes_dead_raider,
/obj/random/civgun,
/turf/simulated/floor/exoplanet/desert{
	temperature = 315.15
	},
/area/exoplanet/moghes)
"C" = (
/obj/effect/decal/cleanable/blood/splatter,
/obj/effect/landmark/corpse/moghes_dead_raider,
/obj/random/civgun/rifle,
/turf/simulated/floor/exoplanet/desert{
	temperature = 315.15
	},
/area/exoplanet/moghes)
"I" = (
/obj/item/paper/fluff/guwandi,
/turf/simulated/floor/exoplanet/desert{
	temperature = 315.15
	},
/area/exoplanet/moghes)
"J" = (
/obj/effect/decal/cleanable/blood/splatter,
/obj/effect/landmark/corpse/moghes_dead_raider,
/turf/simulated/floor/exoplanet/desert{
	temperature = 315.15
	},
/area/exoplanet/moghes)
"L" = (
/obj/structure/bonfire,
/turf/simulated/floor/exoplanet/desert{
	temperature = 315.15
	},
/area/exoplanet/moghes)
"M" = (
/obj/effect/decal/cleanable/blood/splatter,
/turf/simulated/floor/exoplanet/desert{
	temperature = 315.15
	},
/area/exoplanet/moghes)

(1,1,1) = {"
a
a
a
a
a
a
a
a
a
a
a
a
a
a
a
"}
(2,1,1) = {"
a
a
a
a
a
a
g
a
a
a
a
a
a
a
a
"}
(3,1,1) = {"
a
M
a
M
a
a
a
a
M
a
J
a
a
C
a
"}
(4,1,1) = {"
a
a
a
a
a
M
a
a
a
a
a
a
a
a
a
"}
(5,1,1) = {"
a
a
a
a
a
a
a
a
a
J
a
a
M
a
a
"}
(6,1,1) = {"
a
a
a
a
a
a
a
a
a
a
a
a
a
a
a
"}
(7,1,1) = {"
a
a
a
a
a
M
I
M
a
a
a
a
a
a
a
"}
(8,1,1) = {"
a
C
a
a
a
a
L
c
a
a
a
a
a
a
a
"}
(9,1,1) = {"
a
a
a
a
a
M
a
a
M
a
a
a
a
a
M
"}
(10,1,1) = {"
a
a
a
a
a
a
a
a
a
a
a
M
a
a
a
"}
(11,1,1) = {"
a
a
M
a
a
a
a
a
a
a
a
a
a
a
a
"}
(12,1,1) = {"
a
a
a
a
M
a
J
a
a
a
a
a
a
a
a
"}
(13,1,1) = {"
a
a
g
a
a
a
a
a
M
a
J
a
a
a
a
"}
(14,1,1) = {"
a
a
a
a
a
a
a
a
a
a
a
a
a
g
a
"}
(15,1,1) = {"
a
a
a
a
a
a
a
a
a
a
a
a
a
a
a
"}
