//MAP CONVERTED BY dmm2tgm.py THIS HEADER COMMENT PREVENTS RECONVERSION, DO NOT REMOVE
"a" = (
/turf/simulated/floor/exoplanet/desert{
	temperature = 315.15
	},
/area/template_noop)
"f" = (
/turf/simulated/floor/exoplanet/desert/rough{
	temperature = 315.15
	},
/area/template_noop)
"C" = (
/obj/effect/landmark/scorcher,
/obj/effect/decal/cleanable/greenglow/radioactive,
/turf/simulated/floor/exoplanet/desert/rough{
	temperature = 315.15
	},
/area/template_noop)
"J" = (
/obj/effect/landmark/scorcher,
/obj/structure/undetonated_nuke/buried,
/turf/simulated/floor/exoplanet/desert/rough{
	temperature = 315.15
	},
/area/template_noop)
"T" = (
/obj/effect/landmark/scorcher,
/turf/simulated/floor/exoplanet/desert/rough{
	temperature = 315.15
	},
/area/template_noop)

(1,1,1) = {"
a
a
a
a
a
a
a
a
a
a
a
a
a
a
a
"}
(2,1,1) = {"
a
a
a
a
a
a
a
a
a
a
a
a
a
a
a
"}
(3,1,1) = {"
a
a
a
a
a
a
a
a
a
a
a
a
a
a
a
"}
(4,1,1) = {"
a
a
a
a
a
a
a
a
a
a
a
a
a
a
a
"}
(5,1,1) = {"
a
a
a
a
f
f
f
f
f
f
a
a
a
a
a
"}
(6,1,1) = {"
a
a
a
a
f
f
T
f
f
f
f
a
a
a
a
"}
(7,1,1) = {"
a
a
a
f
f
f
f
T
f
f
C
f
a
a
a
"}
(8,1,1) = {"
a
a
T
f
C
T
T
T
T
T
f
f
f
a
a
"}
(9,1,1) = {"
a
f
f
T
T
T
T
T
T
T
T
f
f
a
a
"}
(10,1,1) = {"
a
a
f
f
T
T
T
C
T
T
f
f
T
a
a
"}
(11,1,1) = {"
a
a
f
T
T
T
J
T
T
T
T
f
f
f
a
"}
(12,1,1) = {"
a
a
f
T
T
T
T
T
T
T
f
f
f
a
a
"}
(13,1,1) = {"
a
a
T
f
C
T
T
T
T
T
f
f
f
a
a
"}
(14,1,1) = {"
a
f
a
f
f
T
f
T
f
T
C
a
a
a
a
"}
(15,1,1) = {"
a
a
a
a
f
f
T
T
f
f
f
f
a
a
a
"}
(16,1,1) = {"
a
a
a
a
f
f
f
f
f
f
a
a
a
a
a
"}
(17,1,1) = {"
a
a
a
a
a
a
a
a
a
a
a
a
a
a
a
"}
(18,1,1) = {"
a
a
a
a
a
a
a
a
a
a
a
a
a
a
a
"}
(19,1,1) = {"
a
a
a
a
a
a
a
a
a
a
a
a
a
a
a
"}
(20,1,1) = {"
a
a
a
a
a
a
a
a
a
a
a
a
a
a
a
"}
(21,1,1) = {"
a
a
a
a
a
a
a
a
a
a
a
a
a
a
a
"}
