//MAP CONVERTED BY dmm2tgm.py THIS HEADER COMMENT PREVENTS RECONVERSION, DO NOT REMOVE
"a" = (
/turf/template_noop,
/area/space)
"c" = (
/obj/effect/floor_decal/industrial/outline/operations,
/obj/machinery/button/remote/blast_door{
	dir = 4;
	pixel_x = 22;
	name = "Cargo Hold #1 Shutters";
	id = "lone_spacer_cargo1";
	pixel_y = -1
	},
/obj/structure/closet/crate/loot,
/turf/simulated/floor/tiled/dark/full,
/area/space)
"g" = (
/obj/effect/floor_decal/industrial/outline/operations,
/turf/simulated/floor/tiled/dark/full,
/area/space)
"h" = (
/obj/effect/floor_decal/industrial/outline/operations,
/obj/machinery/light/small{
	dir = 8
	},
/obj/structure/closet/crate/loot,
/turf/simulated/floor/tiled/dark/full,
/area/space)
"i" = (
/obj/effect/floor_decal/industrial/outline/operations,
/obj/item/storage/box/fancy/vials{
	pixel_x = -4;
	pixel_y = 13
	},
/obj/structure/table/rack/folding_table,
/obj/item/clothing/glasses/safety/goggles{
	pixel_x = -1;
	pixel_y = -2
	},
/turf/simulated/floor/tiled/dark/full,
/area/space)
"j" = (
/obj/effect/floor_decal/industrial/outline/operations,
/obj/machinery/button/remote/blast_door{
	dir = 8;
	pixel_x = -22;
	name = "Cargo Hold #3 Shutters";
	id = "lone_spacer_cargo4";
	pixel_y = -1
	},
/turf/simulated/floor/tiled/dark/full,
/area/space)
"k" = (
/obj/effect/floor_decal/industrial/outline/operations,
/obj/machinery/light/small{
	dir = 4
	},
/turf/simulated/floor/tiled/dark/full,
/area/space)
"l" = (
/turf/simulated/floor/tiled/dark/full,
/area/space)
"m" = (
/obj/effect/floor_decal/industrial/outline/operations,
/obj/machinery/light/small{
	dir = 4
	},
/obj/machinery/chemical_dispenser/full{
	dir = 1
	},
/turf/simulated/floor/tiled/dark/full,
/area/space)
"q" = (
/obj/effect/floor_decal/industrial/outline/operations,
/obj/structure/closet/crate/loot,
/turf/simulated/floor/tiled/dark/full,
/area/space)
"x" = (
/obj/structure/bed/stool/chair/office/light{
	dir = 1
	},
/turf/simulated/floor/tiled/dark/full,
/area/space)
"y" = (
/obj/effect/floor_decal/industrial/outline/operations,
/obj/machinery/reagentgrinder{
	pixel_y = 17;
	pixel_x = 6
	},
/obj/structure/table/rack/folding_table,
/obj/item/reagent_containers/glass/beaker/large{
	pixel_y = 4;
	pixel_x = -2
	},
/turf/simulated/floor/tiled/dark/full,
/area/space)
"z" = (
/obj/effect/floor_decal/industrial/outline/operations,
/obj/machinery/light/small{
	dir = 8
	},
/turf/simulated/floor/tiled/dark/full,
/area/space)
"A" = (
/obj/machinery/chem_heater,
/turf/simulated/floor/tiled/dark/full,
/area/space)
"F" = (
/obj/effect/floor_decal/industrial/outline/operations,
/obj/machinery/button/remote/blast_door{
	dir = 4;
	pixel_x = 22;
	name = "Cargo Hold #1 Shutters";
	id = "lone_spacer_cargo1";
	pixel_y = -1
	},
/turf/simulated/floor/tiled/dark/full,
/area/space)
"G" = (
/obj/effect/floor_decal/industrial/outline/operations,
/obj/item/cargo_package/offship/to_horizon{
	pixel_y = 10;
	pixel_x = -1
	},
/obj/item/cargo_package/offship{
	pixel_y = -2;
	pixel_x = 1
	},
/turf/simulated/floor/tiled/dark/full,
/area/space)
"I" = (
/obj/effect/floor_decal/industrial/outline/operations,
/obj/machinery/button/remote/blast_door{
	dir = 8;
	pixel_x = -22;
	name = "Cargo Hold #3 Shutters";
	id = "lone_spacer_cargo4";
	pixel_y = -1
	},
/obj/machinery/chem_master,
/turf/simulated/floor/tiled/dark/full,
/area/space)
"J" = (
/obj/effect/floor_decal/industrial/outline/operations,
/obj/structure/closet/crate/drop,
/obj/item/device/assembly/timer,
/obj/item/device/assembly/timer,
/obj/item/device/assembly/timer,
/obj/item/device/assembly/timer,
/obj/item/device/assembly/igniter,
/obj/item/device/assembly/igniter,
/obj/item/device/assembly/igniter,
/obj/item/device/assembly/igniter,
/obj/item/grenade/chem_grenade,
/obj/item/grenade/chem_grenade,
/obj/item/grenade/chem_grenade,
/obj/item/grenade/chem_grenade,
/turf/simulated/floor/tiled/dark/full,
/area/space)
"Z" = (
/obj/effect/floor_decal/industrial/outline/operations,
/obj/machinery/light/small{
	dir = 4
	},
/obj/structure/closet/crate/drop/grey,
/obj/item/reagent_containers/dropper/electronic_pipette,
/obj/item/stack/material/phoron{
	amount = 15
	},
/turf/simulated/floor/tiled/dark/full,
/area/space)

(1,1,1) = {"
a
a
a
a
a
a
a
a
a
a
a
a
a
a
a
a
a
a
a
a
a
a
a
a
a
a
"}
(2,1,1) = {"
a
a
a
a
a
a
a
a
a
a
a
a
a
a
a
a
a
a
a
a
a
a
a
a
a
a
"}
(3,1,1) = {"
a
a
h
l
l
h
a
a
z
l
l
z
a
a
z
l
l
z
a
a
z
l
l
z
a
a
"}
(4,1,1) = {"
a
a
q
l
l
q
a
a
g
l
l
g
a
a
g
l
l
g
a
a
g
l
l
g
a
a
"}
(5,1,1) = {"
a
a
c
l
l
G
a
a
F
l
l
g
a
a
F
l
l
g
a
a
F
l
l
g
a
a
"}
(6,1,1) = {"
a
a
a
a
a
a
a
a
a
a
a
a
a
a
a
a
a
a
a
a
a
a
a
a
a
a
"}
(7,1,1) = {"
a
a
a
a
a
a
a
a
a
a
a
a
a
a
a
a
a
a
a
a
a
a
a
a
a
a
"}
(8,1,1) = {"
a
a
I
l
l
y
a
a
j
l
l
g
a
a
j
l
l
g
a
a
j
l
l
g
a
a
"}
(9,1,1) = {"
a
a
i
x
l
J
a
a
g
l
l
g
a
a
g
l
l
g
a
a
g
l
l
g
a
a
"}
(10,1,1) = {"
a
a
m
A
l
Z
a
a
k
l
l
k
a
a
k
l
l
k
a
a
k
l
l
k
a
a
"}
(11,1,1) = {"
a
a
a
a
a
a
a
a
a
a
a
a
a
a
a
a
a
a
a
a
a
a
a
a
a
a
"}
(12,1,1) = {"
a
a
a
a
a
a
a
a
a
a
a
a
a
a
a
a
a
a
a
a
a
a
a
a
a
a
"}
