//MAP CONVERTED BY dmm2tgm.py THIS HEADER COMMENT PREVENTS RECONVERSION, DO NOT REMOVE
"b" = (
/obj/effect/landmark/clear,
/turf/template_noop,
/area/exoplanet/barren/asteroid)
"c" = (
/turf/simulated/mineral,
/area/exoplanet/barren/asteroid)
"d" = (
/obj/random/junk,
/obj/effect/landmark/clear,
/turf/template_noop,
/area/exoplanet/barren/asteroid)
"e" = (
/mob/living/simple_animal/hostile/carp/asteroid,
/obj/effect/landmark/clear,
/turf/template_noop,
/area/exoplanet/barren/asteroid)
"f" = (
/obj/random/coin,
/obj/effect/landmark/clear,
/turf/template_noop,
/area/exoplanet/barren/asteroid)
"g" = (
/obj/random/loot,
/obj/effect/landmark/clear,
/turf/template_noop,
/area/exoplanet/barren/asteroid)
"h" = (
/obj/structure/closet/crate/secure/loot,
/obj/effect/landmark/clear,
/turf/template_noop,
/area/exoplanet/barren/asteroid)
"i" = (
/obj/random/powercell,
/obj/effect/landmark/clear,
/turf/template_noop,
/area/exoplanet/barren/asteroid)
"j" = (
/obj/item/device/flashlight/lantern{
	on = 1
	},
/obj/effect/landmark/clear,
/turf/template_noop,
/area/exoplanet/barren/asteroid)
"k" = (
/obj/item/clothing/head/helmet/space/void/mining,
/obj/effect/landmark/clear,
/turf/template_noop,
/area/exoplanet/barren/asteroid)
"l" = (
/turf/simulated/mineral/random/high_chance,
/area/exoplanet/barren/asteroid)
"m" = (
/obj/effect/decal/cleanable/blood/splatter,
/obj/effect/decal/remains,
/obj/effect/landmark/clear,
/turf/template_noop,
/area/exoplanet/barren/asteroid)
"n" = (
/obj/item/pickaxe/gold,
/obj/effect/landmark/clear,
/turf/template_noop,
/area/exoplanet/barren/asteroid)
"o" = (
/obj/random/medical,
/obj/effect/landmark/clear,
/turf/template_noop,
/area/exoplanet/barren/asteroid)
"p" = (
/obj/random/plushie,
/obj/effect/landmark/clear,
/turf/template_noop,
/area/exoplanet/barren/asteroid)
"q" = (
/obj/effect/decal/remains/rat,
/obj/effect/landmark/clear,
/turf/template_noop,
/area/exoplanet/barren/asteroid)
"r" = (
/obj/random/spacecash,
/obj/effect/landmark/clear,
/turf/template_noop,
/area/exoplanet/barren/asteroid)
"B" = (
/turf/template_noop,
/area/exoplanet/barren/asteroid)

(1,1,1) = {"
B
B
B
B
B
B
B
B
B
B
B
B
B
B
B
B
B
B
B
B
B
B
B
B
B
B
B
B
B
B
B
B
"}
(2,1,1) = {"
B
B
B
B
B
B
B
c
c
c
B
B
B
B
B
B
B
B
B
B
B
B
B
B
B
B
B
B
B
B
B
B
"}
(3,1,1) = {"
B
B
c
c
c
c
c
c
c
c
c
c
B
B
B
B
B
B
B
B
B
B
B
B
B
c
c
c
B
B
B
B
"}
(4,1,1) = {"
B
c
c
c
c
c
c
c
c
c
c
c
c
B
B
B
B
B
B
B
B
B
B
B
B
c
c
c
c
c
B
B
"}
(5,1,1) = {"
c
c
c
b
b
b
b
b
b
b
b
c
c
c
c
B
B
B
B
B
B
B
c
c
c
c
c
c
c
c
B
B
"}
(6,1,1) = {"
c
c
c
b
c
c
c
c
c
c
b
b
c
c
c
c
B
B
B
B
B
B
c
c
c
c
c
c
c
c
c
c
"}
(7,1,1) = {"
c
c
c
b
c
c
c
c
c
c
c
b
b
c
c
c
B
B
B
B
c
c
c
c
c
e
b
b
b
r
c
c
"}
(8,1,1) = {"
c
c
c
b
c
c
c
c
c
c
c
b
g
c
c
c
c
c
c
c
c
c
c
c
c
b
h
b
e
b
c
c
"}
(9,1,1) = {"
b
b
b
d
b
b
b
b
b
c
c
c
b
c
c
c
c
c
c
c
c
c
c
c
c
d
b
q
b
b
b
b
"}
(10,1,1) = {"
c
c
c
c
c
c
c
b
b
c
c
c
b
c
c
c
c
c
c
c
c
c
c
c
c
b
c
c
c
c
c
c
"}
(11,1,1) = {"
B
c
c
b
b
e
c
b
b
b
b
b
b
c
c
c
c
c
c
c
c
c
c
b
c
b
c
b
b
b
c
B
"}
(12,1,1) = {"
B
c
b
b
c
c
c
c
c
c
b
b
b
c
c
c
c
c
c
c
c
c
c
b
b
b
b
b
c
b
c
B
"}
(13,1,1) = {"
B
c
b
c
c
c
c
c
c
c
b
b
c
c
c
c
c
c
c
c
c
c
c
b
c
c
c
c
c
b
c
c
"}
(14,1,1) = {"
B
c
b
c
c
b
b
b
b
c
b
b
b
b
b
b
l
l
l
c
c
c
c
b
c
c
c
c
c
b
c
c
"}
(15,1,1) = {"
c
c
b
c
c
b
c
c
b
c
c
c
c
c
e
k
b
b
e
c
c
b
b
b
c
b
c
c
c
b
b
c
"}
(16,1,1) = {"
c
c
b
c
c
b
b
c
b
c
c
c
c
c
b
b
m
b
n
b
b
b
c
c
c
e
c
c
c
c
b
c
"}
(17,1,1) = {"
b
b
b
b
b
b
g
c
b
b
b
b
c
b
j
b
b
h
b
c
c
c
c
c
c
b
b
c
c
c
b
b
"}
(18,1,1) = {"
b
c
c
c
c
b
e
c
c
c
c
b
b
b
c
b
e
b
d
c
c
c
c
c
p
b
d
c
c
c
c
b
"}
(19,1,1) = {"
b
b
b
c
c
b
h
c
c
c
c
c
c
c
c
c
c
c
c
c
c
c
c
c
b
b
b
c
c
c
c
b
"}
(20,1,1) = {"
c
c
b
c
c
c
c
c
c
c
c
c
c
b
b
b
c
c
b
b
c
c
c
c
b
b
e
h
c
c
c
b
"}
(21,1,1) = {"
c
c
b
b
b
e
b
b
i
e
c
h
b
b
b
d
b
b
b
b
c
c
c
c
b
c
c
c
c
c
c
b
"}
(22,1,1) = {"
c
c
c
c
c
b
c
c
c
c
c
b
b
b
e
c
c
c
c
b
c
c
c
c
b
b
b
b
c
c
c
b
"}
(23,1,1) = {"
B
c
c
c
c
b
c
c
c
c
c
c
c
c
c
c
c
c
c
b
c
c
c
c
b
c
c
c
b
c
c
b
"}
(24,1,1) = {"
B
c
c
c
c
f
c
c
c
c
c
c
c
c
c
c
c
c
c
b
c
h
e
c
b
c
c
c
b
c
c
b
"}
(25,1,1) = {"
B
c
c
c
c
c
c
c
c
c
c
c
c
c
c
c
c
c
c
b
c
b
b
b
b
c
c
c
b
b
b
b
"}
(26,1,1) = {"
B
B
B
c
c
c
c
B
c
c
c
c
c
c
c
c
c
c
c
b
c
o
b
b
b
c
c
c
c
c
c
B
"}
(27,1,1) = {"
B
B
B
B
B
B
B
B
B
B
c
c
c
c
c
c
c
c
c
b
c
b
b
b
d
c
c
c
c
c
B
B
"}
(28,1,1) = {"
B
B
B
B
B
B
B
B
B
B
B
c
c
c
c
c
c
c
c
b
c
b
e
b
b
c
c
c
c
c
B
B
"}
(29,1,1) = {"
B
B
B
B
B
B
B
B
B
B
B
B
B
c
c
c
c
c
b
b
c
c
c
c
c
c
c
c
c
B
B
B
"}
(30,1,1) = {"
B
B
B
B
B
B
B
B
B
B
B
B
B
B
c
c
c
c
b
b
c
c
c
c
c
B
B
B
B
B
B
B
"}
(31,1,1) = {"
B
B
B
B
B
B
B
B
B
B
B
B
B
B
B
B
c
c
b
b
c
c
c
c
B
B
B
B
B
B
B
B
"}
(32,1,1) = {"
B
B
B
B
B
B
B
B
B
B
B
B
B
B
B
B
c
c
b
b
c
c
c
c
B
B
B
B
B
B
B
B
"}
