//MAP CONVERTED BY dmm2tgm.py THIS HEADER COMMENT PREVENTS RECONVERSION, DO NOT REMOVE
"a" = (
/obj/effect/landmark/clear,
/obj/structure/sign/flag/coalition,
/turf/template_noop,
/area/template_noop)
"l" = (
/obj/effect/landmark/clear,
/turf/template_noop,
/area/template_noop)
"p" = (
/obj/effect/landmark/clear,
/obj/structure/survey_probe/coc{
	start_deployed = 1
	},
/turf/template_noop,
/area/template_noop)

(1,1,1) = {"
l
l
l
"}
(2,1,1) = {"
a
p
l
"}
(3,1,1) = {"
l
l
l
"}
