//MAP CONVERTED BY dmm2tgm.py THIS HEADER COMMENT PREVENTS RECONVERSION, DO NOT REMOVE
"a" = (
/obj/effect/landmark/clear,
/turf/template_noop,
/area/template_noop)
"s" = (
/obj/effect/landmark/clear,
/obj/structure/sign/flag/elyra,
/turf/template_noop,
/area/template_noop)
"G" = (
/obj/effect/landmark/clear,
/obj/structure/survey_probe/elyra{
	start_deployed = 1
	},
/turf/template_noop,
/area/template_noop)

(1,1,1) = {"
a
a
a
"}
(2,1,1) = {"
s
G
a
"}
(3,1,1) = {"
a
a
a
"}
