//MAP CONVERTED BY dmm2tgm.py THIS HEADER COMMENT PREVENTS RECONVERSION, DO NOT REMOVE
"a" = (
/turf/simulated/mineral/random,
/area/template_noop)
"b" = (
/obj/structure/bed/stool/chair/shuttle{
	dir = 1
	},
/turf/simulated/floor/shuttle/dark_blue{
	oxygen = 0;
	nitrogen = 0
	},
/area/template_noop)
"c" = (
/obj/structure/window/shuttle/unique/escape_pod{
	icon_state = "1,3"
	},
/obj/structure/grille,
/turf/simulated/floor/plating,
/area/template_noop)
"d" = (
/obj/effect/landmark/clear,
/obj/effect/landmark/clear,
/turf/template_noop,
/area/template_noop)
"e" = (
/obj/structure/door_assembly/door_assembly_ext{
	anchored = 1
	},
/turf/simulated/floor/shuttle/dark_blue{
	oxygen = 0;
	nitrogen = 0
	},
/area/template_noop)
"f" = (
/turf/simulated/wall/shuttle/unique/escape_pod{
	icon_state = "2,1"
	},
/area/template_noop)
"g" = (
/obj/structure/shuttle_part/escape_pod{
	icon_state = "0,3"
	},
/turf/unsimulated/floor/asteroid/ash/rocky,
/area/template_noop)
"h" = (
/turf/template_noop,
/area/template_noop)
"i" = (
/obj/effect/landmark/clear,
/turf/template_noop,
/area/template_noop)
"j" = (
/turf/simulated/wall/shuttle/unique/escape_pod{
	icon_state = "0,2"
	},
/area/template_noop)
"k" = (
/mob/living/simple_animal/hostile/carp/shark,
/turf/unsimulated/floor/asteroid/ash/rocky,
/area/template_noop)
"l" = (
/turf/unsimulated/floor/asteroid/ash/rocky,
/area/template_noop)
"n" = (
/turf/simulated/wall/shuttle/unique/escape_pod{
	icon_state = "2,0"
	},
/area/template_noop)
"t" = (
/turf/simulated/wall/shuttle/unique/escape_pod{
	icon_state = "0,1"
	},
/area/template_noop)
"x" = (
/turf/simulated/wall/shuttle/unique/escape_pod{
	icon_state = "0,0"
	},
/area/template_noop)
"z" = (
/obj/structure/closet/crate/secure/loot,
/turf/unsimulated/floor/asteroid/ash/rocky,
/area/template_noop)
"D" = (
/obj/effect/decal/remains/human,
/obj/random/voidsuit,
/obj/random/energy_antag,
/obj/random/smalltank,
/obj/item/device/gps,
/obj/item/archaeological_find,
/turf/simulated/floor/shuttle/dark_blue{
	oxygen = 0;
	nitrogen = 0
	},
/area/template_noop)
"R" = (
/turf/simulated/wall/shuttle/unique/escape_pod{
	icon_state = "2,2"
	},
/area/template_noop)
"Z" = (
/obj/structure/shuttle_part/escape_pod{
	icon_state = "2,3"
	},
/turf/unsimulated/floor/asteroid/ash/rocky,
/area/template_noop)

(1,1,1) = {"
h
h
h
a
a
a
h
h
h
h
h
h
h
h
h
"}
(2,1,1) = {"
h
h
a
a
a
a
a
a
i
i
i
i
i
h
h
"}
(3,1,1) = {"
a
a
a
a
a
a
a
a
a
i
i
i
i
i
h
"}
(4,1,1) = {"
a
a
a
a
l
g
j
t
x
l
i
i
i
i
i
"}
(5,1,1) = {"
a
l
z
l
k
c
D
b
e
l
i
i
i
i
i
"}
(6,1,1) = {"
a
a
a
a
l
Z
R
f
n
l
i
i
i
i
i
"}
(7,1,1) = {"
a
a
a
a
a
a
a
a
a
d
d
d
i
i
i
"}
(8,1,1) = {"
h
a
a
a
a
a
a
a
i
i
i
i
i
h
h
"}
(9,1,1) = {"
h
h
h
h
h
a
a
a
h
h
h
h
h
h
h
"}
(10,1,1) = {"
h
h
h
h
h
h
h
h
h
h
h
h
h
h
h
"}
