//MAP CONVERTED BY dmm2tgm.py THIS HEADER COMMENT PREVENTS RECONVERSION, DO NOT REMOVE
"a" = (
/turf/simulated/mineral,
/area/template_noop)
"b" = (
/turf/template_noop,
/area/template_noop)
"c" = (
/obj/structure/lattice,
/turf/unsimulated/floor/asteroid/ash/rocky,
/area/template_noop)
"d" = (
/obj/structure/lattice,
/obj/effect/decal/cleanable/liquid_fuel,
/obj/effect/decal/cleanable/liquid_fuel,
/obj/item/solar_assembly,
/obj/item/material/shard,
/turf/unsimulated/floor/asteroid/ash/rocky,
/area/template_noop)
"e" = (
/obj/structure/girder,
/turf/unsimulated/floor/asteroid/ash/rocky,
/area/dungeon/crashed_satellite)
"f" = (
/obj/effect/decal/cleanable/liquid_fuel,
/obj/machinery/power/smes/batteryrack,
/turf/simulated/floor/airless,
/area/dungeon/crashed_satellite)
"g" = (
/obj/effect/decal/cleanable/liquid_fuel,
/obj/effect/decal/cleanable/liquid_fuel,
/obj/effect/decal/cleanable/liquid_fuel,
/turf/unsimulated/floor/asteroid/ash/rocky,
/area/template_noop)
"h" = (
/obj/effect/decal/cleanable/liquid_fuel,
/obj/structure/computerframe,
/obj/item/material/shard,
/turf/simulated/floor/airless,
/area/dungeon/crashed_satellite)
"i" = (
/obj/effect/decal/cleanable/liquid_fuel,
/obj/structure/computerframe{
	},
/obj/item/device/gps,
/obj/item/material/shard,
/turf/simulated/floor/airless,
/area/dungeon/crashed_satellite)
"j" = (
/obj/effect/decal/cleanable/liquid_fuel,
/obj/random/tool,
/turf/simulated/floor/airless,
/area/dungeon/crashed_satellite)
"k" = (
/obj/effect/decal/cleanable/liquid_fuel,
/obj/effect/decal/cleanable/blood/oil,
/turf/simulated/floor/airless,
/area/dungeon/crashed_satellite)
"l" = (
/obj/structure/lattice,
/obj/effect/decal/cleanable/liquid_fuel,
/obj/item/stack/cable_coil/cut,
/turf/unsimulated/floor/asteroid/ash/rocky,
/area/template_noop)
"m" = (
/obj/item/material/shard,
/turf/unsimulated/floor/asteroid/ash/rocky,
/area/template_noop)
"n" = (
/obj/item/stack/material/steel,
/obj/effect/decal/cleanable/liquid_fuel,
/obj/effect/decal/cleanable/ash,
/turf/unsimulated/floor/asteroid/ash/rocky,
/area/template_noop)
"o" = (
/obj/effect/decal/cleanable/liquid_fuel,
/obj/effect/decal/cleanable/blood/oil,
/turf/unsimulated/floor/asteroid/ash/rocky,
/area/template_noop)
"p" = (
/obj/item/stack/material/steel,
/turf/unsimulated/floor/asteroid/ash/rocky,
/area/template_noop)
"q" = (
/obj/effect/decal/cleanable/liquid_fuel,
/turf/unsimulated/floor/asteroid/ash/rocky,
/area/template_noop)
"r" = (
/mob/living/simple_animal/hostile/carp,
/turf/unsimulated/floor/asteroid/ash/rocky,
/area/template_noop)
"s" = (
/obj/effect/decal/cleanable/liquid_fuel,
/obj/random/junk,
/turf/simulated/floor/airless,
/area/dungeon/crashed_satellite)
"t" = (
/obj/structure/lattice,
/obj/item/stack/cable_coil/cut,
/turf/unsimulated/floor/asteroid/ash/rocky,
/area/template_noop)
"u" = (
/obj/effect/decal/cleanable/liquid_fuel,
/obj/effect/decal/cleanable/liquid_fuel,
/obj/effect/decal/cleanable/blood/oil,
/turf/unsimulated/floor/asteroid/ash/rocky,
/area/template_noop)
"v" = (
/obj/random/loot,
/turf/unsimulated/floor/asteroid/ash/rocky,
/area/template_noop)
"w" = (
/obj/item/stack/material/steel,
/obj/effect/decal/cleanable/liquid_fuel,
/obj/effect/decal/cleanable/liquid_fuel,
/turf/unsimulated/floor/asteroid/ash/rocky,
/area/template_noop)
"x" = (
/turf/unsimulated/floor/asteroid/ash/rocky,
/area/template_noop)
"y" = (
/obj/effect/decal/remains/robot,
/turf/unsimulated/floor/asteroid/ash/rocky,
/area/template_noop)
"z" = (
/obj/item/arrow/rod,
/turf/unsimulated/floor/asteroid/ash/rocky,
/area/template_noop)
"A" = (
/obj/effect/decal/remains/robot,
/obj/effect/decal/cleanable/liquid_fuel,
/turf/unsimulated/floor/asteroid/ash/rocky,
/area/template_noop)
"B" = (
/obj/item/arrow/rod,
/obj/effect/decal/cleanable/liquid_fuel,
/turf/unsimulated/floor/asteroid/ash/rocky,
/area/template_noop)
"C" = (
/obj/item/arrow/rod,
/obj/effect/decal/cleanable/liquid_fuel,
/obj/effect/decal/cleanable/liquid_fuel,
/obj/effect/decal/cleanable/liquid_fuel,
/turf/unsimulated/floor/asteroid/ash/rocky,
/area/template_noop)
"D" = (
/obj/effect/decal/cleanable/liquid_fuel,
/obj/effect/decal/cleanable/liquid_fuel,
/obj/random/junk,
/turf/unsimulated/floor/asteroid/ash/rocky,
/area/template_noop)
"E" = (
/turf/simulated/wall/shuttle/dark,
/area/dungeon/crashed_satellite)
"F" = (
/obj/effect/decal/cleanable/liquid_fuel,
/obj/random/junk,
/turf/unsimulated/floor/asteroid/ash/rocky,
/area/template_noop)
"G" = (
/obj/structure/lattice,
/obj/item/stack/material/steel,
/obj/effect/decal/cleanable/liquid_fuel,
/turf/unsimulated/floor/asteroid/ash/rocky,
/area/template_noop)
"H" = (
/obj/effect/decal/cleanable/liquid_fuel,
/obj/effect/decal/cleanable/blood/oil,
/obj/item/bluespace_crystal,
/turf/simulated/floor/airless,
/area/dungeon/crashed_satellite)
"I" = (
/obj/effect/decal/cleanable/liquid_fuel,
/obj/item/bluespace_crystal,
/turf/simulated/floor/airless,
/area/dungeon/crashed_satellite)
"J" = (
/obj/effect/decal/cleanable/liquid_fuel,
/obj/effect/decal/cleanable/liquid_fuel,
/turf/unsimulated/floor/asteroid/ash/rocky,
/area/template_noop)
"K" = (
/obj/effect/decal/cleanable/liquid_fuel,
/obj/effect/decal/cleanable/ash,
/turf/unsimulated/floor/asteroid/ash/rocky,
/area/template_noop)
"L" = (
/obj/structure/lattice,
/obj/effect/decal/cleanable/liquid_fuel,
/obj/effect/decal/cleanable/ash,
/turf/unsimulated/floor/asteroid/ash/rocky,
/area/template_noop)
"M" = (
/obj/structure/lattice,
/obj/item/solar_assembly,
/turf/unsimulated/floor/asteroid/ash/rocky,
/area/template_noop)
"N" = (
/obj/structure/girder,
/turf/unsimulated/floor/asteroid/ash/rocky,
/area/template_noop)
"O" = (
/obj/random/tool,
/turf/unsimulated/floor/asteroid/ash/rocky,
/area/template_noop)
"P" = (
/obj/effect/decal/cleanable/liquid_fuel,
/obj/effect/decal/cleanable/ash,
/obj/effect/decal/cleanable/liquid_fuel,
/turf/simulated/floor/airless,
/area/dungeon/crashed_satellite)
"Q" = (
/obj/item/bluespace_crystal,
/mob/living/simple_animal/hostile/carp/shark{
	dir = 8;
	wander = 0
	},
/turf/simulated/floor/airless,
/area/dungeon/crashed_satellite)
"R" = (
/obj/effect/decal/remains/robot,
/obj/effect/decal/cleanable/liquid_fuel,
/obj/item/stack/cable_coil/cut,
/turf/simulated/floor/airless,
/area/dungeon/crashed_satellite)
"S" = (
/obj/structure/lattice,
/obj/item/material/shard,
/turf/unsimulated/floor/asteroid/ash/rocky,
/area/template_noop)
"T" = (
/obj/effect/decal/cleanable/liquid_fuel,
/obj/effect/decal/cleanable/liquid_fuel,
/turf/simulated/floor/airless,
/area/dungeon/crashed_satellite)
"U" = (
/obj/effect/decal/cleanable/liquid_fuel,
/turf/simulated/wall/shuttle/dark,
/area/dungeon/crashed_satellite)
"V" = (
/obj/structure/lattice,
/obj/effect/decal/cleanable/liquid_fuel,
/turf/unsimulated/floor/asteroid/ash/rocky,
/area/dungeon/crashed_satellite)

(1,1,1) = {"
b
b
b
a
a
a
a
a
b
b
b
b
b
"}
(2,1,1) = {"
b
b
b
a
a
a
a
a
b
b
b
b
b
"}
(3,1,1) = {"
b
a
a
a
a
a
a
a
a
b
b
b
b
"}
(4,1,1) = {"
b
a
a
a
a
a
E
x
x
x
b
b
b
"}
(5,1,1) = {"
a
a
a
a
i
H
E
E
x
x
x
b
b
"}
(6,1,1) = {"
a
a
a
a
j
I
R
E
x
x
x
v
b
"}
(7,1,1) = {"
a
a
a
f
k
P
T
I
N
x
r
x
x
"}
(8,1,1) = {"
a
a
a
h
s
Q
U
V
u
J
p
x
x
"}
(9,1,1) = {"
a
a
e
e
E
E
p
l
d
C
q
F
z
"}
(10,1,1) = {"
a
x
m
t
v
x
q
J
G
L
q
o
O
"}
(11,1,1) = {"
b
S
c
M
m
x
z
q
D
g
J
n
q
"}
(12,1,1) = {"
b
x
c
x
x
x
y
x
q
w
o
B
A
"}
(13,1,1) = {"
c
M
x
x
m
x
x
x
q
J
B
K
p
"}
(14,1,1) = {"
b
b
b
b
b
b
b
x
x
x
q
J
x
"}
