//MAP CONVERTED BY dmm2tgm.py THIS HEADER COMMENT PREVENTS RECONVERSION, DO NOT REMOVE
"a" = (
/turf/unsimulated/chasm_mask,
/area/mine/unexplored)
"b" = (
/turf/unsimulated/wall/supermatter/no_spread,
/area/mine/unexplored)
"c" = (
/turf/simulated/wall/rusty,
/area/mine/unexplored)
"d" = (
/turf/simulated/floor/tiled/airless,
/area/mine/unexplored)
"e" = (
/obj/machinery/light{
	icon_state = "tube1";
	dir = 1
	},
/turf/simulated/floor/tiled/airless,
/area/mine/unexplored)
"f" = (
/obj/random/junk,
/turf/simulated/floor/tiled/airless,
/area/mine/unexplored)
"g" = (
/obj/effect/decal/cleanable/dirt,
/turf/simulated/floor/tiled/airless,
/area/mine/unexplored)
"h" = (
/obj/item/bluespace_crystal,
/turf/simulated/floor/tiled/airless,
/area/mine/unexplored)
"i" = (
/obj/machinery/artifact,
/turf/simulated/floor/tiled/airless,
/area/mine/unexplored)
"j" = (
/obj/machinery/door/airlock/hatch,
/turf/simulated/floor/tiled/airless,
/area/mine/unexplored)
"k" = (
/obj/machinery/light{
	dir = 4;
	icon_state = "tube1";
	pixel_x = 0
	},
/turf/simulated/floor/tiled/airless,
/area/mine/unexplored)
"l" = (
/obj/machinery/light{
	dir = 8;
	icon_state = "tube1";
	pixel_y = 0
	},
/turf/simulated/floor/tiled/airless,
/area/mine/unexplored)

(1,1,1) = {"
a
a
a
a
a
a
a
a
a
a
a
a
a
a
a
a
a
a
a
a
a
a
a
a
a
a
a
a
a
a
a
a
"}
(2,1,1) = {"
a
a
a
a
a
a
a
a
a
a
a
a
a
a
a
a
a
a
a
a
a
a
a
a
a
a
a
a
a
a
a
a
"}
(3,1,1) = {"
a
a
a
a
a
a
a
a
a
a
a
a
a
a
a
a
a
a
a
a
a
a
a
a
a
a
a
a
a
a
a
a
"}
(4,1,1) = {"
a
a
a
a
a
a
a
a
a
a
a
a
a
a
a
a
a
a
a
a
a
a
a
a
a
a
a
a
a
a
a
a
"}
(5,1,1) = {"
a
a
a
a
a
a
a
a
a
a
a
a
a
a
a
a
a
a
a
a
a
b
b
a
a
a
a
a
a
a
a
a
"}
(6,1,1) = {"
a
a
a
a
a
a
a
a
a
a
a
a
a
a
a
a
a
a
a
a
b
b
b
a
a
a
a
a
a
a
a
a
"}
(7,1,1) = {"
a
a
a
a
a
a
a
a
a
a
a
a
a
a
a
a
a
a
a
b
b
b
b
b
a
a
a
a
a
a
a
a
"}
(8,1,1) = {"
a
a
a
a
a
a
a
a
a
a
c
c
c
c
c
j
c
c
c
c
b
b
b
a
a
a
a
a
a
a
a
a
"}
(9,1,1) = {"
a
a
a
a
a
a
a
a
a
a
c
d
f
g
g
d
c
g
l
d
c
b
a
a
a
a
a
a
a
a
a
a
"}
(10,1,1) = {"
a
a
a
a
a
a
a
a
a
a
c
d
d
d
g
g
c
g
b
h
c
b
b
a
a
a
a
a
a
a
a
a
"}
(11,1,1) = {"
a
a
a
a
a
a
a
a
a
b
c
e
d
d
b
d
c
g
b
g
c
b
b
b
a
a
a
a
a
a
a
a
"}
(12,1,1) = {"
a
a
a
a
a
a
a
a
b
b
b
b
g
d
b
g
c
d
b
b
b
b
b
b
a
a
a
a
a
a
a
a
"}
(13,1,1) = {"
a
a
a
a
a
a
b
b
b
b
b
d
d
b
b
b
b
b
b
b
c
b
a
a
a
a
a
a
a
a
a
a
"}
(14,1,1) = {"
a
a
a
a
a
a
a
b
b
b
c
d
g
d
d
g
b
g
d
g
c
b
b
a
a
a
a
a
a
a
a
a
"}
(15,1,1) = {"
a
a
a
a
a
a
a
b
b
b
c
d
d
h
g
b
b
d
g
f
c
b
a
a
a
a
a
a
a
a
a
a
"}
(16,1,1) = {"
a
a
a
a
a
a
a
a
b
b
c
d
c
c
b
b
b
b
b
d
c
a
a
a
a
a
a
a
a
a
a
a
"}
(17,1,1) = {"
a
a
a
a
a
a
a
a
b
b
c
f
d
d
g
b
b
g
d
d
c
a
a
a
a
a
a
a
a
a
a
a
"}
(18,1,1) = {"
a
a
a
a
a
a
a
a
a
b
c
d
d
g
i
b
g
c
c
c
b
a
a
a
a
a
a
a
a
a
a
a
"}
(19,1,1) = {"
a
a
a
a
a
a
a
a
a
b
c
d
d
d
b
b
b
c
d
b
b
b
a
a
a
a
a
a
a
a
a
a
"}
(20,1,1) = {"
a
a
a
a
a
a
a
a
a
b
b
b
b
b
b
b
b
b
b
b
b
b
a
a
a
a
a
a
a
a
a
a
"}
(21,1,1) = {"
a
a
a
a
a
a
a
a
a
a
c
d
b
d
b
b
b
b
d
g
c
a
a
a
a
a
a
a
a
a
a
a
"}
(22,1,1) = {"
a
a
a
a
a
a
a
a
a
b
b
b
b
d
d
d
b
b
g
g
c
a
a
a
a
a
a
a
a
a
a
a
"}
(23,1,1) = {"
a
a
a
a
a
a
a
a
a
a
b
b
b
b
g
f
d
b
d
h
c
a
a
a
a
a
a
a
a
a
a
a
"}
(24,1,1) = {"
a
a
a
a
a
a
a
a
a
a
b
d
b
d
h
d
k
c
g
f
c
a
a
a
a
a
a
a
a
a
a
a
"}
(25,1,1) = {"
a
a
a
a
a
a
a
a
a
a
b
b
b
b
b
c
c
c
c
c
c
a
a
a
a
a
a
a
a
a
a
a
"}
(26,1,1) = {"
a
a
a
a
a
a
a
a
a
a
a
b
a
a
b
b
b
b
a
a
a
a
a
a
a
a
a
a
a
a
a
a
"}
(27,1,1) = {"
a
a
a
a
a
a
a
a
a
a
a
b
a
a
b
b
b
b
b
a
a
a
a
a
a
a
a
a
a
a
a
a
"}
(28,1,1) = {"
a
a
a
a
a
a
a
a
a
a
b
b
b
a
a
a
a
b
b
a
a
a
a
a
a
a
a
a
a
a
a
a
"}
(29,1,1) = {"
a
a
a
a
a
a
a
a
a
a
b
b
b
a
a
a
b
b
a
a
a
a
a
a
a
a
a
a
a
a
a
a
"}
(30,1,1) = {"
a
a
a
a
a
a
a
a
a
a
a
a
a
a
a
a
a
a
a
a
a
a
a
a
a
a
a
a
a
a
a
a
"}
(31,1,1) = {"
a
a
a
a
a
a
a
a
a
a
a
a
a
a
a
a
a
a
a
a
a
a
a
a
a
a
a
a
a
a
a
a
"}
(32,1,1) = {"
a
a
a
a
a
a
a
a
a
a
a
a
a
a
a
a
a
a
a
a
a
a
a
a
a
a
a
a
a
a
a
a
"}
