//MAP CONVERTED BY dmm2tgm.py THIS HEADER COMMENT PREVENTS RECONVERSION, DO NOT REMOVE
"a" = (
/turf/unsimulated/chasm_mask,
/area/mine/unexplored)
"b" = (
/turf/simulated/mineral,
/area/mine/unexplored)
"c" = (
/turf/unsimulated/floor/asteroid/ash/rocky,
/area/mine/unexplored)
"d" = (
/mob/living/simple_animal/hostile/carp,
/turf/unsimulated/floor/asteroid/ash/rocky,
/area/mine/unexplored)
"e" = (
/turf/simulated/wall/wood,
/area/mine/unexplored)
"f" = (
/turf/simulated/floor/holofloor/wood,
/area/mine/unexplored)
"g" = (
/obj/structure/closet/crate/secure/loot,
/turf/simulated/floor/holofloor/wood,
/area/mine/unexplored)
"h" = (
/obj/structure/simple_door/wood,
/turf/unsimulated/floor/asteroid/ash/rocky,
/area/mine/unexplored)
"i" = (
/mob/living/simple_animal/hostile/carp/shark,
/turf/simulated/floor/holofloor/wood,
/area/mine/unexplored)
"j" = (
/obj/structure/closet/crate/secure/loot,
/turf/unsimulated/floor/asteroid/ash/rocky,
/area/mine/unexplored)
"k" = (
/obj/effect/decal/remains,
/obj/random/loot,
/turf/unsimulated/floor/asteroid/ash/rocky,
/area/mine/unexplored)
"l" = (
/obj/effect/decal/remains,
/turf/unsimulated/floor/asteroid/ash/rocky,
/area/mine/unexplored)
"m" = (
/turf/simulated/open/airless,
/area/mine/unexplored)

(1,1,1) = {"
a
a
a
a
m
m
m
m
m
m
m
m
m
c
c
c
c
c
c
c
c
c
c
c
c
c
a
a
a
a
a
a
"}
(2,1,1) = {"
a
a
a
m
m
b
a
a
b
b
b
a
m
m
c
c
k
c
c
c
l
c
c
c
c
a
a
a
a
a
a
a
"}
(3,1,1) = {"
a
a
a
m
a
b
a
a
a
a
b
a
a
a
a
c
c
c
c
c
c
c
c
c
m
m
m
a
a
a
a
a
"}
(4,1,1) = {"
a
a
m
m
a
b
a
c
a
a
b
b
a
a
a
a
c
c
c
l
c
c
c
a
a
a
m
m
m
a
a
a
"}
(5,1,1) = {"
a
a
m
a
a
b
a
j
c
a
a
b
b
a
b
b
b
c
c
c
c
c
b
b
a
a
a
a
m
a
a
a
"}
(6,1,1) = {"
a
m
m
a
a
b
a
c
c
c
a
a
b
b
b
a
a
a
c
c
c
a
a
b
b
a
a
a
m
a
a
a
"}
(7,1,1) = {"
a
m
a
a
b
b
a
c
c
c
c
a
a
b
b
a
a
a
a
c
a
a
a
a
b
b
a
a
m
a
a
a
"}
(8,1,1) = {"
a
m
a
a
b
a
a
c
d
l
c
c
a
c
c
c
c
c
c
c
c
a
a
a
a
b
a
a
m
a
a
a
"}
(9,1,1) = {"
a
m
a
a
b
a
a
c
c
c
c
c
c
c
c
c
c
c
c
c
c
c
a
a
a
b
b
a
m
a
a
a
"}
(10,1,1) = {"
m
m
a
a
b
b
a
a
c
c
a
c
a
a
c
c
c
c
k
c
c
c
c
c
a
a
b
a
m
a
a
a
"}
(11,1,1) = {"
m
a
a
a
a
b
a
a
c
c
a
c
a
a
b
b
a
c
c
c
c
c
c
c
c
c
b
a
m
a
a
a
"}
(12,1,1) = {"
m
a
a
a
a
b
a
a
a
c
c
c
a
a
a
b
a
a
a
c
c
c
k
c
c
c
b
a
m
a
a
a
"}
(13,1,1) = {"
m
a
a
a
a
b
b
a
a
c
c
k
c
a
b
b
b
a
a
a
c
c
c
c
c
c
b
a
m
a
a
a
"}
(14,1,1) = {"
m
a
a
a
a
a
b
a
a
c
c
d
c
b
b
a
b
b
b
c
c
c
c
c
a
a
b
a
m
a
a
a
"}
(15,1,1) = {"
m
a
a
a
a
a
b
b
a
a
c
c
c
c
a
a
a
c
b
c
c
c
a
a
a
a
b
a
m
a
a
a
"}
(16,1,1) = {"
m
a
a
a
a
a
a
b
b
b
b
c
c
c
a
c
c
c
c
c
a
a
a
b
b
b
a
a
m
a
a
a
"}
(17,1,1) = {"
m
m
a
a
a
a
a
a
b
b
a
a
c
c
c
c
a
a
c
b
b
b
b
b
a
a
a
m
m
a
a
a
"}
(18,1,1) = {"
a
m
m
a
a
a
a
b
b
a
a
a
c
c
c
c
c
c
c
a
b
a
a
b
a
a
a
m
a
a
a
a
"}
(19,1,1) = {"
a
m
m
a
a
a
a
b
a
a
a
c
c
c
a
a
a
c
c
c
c
c
a
b
b
a
a
m
a
a
a
a
"}
(20,1,1) = {"
a
m
m
m
m
m
b
b
a
a
c
c
c
c
b
b
b
b
a
c
d
c
c
a
b
a
a
m
a
a
a
a
"}
(21,1,1) = {"
a
m
m
a
a
a
b
a
a
c
c
l
c
c
a
a
a
b
b
a
c
l
c
a
b
a
a
m
a
a
a
a
"}
(22,1,1) = {"
m
m
a
a
a
a
a
a
c
c
d
c
c
c
c
a
a
a
b
b
c
c
j
a
b
a
m
m
a
a
a
a
"}
(23,1,1) = {"
m
a
a
e
e
e
e
e
c
c
a
a
c
c
c
c
c
a
a
b
a
a
a
b
b
a
m
a
a
a
a
a
"}
(24,1,1) = {"
m
a
a
e
f
f
f
e
c
b
b
b
b
c
c
d
c
c
a
b
b
a
a
b
a
a
m
a
a
a
a
a
"}
(25,1,1) = {"
m
a
a
e
f
g
i
h
c
a
b
a
a
a
c
c
k
c
c
a
b
b
b
b
a
m
m
a
a
a
a
a
"}
(26,1,1) = {"
m
a
a
e
f
f
f
e
c
a
b
b
a
c
c
c
c
c
c
a
a
b
b
a
a
m
a
a
a
a
a
a
"}
(27,1,1) = {"
m
a
a
e
e
e
e
e
c
c
a
b
b
c
c
c
a
a
a
a
b
b
a
a
a
m
a
a
a
a
a
a
"}
(28,1,1) = {"
m
a
k
c
c
c
c
c
c
a
a
a
b
b
c
a
a
b
b
b
b
a
a
a
m
m
a
a
a
a
a
a
"}
(29,1,1) = {"
m
a
a
a
a
a
a
a
b
b
b
b
b
b
b
b
b
b
m
m
m
m
m
a
m
a
a
a
a
a
a
a
"}
(30,1,1) = {"
m
m
m
a
a
a
a
a
b
m
m
m
m
m
m
m
m
m
m
a
a
a
m
m
m
a
a
a
a
a
a
a
"}
(31,1,1) = {"
m
m
m
m
m
m
m
m
m
m
a
a
a
a
a
a
a
a
a
a
a
m
m
a
a
a
a
a
a
a
a
a
"}
(32,1,1) = {"
a
a
a
a
a
a
a
a
a
a
a
a
a
a
a
a
a
a
a
a
a
a
a
a
a
a
a
a
a
a
a
a
"}
