//MAP CONVERTED BY dmm2tgm.py THIS HEADER COMMENT PREVENTS RECONVERSION, DO NOT REMOVE
"a" = (
/turf/unsimulated/chasm_mask,
/area/mine/unexplored)
"b" = (
/turf/simulated/mineral,
/area/mine/unexplored)
"c" = (
/turf/simulated/floor/asteroid/ash/rocky,
/area/mine/unexplored)
"d" = (
/obj/structure/closet/crate/secure/loot,
/turf/simulated/floor/asteroid/ash/rocky,
/area/mine/unexplored)
"e" = (
/mob/living/simple_animal/hostile/carp,
/turf/simulated/floor/asteroid/ash/rocky,
/area/mine/unexplored)
"f" = (
/obj/effect/decal/remains/human,
/obj/random/loot,
/turf/simulated/floor/asteroid/ash/rocky,
/area/mine/unexplored)
"h" = (
/obj/random/loot,
/obj/effect/decal/remains/human,
/turf/simulated/floor/asteroid/ash/rocky,
/area/mine/unexplored)
"i" = (
/turf/simulated/open/airless,
/area/mine/unexplored)

(1,1,1) = {"
a
a
a
a
a
a
a
a
i
i
i
i
i
i
i
i
i
a
a
a
a
a
a
a
a
a
a
a
a
a
a
a
"}
(2,1,1) = {"
a
a
a
a
a
a
a
i
i
a
a
a
a
b
b
b
i
i
i
a
a
a
a
a
a
a
a
a
a
a
a
a
"}
(3,1,1) = {"
a
a
a
a
a
a
i
i
a
a
a
b
b
b
a
b
b
a
i
i
a
a
a
a
a
a
a
a
a
a
a
a
"}
(4,1,1) = {"
a
a
a
a
a
i
i
a
a
b
b
b
a
a
a
a
b
b
a
i
i
a
a
a
a
a
a
a
a
a
a
a
"}
(5,1,1) = {"
a
a
a
a
a
i
a
a
b
b
a
a
a
c
c
a
a
b
a
a
i
i
i
a
a
a
a
a
a
a
a
a
"}
(6,1,1) = {"
a
a
a
a
i
i
a
b
b
a
a
c
c
c
e
c
a
b
b
a
a
a
i
i
i
i
i
i
a
a
a
a
"}
(7,1,1) = {"
a
a
a
a
i
a
b
b
a
a
e
c
d
c
c
c
a
a
b
a
a
b
b
b
b
b
a
i
i
a
a
a
"}
(8,1,1) = {"
a
a
a
a
i
a
b
a
a
c
c
c
f
c
c
a
a
a
b
b
b
b
a
a
a
b
b
a
i
i
a
a
"}
(9,1,1) = {"
a
a
a
a
i
a
b
b
a
c
c
c
c
c
c
c
c
a
a
b
a
a
a
c
a
a
b
a
a
i
i
i
"}
(10,1,1) = {"
a
a
a
a
i
a
b
a
a
c
f
c
a
c
f
c
c
c
a
a
a
c
c
h
c
a
b
a
a
a
a
a
"}
(11,1,1) = {"
a
a
a
a
i
a
b
b
a
c
c
a
a
c
c
c
c
f
c
c
c
c
c
c
c
a
b
b
b
b
b
b
"}
(12,1,1) = {"
a
a
a
a
i
i
a
b
a
a
a
a
a
c
e
c
c
c
c
a
a
a
a
c
c
c
a
a
a
a
a
a
"}
(13,1,1) = {"
a
a
a
a
a
i
a
b
b
a
b
a
c
c
c
c
a
a
a
a
b
b
a
a
c
c
c
a
a
c
a
a
"}
(14,1,1) = {"
a
a
a
a
a
a
i
a
b
b
b
a
c
c
c
b
b
b
b
b
b
b
b
a
a
c
c
c
c
c
c
c
"}
(15,1,1) = {"
a
a
a
a
a
a
i
i
a
a
b
b
c
a
c
b
a
a
a
a
a
a
b
b
a
a
c
c
f
c
c
f
"}
(16,1,1) = {"
a
a
a
a
a
a
a
i
a
a
b
c
c
a
c
b
a
a
i
i
i
a
a
b
b
a
a
c
c
c
c
c
"}
(17,1,1) = {"
a
a
a
a
a
i
i
i
a
a
b
a
c
a
c
b
b
a
i
i
i
i
a
a
b
b
a
a
a
a
a
b
"}
(18,1,1) = {"
a
a
a
a
i
i
a
a
a
b
b
a
c
a
c
c
b
a
a
i
a
i
i
a
a
b
b
b
b
b
b
b
"}
(19,1,1) = {"
a
a
a
i
i
a
a
a
b
b
a
a
c
a
c
a
b
a
a
i
i
a
i
i
i
a
a
a
a
a
a
a
"}
(20,1,1) = {"
a
a
a
i
a
a
b
b
b
a
a
c
c
c
c
a
b
b
a
a
i
a
a
a
i
i
i
i
i
i
i
i
"}
(21,1,1) = {"
a
a
i
i
a
b
b
a
a
a
c
c
c
c
c
a
a
b
b
a
i
i
a
a
a
a
a
a
a
a
a
a
"}
(22,1,1) = {"
a
a
i
a
a
b
a
a
c
c
c
c
e
c
c
f
a
a
b
a
a
i
a
a
a
a
a
a
a
a
a
a
"}
(23,1,1) = {"
a
a
i
a
b
b
a
c
c
c
a
c
c
a
c
c
c
a
b
a
a
i
a
a
a
a
a
a
a
a
a
a
"}
(24,1,1) = {"
a
a
i
a
b
a
a
c
f
c
a
a
a
a
c
c
a
a
b
a
a
i
a
a
a
a
a
a
a
a
a
a
"}
(25,1,1) = {"
a
a
i
a
b
a
c
c
c
c
d
a
a
c
e
c
a
b
b
a
i
i
a
a
a
a
a
a
a
a
a
a
"}
(26,1,1) = {"
a
a
i
a
b
a
c
c
e
c
c
c
c
c
c
c
a
b
a
a
i
a
a
a
a
a
a
a
a
a
a
a
"}
(27,1,1) = {"
a
a
i
a
b
a
a
c
c
c
c
f
c
c
c
a
a
b
a
i
i
a
a
a
a
a
a
a
a
a
a
a
"}
(28,1,1) = {"
a
a
i
a
b
a
a
a
c
c
c
c
c
a
a
a
b
b
a
i
a
a
a
a
a
a
a
a
a
a
a
a
"}
(29,1,1) = {"
a
a
i
a
a
b
b
a
a
a
a
a
a
a
b
b
b
a
i
i
a
a
a
a
a
a
a
a
a
a
a
a
"}
(30,1,1) = {"
a
a
i
i
a
a
b
b
b
b
b
b
b
b
b
a
a
i
i
a
a
a
a
a
a
a
a
a
a
a
a
a
"}
(31,1,1) = {"
a
a
a
i
i
a
a
a
a
a
a
a
a
a
a
a
a
i
a
a
a
a
a
a
a
a
a
a
a
a
a
a
"}
(32,1,1) = {"
a
a
a
a
i
i
i
i
i
i
i
i
i
i
i
i
i
i
a
a
a
a
a
a
a
a
a
a
a
a
a
a
"}
