//MAP CONVERTED BY dmm2tgm.py THIS HEADER COMMENT PREVENTS RECONVERSION, DO NOT REMOVE
"a" = (
/turf/unsimulated/chasm_mask,
/area/mine/unexplored)
"b" = (
/turf/simulated/mineral,
/area/mine/unexplored)
"c" = (
/turf/simulated/floor/asteroid/ash/rocky,
/area/mine/unexplored)
"d" = (
/obj/structure/closet/crate/secure/loot,
/turf/simulated/floor/asteroid/ash/rocky,
/area/mine/unexplored)
"e" = (
/mob/living/simple_animal/hostile/carp,
/turf/simulated/floor/asteroid/ash/rocky,
/area/mine/unexplored)
"f" = (
/obj/effect/decal/remains/human,
/obj/random/loot,
/turf/simulated/floor/asteroid/ash/rocky,
/area/mine/unexplored)
"g" = (
/mob/living/simple_animal/hostile/carp/shark,
/turf/simulated/floor/asteroid/ash/rocky,
/area/mine/unexplored)
"h" = (
/obj/effect/decal/remains/human,
/turf/simulated/floor/asteroid/ash/rocky,
/area/mine/unexplored)
"i" = (
/turf/simulated/open/airless,
/area/mine/unexplored)
"j" = (
/obj/structure/simple_door/wood,
/turf/simulated/floor/asteroid/ash/rocky,
/area/mine/unexplored)

(1,1,1) = {"
a
b
b
a
c
c
c
a
b
b
a
i
i
a
a
a
a
a
a
a
a
a
a
a
a
i
i
i
a
a
a
a
"}
(2,1,1) = {"
a
a
b
a
c
h
c
a
a
b
b
a
i
a
a
a
a
a
a
a
a
a
i
i
i
i
a
a
a
a
b
b
"}
(3,1,1) = {"
a
a
b
a
c
c
c
c
a
b
b
a
i
i
a
a
a
a
a
a
i
i
i
a
a
a
a
a
b
b
b
a
"}
(4,1,1) = {"
a
a
b
a
a
c
c
c
b
b
b
b
a
i
i
a
a
a
a
i
i
a
a
a
a
b
b
b
b
b
a
a
"}
(5,1,1) = {"
a
a
b
a
a
c
b
j
b
b
b
b
b
a
i
i
i
i
i
i
a
a
b
b
b
b
b
b
b
b
a
a
"}
(6,1,1) = {"
a
a
b
b
b
b
b
c
c
b
b
b
b
a
a
a
a
a
a
a
a
b
b
a
a
a
a
b
b
a
c
h
"}
(7,1,1) = {"
a
a
a
b
b
b
b
c
c
c
a
a
b
b
a
a
a
a
a
b
b
b
a
a
a
c
c
c
b
c
c
c
"}
(8,1,1) = {"
b
a
a
b
b
b
b
c
c
c
c
a
a
b
b
b
b
b
b
b
a
a
a
c
c
c
c
h
j
c
c
a
"}
(9,1,1) = {"
a
b
b
b
b
a
c
c
e
c
c
c
a
a
a
c
c
a
a
a
a
c
c
c
c
c
e
c
b
c
a
a
"}
(10,1,1) = {"
i
a
a
b
b
a
a
c
c
c
c
c
c
a
c
f
c
c
c
a
c
c
c
c
c
c
c
c
b
b
a
a
"}
(11,1,1) = {"
i
i
a
a
b
b
a
a
c
c
c
c
c
c
c
c
c
c
c
c
c
c
c
c
c
c
a
b
b
b
b
b
"}
(12,1,1) = {"
a
i
i
a
a
b
b
b
a
a
c
c
c
c
c
c
e
c
c
c
c
c
c
c
a
a
b
b
b
b
b
a
"}
(13,1,1) = {"
a
a
i
i
a
a
a
b
b
b
a
a
a
a
a
c
c
c
c
c
c
c
a
a
a
b
b
b
a
a
i
i
"}
(14,1,1) = {"
a
a
a
i
i
a
a
a
a
b
b
b
a
a
a
c
c
c
c
e
c
c
a
a
b
b
a
a
a
i
i
a
"}
(15,1,1) = {"
a
a
a
a
i
a
a
a
b
b
b
b
b
a
c
c
f
c
c
c
c
c
a
a
a
b
b
b
a
i
a
a
"}
(16,1,1) = {"
a
a
a
a
i
a
a
b
b
a
a
a
a
c
c
c
c
c
a
a
c
c
c
a
a
a
a
b
a
i
a
a
"}
(17,1,1) = {"
a
a
a
i
i
a
b
b
a
a
a
a
c
c
c
c
c
a
a
a
a
c
c
c
a
a
a
b
b
i
i
a
"}
(18,1,1) = {"
a
a
a
i
a
a
b
a
a
a
a
c
c
c
a
a
c
c
a
a
a
c
c
e
c
a
a
a
b
a
i
i
"}
(19,1,1) = {"
a
a
a
i
a
b
b
a
a
c
c
c
c
c
a
c
c
c
a
a
a
a
c
c
c
c
a
a
b
b
a
i
"}
(20,1,1) = {"
a
a
i
i
a
b
a
a
c
c
c
c
a
a
a
c
c
c
a
b
a
a
a
c
c
c
c
b
b
b
b
a
"}
(21,1,1) = {"
a
a
i
a
a
b
a
a
c
h
c
a
a
a
c
c
c
a
a
b
b
a
a
c
c
c
b
b
b
b
b
a
"}
(22,1,1) = {"
a
a
i
a
a
b
a
a
c
g
c
a
a
c
c
c
c
a
a
b
b
a
a
a
c
c
b
b
b
b
b
b
"}
(23,1,1) = {"
a
a
i
a
a
b
a
a
c
c
c
c
c
c
c
a
a
a
a
b
b
b
a
a
a
c
c
b
c
c
a
b
"}
(24,1,1) = {"
a
a
i
a
a
b
a
a
a
a
c
c
c
c
c
a
a
a
a
b
b
b
b
a
a
c
c
j
c
c
a
a
"}
(25,1,1) = {"
a
a
i
a
a
b
a
a
a
c
c
a
c
c
a
a
a
a
a
a
b
b
b
a
a
a
c
b
c
c
c
a
"}
(26,1,1) = {"
a
a
i
a
a
b
a
a
a
c
d
a
c
c
a
a
a
a
a
a
a
b
b
a
a
a
b
b
c
c
c
c
"}
(27,1,1) = {"
a
a
i
a
a
b
a
a
a
c
c
a
c
c
c
c
c
c
c
a
a
a
a
a
a
a
b
b
c
c
f
c
"}
(28,1,1) = {"
a
a
i
a
a
b
b
a
c
c
c
a
c
c
c
e
c
c
c
c
c
c
c
a
a
a
b
b
a
c
c
c
"}
(29,1,1) = {"
a
a
i
a
a
b
b
b
f
c
a
a
c
c
c
c
f
c
c
c
c
d
c
c
c
c
b
b
a
a
c
c
"}
(30,1,1) = {"
a
a
i
i
a
a
a
b
b
b
a
c
c
b
b
b
b
b
b
b
c
c
c
c
c
c
c
b
c
c
a
c
"}
(31,1,1) = {"
a
a
a
i
i
i
i
i
i
b
b
b
b
b
b
i
i
i
i
b
b
b
b
b
b
b
c
b
c
c
c
h
"}
(32,1,1) = {"
a
a
a
a
a
a
a
a
i
i
i
i
i
b
a
a
a
a
i
i
i
i
i
i
i
b
b
b
b
b
b
b
"}
