//MAP CONVERTED BY dmm2tgm.py THIS HEADER COMMENT PREVENTS RECONVERSION, DO NOT REMOVE
"a" = (
/turf/unsimulated/chasm_mask,
/area/mine/unexplored)
"b" = (
/turf/simulated/floor/asteroid/ash/rocky,
/area/mine/unexplored)
"c" = (
/mob/living/simple_animal/hostile/carp,
/turf/simulated/floor/asteroid/ash/rocky,
/area/mine/unexplored)
"d" = (
/obj/structure/closet/crate/secure/loot,
/turf/simulated/floor/asteroid/ash/rocky,
/area/mine/unexplored)
"e" = (
/turf/simulated/mineral,
/area/mine/unexplored)
"f" = (
/obj/effect/decal/remains,
/obj/random/loot,
/turf/simulated/floor/asteroid/ash/rocky,
/area/mine/unexplored)
"g" = (
/obj/structure/simple_door/wood,
/turf/simulated/floor/asteroid/ash/rocky,
/area/mine/unexplored)
"h" = (
/mob/living/simple_animal/hostile/carp/shark,
/turf/simulated/floor/asteroid/ash/rocky,
/area/mine/unexplored)
"i" = (
/obj/effect/decal/remains,
/turf/simulated/floor/asteroid/ash/rocky,
/area/mine/unexplored)
"j" = (
/turf/simulated/open/airless,
/area/mine/unexplored)

(1,1,1) = {"
a
a
a
a
a
a
a
j
j
a
a
a
a
a
a
a
j
j
j
a
a
a
a
a
a
a
a
a
a
a
a
a
"}
(2,1,1) = {"
a
a
a
a
a
a
j
j
j
j
j
j
j
j
j
j
j
a
j
a
e
e
a
a
a
a
a
a
a
a
a
a
"}
(3,1,1) = {"
a
a
a
j
j
j
j
a
a
e
e
e
e
e
e
a
a
a
j
j
j
j
a
a
a
a
a
a
a
a
a
a
"}
(4,1,1) = {"
a
j
j
j
a
a
a
a
a
e
e
a
a
a
e
a
a
a
a
e
e
j
a
a
a
a
a
a
a
a
a
a
"}
(5,1,1) = {"
j
j
a
a
a
a
a
a
a
a
e
b
d
b
e
e
e
e
e
e
e
j
j
a
a
a
a
a
a
a
a
a
"}
(6,1,1) = {"
e
e
e
e
e
a
a
a
a
e
e
b
b
b
e
e
b
b
b
e
e
e
j
j
a
a
a
a
a
a
a
a
"}
(7,1,1) = {"
b
b
b
e
e
e
e
a
e
e
b
b
b
b
b
b
b
b
b
b
b
e
e
j
j
a
a
a
a
a
a
a
"}
(8,1,1) = {"
i
b
b
b
b
b
e
e
e
b
b
b
b
c
b
b
a
a
b
b
b
b
e
e
j
j
a
a
a
a
a
a
"}
(9,1,1) = {"
b
b
b
i
b
b
b
b
e
b
b
b
b
b
b
a
j
j
a
b
b
b
e
a
e
j
j
a
a
a
a
a
"}
(10,1,1) = {"
e
e
b
b
b
b
b
b
b
b
b
c
b
b
b
a
j
a
b
b
c
b
e
e
e
e
j
j
a
a
a
a
"}
(11,1,1) = {"
a
e
e
e
e
e
e
e
b
b
f
b
b
b
b
j
j
b
b
b
b
b
b
b
b
e
e
j
j
j
a
a
"}
(12,1,1) = {"
j
j
a
a
a
a
a
e
b
b
b
b
b
b
a
j
a
b
b
b
b
b
b
b
b
b
e
e
e
j
j
a
"}
(13,1,1) = {"
a
j
j
j
j
a
a
e
b
b
b
b
b
b
b
a
b
b
b
a
b
b
b
b
b
a
a
a
e
e
j
a
"}
(14,1,1) = {"
a
a
a
a
j
a
a
e
b
b
b
a
b
b
b
b
b
b
b
a
a
a
a
a
a
a
a
j
a
e
j
a
"}
(15,1,1) = {"
a
a
a
a
j
a
e
e
b
b
a
a
a
b
b
b
b
f
b
b
a
a
a
a
j
j
j
j
a
e
j
a
"}
(16,1,1) = {"
a
a
a
a
j
a
e
b
b
b
a
j
a
a
b
b
b
b
d
b
b
b
a
j
j
a
a
a
a
e
j
a
"}
(17,1,1) = {"
a
a
a
a
j
a
e
b
c
b
a
j
j
j
a
a
b
b
b
b
b
b
b
a
a
a
a
b
b
e
j
a
"}
(18,1,1) = {"
a
a
a
a
j
a
e
b
b
b
a
a
a
j
j
a
a
b
b
c
b
b
b
b
b
b
b
b
b
e
j
a
"}
(19,1,1) = {"
a
a
a
a
j
j
e
e
b
b
b
b
a
a
j
j
a
b
b
b
b
c
b
b
b
b
b
b
b
e
j
a
"}
(20,1,1) = {"
a
a
a
a
a
j
a
e
b
b
b
b
b
b
a
a
b
b
b
b
b
b
b
b
a
a
b
b
b
e
j
a
"}
(21,1,1) = {"
a
a
a
a
a
j
a
e
b
b
b
b
b
b
b
b
b
b
b
a
a
a
a
a
a
a
a
a
b
e
j
a
"}
(22,1,1) = {"
a
a
a
a
a
j
a
e
e
e
b
b
b
b
b
b
b
b
a
a
e
e
e
e
e
a
a
a
b
e
j
j
"}
(23,1,1) = {"
a
a
a
a
a
j
j
a
a
e
b
b
b
c
b
b
b
a
a
e
e
a
b
a
e
e
a
e
b
e
e
j
"}
(24,1,1) = {"
a
a
a
a
a
a
j
j
a
e
e
b
b
b
b
b
b
a
a
e
a
b
b
b
a
e
e
e
b
b
e
j
"}
(25,1,1) = {"
a
a
a
a
a
a
a
j
a
a
e
e
b
b
b
b
b
b
a
e
h
b
d
b
b
b
g
b
b
b
e
j
"}
(26,1,1) = {"
a
a
a
a
a
a
j
j
a
e
e
b
b
b
b
b
b
b
a
e
a
b
b
b
a
e
e
e
b
b
e
j
"}
(27,1,1) = {"
a
a
a
a
a
j
j
a
e
e
b
b
b
b
f
b
b
b
a
e
e
a
b
a
e
e
a
e
b
e
e
j
"}
(28,1,1) = {"
a
a
a
j
j
a
a
e
e
b
b
b
b
b
b
b
b
b
a
a
e
e
e
e
e
a
a
b
b
e
j
j
"}
(29,1,1) = {"
a
a
a
j
a
a
e
e
b
b
b
b
b
e
e
b
b
b
b
a
a
a
a
a
a
a
b
b
b
e
j
j
"}
(30,1,1) = {"
a
a
a
j
a
e
e
b
b
b
b
b
e
e
e
b
b
b
b
b
b
b
b
b
b
b
b
f
b
e
j
a
"}
(31,1,1) = {"
a
a
j
j
e
e
b
b
b
b
b
e
e
j
e
e
b
b
b
b
b
b
b
b
b
b
b
b
e
e
j
a
"}
(32,1,1) = {"
a
a
j
a
e
b
b
i
b
b
e
e
j
j
j
e
e
e
e
e
e
e
e
e
e
e
e
e
e
j
j
a
"}
