//MAP CONVERTED BY dmm2tgm.py THIS HEADER COMMENT PREVENTS RECONVERSION, DO NOT REMOVE
"a" = (
/turf/unsimulated/chasm_mask,
/area/mine/unexplored)
"b" = (
/turf/simulated/floor/asteroid/ash/rocky,
/area/mine/unexplored)
"c" = (
/turf/simulated/open/airless,
/area/mine/unexplored)
"d" = (
/mob/living/simple_animal/hostile/carp,
/turf/simulated/floor/asteroid/ash/rocky,
/area/mine/unexplored)
"e" = (
/obj/effect/decal/remains/xeno,
/turf/simulated/floor/asteroid/ash/rocky,
/area/mine/unexplored)
"f" = (
/obj/structure/closet/crate/secure/loot,
/turf/simulated/floor/asteroid/ash/rocky,
/area/mine/unexplored)
"g" = (
/obj/effect/decal/remains/human,
/obj/random/voidsuit,
/turf/simulated/floor/asteroid/ash/rocky,
/area/mine/unexplored)
"h" = (
/obj/random/projectile,
/turf/simulated/floor/asteroid/ash/rocky,
/area/mine/unexplored)
"i" = (
/obj/item/device/gps/engineering,
/turf/simulated/floor/asteroid/ash/rocky,
/area/mine/unexplored)
"j" = (
/turf/simulated/mineral,
/area/mine/unexplored)
"k" = (
/obj/effect/decal/remains/human,
/turf/simulated/floor/asteroid/ash/rocky,
/area/mine/unexplored)
"l" = (
/obj/effect/decal/remains/xeno,
/obj/random/loot,
/turf/simulated/floor/asteroid/ash/rocky,
/area/mine/unexplored)
"m" = (
/obj/effect/decal/remains/human,
/obj/random/loot,
/turf/simulated/floor/asteroid/ash/rocky,
/area/mine/unexplored)

(1,1,1) = {"
a
a
a
a
a
a
a
a
a
a
a
a
a
a
a
a
a
a
c
c
c
c
c
a
a
a
a
a
a
a
a
a
"}
(2,1,1) = {"
a
a
a
a
a
a
a
a
a
a
a
a
a
a
a
a
c
c
c
a
a
a
c
c
a
a
a
a
a
a
a
a
"}
(3,1,1) = {"
a
a
a
a
a
a
a
a
a
a
c
c
c
c
c
c
c
a
a
a
a
a
a
c
a
a
a
a
a
a
a
a
"}
(4,1,1) = {"
a
a
a
a
a
a
a
a
c
c
c
a
a
a
a
a
a
a
a
a
a
j
j
c
c
a
a
a
a
a
a
a
"}
(5,1,1) = {"
a
a
a
a
a
a
a
c
c
a
a
j
j
j
j
j
j
j
j
a
j
j
j
j
c
c
a
a
a
a
a
a
"}
(6,1,1) = {"
a
a
a
a
a
a
c
c
a
a
j
j
a
a
b
b
a
a
j
j
j
b
j
j
j
c
a
a
a
a
a
a
"}
(7,1,1) = {"
a
a
a
a
a
a
c
a
a
j
j
a
a
a
b
b
b
b
a
a
b
b
k
b
j
c
c
a
a
a
a
a
"}
(8,1,1) = {"
a
a
a
a
a
c
c
a
a
j
a
a
b
b
b
i
b
b
b
b
b
b
b
j
j
a
c
a
a
a
a
a
"}
(9,1,1) = {"
a
a
a
a
a
c
a
a
j
j
b
b
b
f
b
b
g
b
b
b
m
b
b
j
j
a
c
a
a
a
a
a
"}
(10,1,1) = {"
a
a
a
a
c
c
a
a
j
a
b
b
b
b
b
b
h
b
b
d
b
b
b
j
j
a
c
a
a
a
a
a
"}
(11,1,1) = {"
a
a
a
a
c
a
a
a
j
a
b
b
l
b
b
b
b
b
b
b
b
b
a
j
j
a
c
a
a
a
a
a
"}
(12,1,1) = {"
a
a
a
c
c
a
a
a
j
a
b
b
b
b
k
b
c
b
b
b
k
b
a
j
a
a
c
a
a
a
a
a
"}
(13,1,1) = {"
a
a
a
c
a
a
a
j
j
a
b
b
d
b
b
b
c
c
b
b
b
b
a
j
a
c
c
a
a
a
a
a
"}
(14,1,1) = {"
a
a
a
c
a
a
a
j
a
b
b
b
b
b
b
c
c
c
b
b
b
b
a
j
a
c
a
a
a
a
a
a
"}
(15,1,1) = {"
a
a
a
c
a
a
j
j
b
b
b
b
b
b
b
c
c
c
c
b
b
b
j
j
a
c
a
a
a
a
a
a
"}
(16,1,1) = {"
a
a
c
c
a
a
j
a
b
b
k
b
b
c
c
c
c
c
c
b
b
d
j
a
c
c
a
a
a
a
a
a
"}
(17,1,1) = {"
a
a
c
a
a
a
j
a
b
b
b
b
c
c
c
c
c
c
b
b
b
b
j
a
c
a
a
a
a
a
a
a
"}
(18,1,1) = {"
a
a
c
a
a
a
j
a
b
d
b
c
c
c
c
c
c
c
b
l
b
b
j
a
c
a
a
a
a
a
a
a
"}
(19,1,1) = {"
a
a
c
a
a
j
j
a
b
b
b
c
c
c
c
c
c
b
b
b
b
a
j
a
c
a
a
a
a
a
a
a
"}
(20,1,1) = {"
a
c
c
a
a
j
a
b
b
b
c
c
c
c
c
c
b
b
b
b
b
a
j
a
c
a
a
a
a
a
a
a
"}
(21,1,1) = {"
a
c
a
a
a
j
a
d
b
b
c
c
c
c
c
c
b
b
d
b
b
a
j
a
c
a
a
a
a
a
a
a
"}
(22,1,1) = {"
a
c
a
a
j
j
b
b
b
c
c
c
c
c
c
c
b
k
b
a
a
a
j
c
c
a
a
a
a
a
a
a
"}
(23,1,1) = {"
a
c
a
a
j
a
b
l
b
c
c
c
c
c
c
b
b
b
b
a
a
j
j
c
a
a
a
a
a
a
a
a
"}
(24,1,1) = {"
c
c
a
a
j
a
b
b
b
c
c
c
c
c
b
b
b
b
b
a
j
j
a
c
a
a
a
a
a
a
a
a
"}
(25,1,1) = {"
c
a
a
a
j
a
b
b
c
c
c
c
b
b
b
b
a
a
a
a
j
a
a
c
a
a
a
a
a
a
a
a
"}
(26,1,1) = {"
c
a
a
a
j
j
a
b
b
b
b
b
b
d
b
b
a
a
a
j
j
a
a
c
a
a
a
a
a
a
a
a
"}
(27,1,1) = {"
c
a
a
a
a
j
a
b
b
b
d
b
b
e
b
b
a
a
j
j
a
a
c
c
a
a
a
a
a
a
a
a
"}
(28,1,1) = {"
c
a
a
a
a
j
j
a
a
b
b
b
b
b
b
a
j
j
j
a
a
a
c
a
a
a
a
a
a
a
a
a
"}
(29,1,1) = {"
c
a
a
a
a
a
j
j
a
a
a
a
a
a
a
j
j
a
a
a
a
c
c
a
a
a
a
a
a
a
a
a
"}
(30,1,1) = {"
c
c
a
a
a
a
a
j
j
j
j
j
j
j
j
j
a
a
a
a
c
c
a
a
a
a
a
a
a
a
a
a
"}
(31,1,1) = {"
a
c
c
c
c
c
a
a
a
a
a
a
a
a
a
a
a
a
a
c
c
a
a
a
a
a
a
a
a
a
a
a
"}
(32,1,1) = {"
a
a
a
a
a
c
c
c
c
c
c
c
c
c
c
c
c
c
c
c
a
a
a
a
a
a
a
a
a
a
a
a
"}
