//MAP CONVERTED BY dmm2tgm.py THIS HEADER COMMENT PREVENTS RECONVERSION, DO NOT REMOVE
"a" = (
/turf/unsimulated/chasm_mask,
/area/mine/unexplored)
"b" = (
/turf/simulated/floor/asteroid/ash/rocky,
/area/mine/unexplored)
"c" = (
/turf/simulated/mineral,
/area/mine/unexplored)
"d" = (
/obj/random/junk,
/turf/simulated/floor/asteroid/ash/rocky,
/area/mine/unexplored)
"e" = (
/mob/living/simple_animal/hostile/carp,
/turf/simulated/floor/asteroid/ash/rocky,
/area/mine/unexplored)
"f" = (
/obj/random/coin,
/turf/simulated/floor/asteroid/ash/rocky,
/area/mine/unexplored)
"g" = (
/obj/random/loot,
/turf/simulated/floor/asteroid/ash/rocky,
/area/mine/unexplored)
"h" = (
/obj/structure/closet/crate/secure/loot,
/turf/simulated/floor/asteroid/ash/rocky,
/area/mine/unexplored)
"i" = (
/obj/random/powercell,
/turf/simulated/floor/asteroid/ash/rocky,
/area/mine/unexplored)
"j" = (
/obj/item/device/flashlight/lantern{
	on = 1
	},
/turf/simulated/floor/asteroid/ash/rocky,
/area/mine/unexplored)
"k" = (
/obj/item/clothing/head/helmet/space/void/mining,
/turf/simulated/floor/asteroid/ash/rocky,
/area/mine/unexplored)
"l" = (
/turf/simulated/mineral/random/high_chance,
/area/mine/unexplored)
"m" = (
/obj/effect/decal/cleanable/blood/splatter,
/obj/effect/decal/remains,
/turf/simulated/floor/asteroid/ash/rocky,
/area/mine/unexplored)
"n" = (
/obj/item/weapon/pickaxe/gold,
/turf/simulated/floor/asteroid/ash/rocky,
/area/mine/unexplored)
"o" = (
/obj/random/medical,
/turf/simulated/floor/asteroid/ash/rocky,
/area/mine/unexplored)
"p" = (
/obj/random/plushie,
/turf/simulated/floor/asteroid/ash/rocky,
/area/mine/unexplored)
"q" = (
/obj/effect/decal/remains/mouse,
/turf/simulated/floor/asteroid/ash/rocky,
/area/mine/unexplored)
"r" = (
/obj/random/spacecash,
/turf/simulated/floor/asteroid/ash/rocky,
/area/mine/unexplored)

(1,1,1) = {"
a
a
a
a
a
a
a
a
a
a
a
a
a
a
a
a
a
a
a
a
a
a
a
a
a
a
a
a
a
a
a
a
"}
(2,1,1) = {"
a
a
a
a
a
a
a
a
a
a
a
a
a
a
a
a
a
a
a
a
a
a
a
a
a
a
a
a
a
a
a
a
"}
(3,1,1) = {"
a
a
a
a
c
c
c
c
c
c
c
a
a
a
a
a
a
a
a
a
a
a
a
a
a
a
a
a
a
a
a
a
"}
(4,1,1) = {"
a
a
a
a
a
a
a
a
a
a
c
c
a
a
a
a
a
a
a
a
a
a
a
a
a
a
a
a
a
a
a
a
"}
(5,1,1) = {"
a
a
a
b
b
b
b
b
b
b
b
c
c
a
a
a
a
a
a
a
a
a
a
a
a
a
a
a
a
a
a
a
"}
(6,1,1) = {"
a
a
a
b
a
a
a
a
a
a
b
b
c
c
a
a
a
a
a
a
a
a
a
a
c
c
c
c
c
c
c
a
"}
(7,1,1) = {"
a
a
a
b
a
c
c
c
c
c
a
b
b
c
a
a
a
a
a
a
a
a
a
a
c
e
b
b
b
r
c
a
"}
(8,1,1) = {"
a
a
a
b
a
a
a
a
a
c
a
b
g
c
a
a
a
a
a
a
a
a
a
a
c
b
h
b
e
b
c
c
"}
(9,1,1) = {"
b
b
b
d
b
b
b
b
b
c
a
a
b
c
a
a
a
a
a
a
a
a
a
a
c
d
b
q
b
b
b
b
"}
(10,1,1) = {"
a
a
c
c
c
c
c
a
b
c
a
a
b
c
a
a
a
a
a
a
a
c
c
c
c
b
c
c
c
c
c
a
"}
(11,1,1) = {"
a
a
a
b
b
e
c
a
b
b
b
b
b
c
a
c
c
c
c
a
a
c
a
b
a
b
a
b
b
b
a
a
"}
(12,1,1) = {"
a
a
b
b
c
c
c
c
c
c
b
a
a
c
a
c
a
a
a
a
a
c
a
b
b
b
b
b
c
b
c
a
"}
(13,1,1) = {"
a
a
b
c
c
a
a
a
a
c
b
a
c
c
c
c
c
c
c
c
a
c
a
b
a
a
a
a
a
b
c
a
"}
(14,1,1) = {"
a
a
b
c
a
b
b
b
b
c
b
b
b
b
b
b
l
l
l
c
c
c
a
b
c
c
c
c
a
b
c
a
"}
(15,1,1) = {"
a
a
b
c
a
b
a
c
b
c
c
c
c
c
e
k
b
b
e
c
c
b
b
b
c
b
c
a
a
b
b
a
"}
(16,1,1) = {"
a
a
b
c
a
b
b
c
b
a
a
a
c
c
b
b
m
b
n
b
b
b
a
a
c
e
c
c
a
a
b
a
"}
(17,1,1) = {"
b
b
b
b
b
b
g
c
b
b
b
b
c
b
j
b
b
h
b
c
c
c
c
c
c
b
b
c
a
a
b
b
"}
(18,1,1) = {"
b
a
a
a
a
b
e
c
a
a
a
b
b
b
c
b
e
b
d
a
a
a
a
c
p
b
d
c
a
a
a
b
"}
(19,1,1) = {"
b
b
b
a
a
b
h
c
a
a
a
a
c
c
c
c
c
c
c
a
a
a
a
c
b
b
b
c
c
a
a
b
"}
(20,1,1) = {"
a
a
b
c
c
c
c
c
c
c
c
c
c
b
b
b
a
a
a
a
a
a
a
c
b
b
e
h
c
a
a
b
"}
(21,1,1) = {"
a
a
b
b
b
e
c
a
i
e
c
h
b
b
b
d
a
a
a
a
a
a
a
c
b
c
c
c
c
c
a
b
"}
(22,1,1) = {"
a
a
a
a
a
b
c
a
c
c
c
b
b
b
e
a
a
a
a
a
a
a
a
c
b
b
b
b
a
c
a
b
"}
(23,1,1) = {"
a
a
a
a
a
b
c
a
a
a
c
c
c
c
c
c
c
c
c
a
c
c
c
c
b
a
a
b
b
c
a
b
"}
(24,1,1) = {"
a
a
a
a
a
f
c
a
a
a
c
a
a
a
a
a
a
a
c
a
c
h
e
c
b
c
c
c
b
c
a
b
"}
(25,1,1) = {"
a
c
c
c
c
c
c
a
a
a
c
a
a
a
a
a
a
a
c
a
c
b
b
b
b
a
a
a
b
b
b
b
"}
(26,1,1) = {"
a
a
a
a
a
a
c
a
a
a
c
a
a
a
a
a
a
a
c
a
c
o
b
b
b
a
a
a
a
a
a
a
"}
(27,1,1) = {"
a
a
a
a
a
a
a
a
a
a
c
a
a
a
a
a
a
a
c
a
c
b
b
b
d
a
c
c
c
c
c
c
"}
(28,1,1) = {"
a
a
a
a
a
a
a
a
a
a
a
a
a
a
a
a
a
a
c
a
c
b
e
b
b
a
c
a
a
a
a
a
"}
(29,1,1) = {"
a
a
a
a
a
a
a
a
a
a
a
a
a
a
a
a
a
a
a
a
c
c
c
c
c
c
c
a
a
a
a
a
"}
(30,1,1) = {"
a
a
a
a
a
a
a
a
a
a
a
a
a
a
a
a
a
a
a
a
a
a
a
a
a
a
a
a
a
a
a
a
"}
(31,1,1) = {"
a
a
a
a
a
a
a
a
a
a
a
a
a
a
a
a
a
a
a
a
a
a
a
a
a
a
a
a
a
a
a
a
"}
(32,1,1) = {"
a
a
a
a
a
a
a
a
a
a
a
a
a
a
a
a
a
a
a
a
a
a
a
a
a
a
a
a
a
a
a
a
"}
