//MAP CONVERTED BY dmm2tgm.py THIS HEADER COMMENT PREVENTS RECONVERSION, DO NOT REMOVE
"a" = (
/turf/unsimulated/chasm_mask,
/area/mine/unexplored)
"b" = (
/turf/simulated/mineral/random,
/area/mine/unexplored)
"c" = (
/obj/structure/closet/crate/secure/loot,
/turf/simulated/floor/asteroid/ash/rocky,
/area/mine/unexplored)
"d" = (
/mob/living/simple_animal/hostile/retaliate/cavern_dweller,
/turf/simulated/floor/asteroid/ash/rocky,
/area/mine/unexplored)
"e" = (
/turf/simulated/mineral/random/higher_chance,
/area/mine/unexplored)
"f" = (
/obj/random/loot,
/turf/simulated/floor/asteroid/ash/rocky,
/area/mine/unexplored)
"g" = (
/turf/simulated/floor/asteroid/ash/rocky,
/area/mine/unexplored)
"h" = (
/turf/simulated/floor/asteroid/ash/rocky,
/area/space)
"i" = (
/turf/simulated/open/airless,
/area/mine/unexplored)

(1,1,1) = {"
a
a
a
a
a
a
a
a
a
a
a
a
a
a
a
a
a
a
a
a
a
a
a
a
a
i
i
i
i
i
i
a
"}
(2,1,1) = {"
a
a
a
a
a
i
i
i
i
i
i
i
i
a
a
a
a
a
i
i
i
i
i
i
i
i
b
b
b
b
i
i
"}
(3,1,1) = {"
a
a
a
a
i
i
b
b
b
b
b
b
i
i
i
i
a
i
i
b
b
b
b
b
b
b
b
a
a
b
b
b
"}
(4,1,1) = {"
a
a
a
a
i
b
b
a
a
a
a
b
b
b
b
i
i
i
b
b
a
a
a
a
a
a
a
a
a
a
a
g
"}
(5,1,1) = {"
a
a
a
a
i
b
g
g
g
a
a
a
a
a
b
b
i
b
b
a
a
g
g
g
g
g
g
g
g
g
g
g
"}
(6,1,1) = {"
a
a
a
a
i
b
a
g
d
g
g
g
g
a
a
b
b
b
a
a
g
g
g
g
g
g
g
g
g
g
g
g
"}
(7,1,1) = {"
a
a
a
i
i
b
a
g
g
g
g
g
g
g
a
a
a
a
g
g
g
g
g
g
g
g
g
g
d
g
g
g
"}
(8,1,1) = {"
a
a
a
i
b
b
a
g
g
e
e
g
g
g
g
g
g
g
g
g
d
g
g
g
f
g
g
g
g
g
g
g
"}
(9,1,1) = {"
a
a
a
i
b
a
g
g
f
g
e
e
g
g
g
g
g
g
g
g
g
g
g
g
g
g
g
g
a
a
a
a
"}
(10,1,1) = {"
a
a
a
i
b
a
g
g
g
g
c
e
g
g
g
g
g
e
g
g
g
g
g
a
a
a
a
a
a
a
a
b
"}
(11,1,1) = {"
a
a
i
i
b
a
g
g
g
g
g
e
g
g
d
g
e
e
e
g
g
g
a
a
a
a
a
a
a
b
b
b
"}
(12,1,1) = {"
a
a
i
b
b
a
g
g
g
g
e
e
g
g
g
e
e
e
g
g
g
a
a
a
a
b
b
b
b
b
i
i
"}
(13,1,1) = {"
a
a
i
b
a
a
g
d
g
e
e
g
h
f
g
e
e
e
g
g
a
a
a
b
b
b
i
i
i
i
i
a
"}
(14,1,1) = {"
a
a
i
b
b
a
g
g
g
g
g
g
g
g
g
e
e
g
g
g
a
b
b
b
i
i
i
a
a
a
a
a
"}
(15,1,1) = {"
a
a
i
i
b
a
g
g
g
g
g
g
g
g
g
g
g
g
g
a
a
b
i
i
i
a
a
a
a
a
a
a
"}
(16,1,1) = {"
a
a
a
i
b
a
g
g
g
g
g
g
g
e
g
g
g
g
a
a
a
b
b
i
a
a
a
a
a
a
a
a
"}
(17,1,1) = {"
a
a
a
i
b
a
g
g
g
g
d
g
e
e
e
g
g
g
g
a
a
a
b
i
a
a
a
a
a
a
a
a
"}
(18,1,1) = {"
a
a
a
i
b
a
a
g
g
g
g
g
e
e
e
e
g
g
g
g
a
a
b
i
a
a
a
a
a
a
a
a
"}
(19,1,1) = {"
a
a
a
i
b
b
a
a
a
g
g
g
g
e
e
e
g
g
d
g
a
a
b
i
i
a
a
a
a
a
a
a
"}
(20,1,1) = {"
a
a
a
i
i
b
b
b
a
a
g
g
g
g
e
e
g
g
g
g
a
a
a
b
i
i
a
a
a
a
a
a
"}
(21,1,1) = {"
a
a
a
a
i
i
i
b
b
b
b
b
b
g
g
g
g
g
g
g
g
a
a
b
b
i
a
a
a
a
a
a
"}
(22,1,1) = {"
a
a
a
a
a
i
i
i
i
a
a
b
b
g
b
g
g
g
e
e
g
a
a
a
b
i
i
a
a
a
a
a
"}
(23,1,1) = {"
a
a
a
a
a
a
i
a
i
i
i
i
g
g
b
a
g
g
g
e
g
g
g
a
b
b
i
a
a
a
a
a
"}
(24,1,1) = {"
a
a
a
a
a
a
i
a
a
b
b
i
g
b
b
b
a
g
g
e
g
g
g
a
a
b
i
i
a
a
a
a
"}
(25,1,1) = {"
a
a
a
a
a
a
i
a
a
b
a
i
i
a
b
b
b
g
g
g
g
d
g
g
a
b
b
i
a
a
a
a
"}
(26,1,1) = {"
a
a
a
a
a
a
i
a
a
b
a
g
i
a
b
a
b
a
g
f
g
g
g
g
a
a
b
i
a
a
a
a
"}
(27,1,1) = {"
a
a
a
a
a
a
i
a
b
b
a
g
i
i
b
a
b
b
g
g
g
e
g
g
a
a
b
i
a
a
a
a
"}
(28,1,1) = {"
a
a
a
a
a
a
i
a
b
a
g
g
a
i
i
a
a
b
a
g
g
e
e
g
g
a
b
i
a
a
a
a
"}
(29,1,1) = {"
a
a
a
a
a
a
i
a
b
a
c
g
a
b
i
i
a
b
b
g
g
g
e
g
g
a
b
i
a
a
a
a
"}
(30,1,1) = {"
a
a
a
a
a
a
i
i
b
b
a
b
b
b
a
i
i
a
b
b
g
g
g
g
g
a
b
i
a
a
a
a
"}
(31,1,1) = {"
a
a
a
a
a
a
a
i
a
b
b
b
a
a
a
a
i
i
a
b
b
g
d
g
g
a
b
i
i
a
a
a
"}
(32,1,1) = {"
a
a
a
a
a
a
a
i
i
i
i
i
i
i
i
i
i
i
a
a
b
g
g
g
g
a
b
a
i
a
a
a
"}
