//MAP CONVERTED BY dmm2tgm.py THIS HEADER COMMENT PREVENTS RECONVERSION, DO NOT REMOVE
"a" = (
/turf/unsimulated/chasm_mask,
/area/mine/unexplored)
"b" = (
/turf/simulated/mineral,
/area/mine/unexplored)
"c" = (
/turf/unsimulated/floor/asteroid/ash/rocky,
/area/mine/unexplored)
"d" = (
/mob/living/simple_animal/hostile/carp{
	wander = 0
	},
/turf/unsimulated/floor/asteroid/ash/rocky,
/area/mine/unexplored)
"e" = (
/obj/item/arrow/rod,
/turf/unsimulated/floor/asteroid/ash/rocky,
/area/mine/unexplored)
"f" = (
/obj/effect/decal/cleanable/blood/drip,
/turf/unsimulated/floor/asteroid/ash/rocky,
/area/mine/unexplored)
"i" = (
/obj/effect/decal/remains/human,
/obj/effect/decal/cleanable/blood,
/obj/random/voidsuit,
/turf/unsimulated/floor/asteroid/ash/rocky,
/area/mine/unexplored)
"j" = (
/obj/random/loot,
/turf/unsimulated/floor/asteroid/ash/rocky,
/area/mine/unexplored)
"k" = (
/obj/item/material/shard{
	icon_state = "small"
	},
/obj/effect/decal/cleanable/blood/drip,
/turf/unsimulated/floor/asteroid/ash/rocky,
/area/mine/unexplored)
"l" = (
/obj/random/melee,
/turf/unsimulated/floor/asteroid/ash/rocky,
/area/mine/unexplored)
"m" = (
/turf/simulated/wall/shuttle/cardinal,
/area/mine/unexplored)
"n" = (
/obj/structure/grille/broken,
/turf/simulated/floor,
/area/mine/unexplored)
"o" = (
/obj/effect/decal/cleanable/blood/drip,
/obj/machinery/door/airlock/external{
	icon_state = "door_locked";
	locked = 1
	},
/obj/effect/decal/cleanable/blood/drip,
/turf/simulated/floor/shuttle,
/area/mine/unexplored)
"p" = (
/obj/structure/grille,
/obj/structure/window/reinforced{
	dir = 4
	},
/obj/structure/window/reinforced,
/obj/item/material/shard,
/turf/simulated/floor,
/area/mine/unexplored)
"q" = (
/obj/effect/decal/cleanable/blood,
/turf/simulated/floor/shuttle/dark_blue,
/area/mine/unexplored)
"t" = (
/obj/item/arrow/rod,
/turf/simulated/floor/shuttle/dark_blue,
/area/mine/unexplored)
"u" = (
/obj/structure/grille,
/obj/item/material/shard,
/obj/structure/window/reinforced{
	dir = 8
	},
/turf/simulated/floor,
/area/mine/unexplored)
"v" = (
/obj/structure/bed/stool/chair/shuttle,
/obj/effect/decal/cleanable/blood,
/obj/effect/decal/remains/human,
/turf/simulated/floor/shuttle/dark_blue,
/area/mine/unexplored)
"w" = (
/obj/effect/decal/cleanable/blood/drip,
/turf/simulated/floor/shuttle/dark_blue,
/area/mine/unexplored)
"x" = (
/obj/effect/decal/cleanable/blood/drip,
/obj/effect/decal/cleanable/blood/drip,
/turf/simulated/floor/shuttle/dark_blue,
/area/mine/unexplored)
"y" = (
/obj/machinery/door/airlock/external{
	icon_state = "door_locked";
	locked = 1
	},
/obj/effect/decal/cleanable/blood/drip,
/turf/simulated/floor/shuttle,
/area/mine/unexplored)
"z" = (
/obj/structure/bed/stool/chair/shuttle,
/obj/effect/decal/cleanable/blood,
/turf/simulated/floor/shuttle/dark_blue,
/area/mine/unexplored)
"A" = (
/turf/simulated/floor/shuttle/dark_blue,
/area/mine/unexplored)
"B" = (
/obj/random/voidsuit,
/turf/simulated/floor/shuttle/dark_blue,
/area/mine/unexplored)
"C" = (
/obj/item/device/gps,
/turf/simulated/floor/shuttle/dark_blue,
/area/mine/unexplored)
"D" = (
/obj/structure/grille,
/obj/structure/window/reinforced{
	dir = 4
	},
/obj/structure/window/reinforced{
	dir = 8
	},
/obj/structure/window/reinforced{
	dir = 1
	},
/turf/simulated/floor,
/area/mine/unexplored)
"E" = (
/obj/structure/closet/crate/secure/loot,
/turf/simulated/floor/shuttle/dark_blue,
/area/mine/unexplored)
"F" = (
/obj/random/loot,
/turf/simulated/floor/shuttle/dark_blue,
/area/mine/unexplored)
"G" = (
/obj/structure/bed/stool/chair/shuttle{
	dir = 1
	},
/obj/effect/decal/cleanable/blood,
/obj/effect/decal/remains/human,
/turf/simulated/floor/shuttle/dark_blue,
/area/mine/unexplored)
"H" = (
/obj/effect/decal/cleanable/blood/drip,
/mob/living/simple_animal/hostile/carp{
	wander = 0
	},
/turf/simulated/floor/shuttle/dark_blue,
/area/mine/unexplored)
"I" = (
/obj/structure/grille,
/obj/structure/window/reinforced{
	dir = 4
	},
/obj/structure/window/reinforced{
	dir = 8
	},
/turf/simulated/floor,
/area/mine/unexplored)
"J" = (
/obj/structure/grille,
/obj/structure/window/reinforced{
	dir = 4
	},
/obj/structure/window/reinforced{
	dir = 8
	},
/obj/structure/window/reinforced,
/turf/simulated/floor,
/area/mine/unexplored)
"K" = (
/obj/item/arrow/rod,
/mob/living/simple_animal/hostile/carp/shark{
	wander = 0
	},
/turf/simulated/floor/shuttle/dark_blue,
/area/mine/unexplored)

(1,1,1) = {"
a
a
a
a
a
a
a
a
a
a
a
a
a
a
a
a
a
a
a
a
a
a
a
a
a
a
a
a
a
a
a
a
"}
(2,1,1) = {"
a
a
a
a
a
a
a
a
a
a
a
a
a
a
a
a
a
a
a
a
a
a
a
a
a
a
a
a
a
a
a
a
"}
(3,1,1) = {"
a
a
a
a
a
a
a
a
a
a
a
a
a
a
a
a
a
a
a
a
a
a
a
a
a
a
a
a
a
a
a
a
"}
(4,1,1) = {"
a
a
a
a
a
a
a
a
a
a
a
a
a
a
a
a
a
a
a
a
a
a
a
a
a
a
a
a
a
a
a
a
"}
(5,1,1) = {"
a
a
a
a
a
a
a
a
a
a
a
a
a
a
a
a
a
a
a
a
a
a
a
a
a
a
a
a
a
a
a
a
"}
(6,1,1) = {"
a
a
a
a
a
a
a
a
a
a
a
a
a
a
a
b
b
b
a
b
a
b
b
b
a
a
a
a
a
a
a
a
"}
(7,1,1) = {"
a
a
a
a
a
a
a
a
a
a
a
a
a
a
b
b
b
b
b
b
b
b
b
b
b
b
a
a
a
a
a
a
"}
(8,1,1) = {"
a
a
a
a
a
a
a
a
a
a
a
a
a
b
b
b
b
b
b
b
b
b
b
b
b
b
b
b
a
a
a
a
"}
(9,1,1) = {"
a
a
a
a
a
a
a
a
a
a
a
a
a
c
b
b
b
b
b
b
b
b
b
b
b
b
b
b
a
a
a
a
"}
(10,1,1) = {"
a
a
a
a
a
a
a
a
a
a
a
a
a
c
d
c
c
c
b
b
b
b
b
b
b
b
b
b
a
a
a
a
"}
(11,1,1) = {"
a
a
a
a
a
a
a
a
a
a
a
a
a
c
c
c
c
c
m
v
b
b
b
b
b
b
b
a
a
a
a
a
"}
(12,1,1) = {"
a
a
a
a
a
a
a
a
a
a
a
a
a
c
c
j
m
m
m
v
K
b
b
b
b
b
b
a
a
a
a
a
"}
(13,1,1) = {"
a
a
a
a
a
a
a
a
a
a
a
a
a
c
c
c
n
q
u
w
B
b
b
b
b
b
b
b
a
a
a
a
"}
(14,1,1) = {"
a
a
a
a
a
a
a
a
a
a
a
a
a
c
e
c
o
w
y
x
w
E
b
b
b
b
b
b
a
a
a
a
"}
(15,1,1) = {"
a
a
a
a
a
a
a
a
a
a
a
a
a
c
f
k
p
t
n
A
H
F
b
b
b
b
b
b
a
a
a
a
"}
(16,1,1) = {"
a
a
a
a
a
a
a
a
a
a
a
a
a
c
f
c
m
m
m
z
C
G
m
b
b
b
b
b
a
a
a
a
"}
(17,1,1) = {"
a
a
a
a
a
a
a
a
a
a
a
a
a
c
c
f
c
c
m
v
A
G
m
b
b
b
b
b
a
a
a
a
"}
(18,1,1) = {"
a
a
a
a
a
a
a
a
a
a
a
a
a
c
c
f
c
c
m
D
I
J
m
a
b
b
b
a
a
a
a
a
"}
(19,1,1) = {"
a
a
a
a
a
a
a
a
a
a
a
a
a
c
f
l
c
c
a
a
a
a
a
a
a
b
b
b
a
a
a
a
"}
(20,1,1) = {"
a
a
a
a
a
a
a
a
a
a
a
a
a
c
i
c
c
c
a
a
a
a
a
a
a
a
a
b
a
a
a
a
"}
(21,1,1) = {"
a
a
a
a
a
a
a
a
a
a
a
a
a
c
c
c
a
a
a
a
a
a
a
a
a
a
a
a
a
a
a
a
"}
(22,1,1) = {"
a
a
a
a
a
a
a
a
a
a
a
a
a
a
a
a
a
a
a
a
a
a
a
a
a
a
a
a
a
a
a
a
"}
(23,1,1) = {"
a
a
a
a
a
a
a
a
a
a
a
a
a
a
a
a
a
a
a
a
a
a
a
a
a
a
a
a
a
a
a
a
"}
(24,1,1) = {"
a
a
a
a
a
a
a
a
a
a
a
a
a
a
a
a
a
a
a
a
a
a
a
a
a
a
a
a
a
a
a
a
"}
(25,1,1) = {"
a
a
a
a
a
a
a
a
a
a
a
a
a
a
a
a
a
a
a
a
a
a
a
a
a
a
a
a
a
a
a
a
"}
(26,1,1) = {"
a
a
a
a
a
a
a
a
a
a
a
a
a
a
a
a
a
a
a
a
a
a
a
a
a
a
a
a
a
a
a
a
"}
(27,1,1) = {"
a
a
a
a
a
a
a
a
a
a
a
a
a
a
a
a
a
a
a
a
a
a
a
a
a
a
a
a
a
a
a
a
"}
(28,1,1) = {"
a
a
a
a
a
a
a
a
a
a
a
a
a
a
a
a
a
a
a
a
a
a
a
a
a
a
a
a
a
a
a
a
"}
(29,1,1) = {"
a
a
a
a
a
a
a
a
a
a
a
a
a
a
a
a
a
a
a
a
a
a
a
a
a
a
a
a
a
a
a
a
"}
(30,1,1) = {"
a
a
a
a
a
a
a
a
a
a
a
a
a
a
a
a
a
a
a
a
a
a
a
a
a
a
a
a
a
a
a
a
"}
(31,1,1) = {"
a
a
a
a
a
a
a
a
a
a
a
a
a
a
a
a
a
a
a
a
a
a
a
a
a
a
a
a
a
a
a
a
"}
(32,1,1) = {"
a
a
a
a
a
a
a
a
a
a
a
a
a
a
a
a
a
a
a
a
a
a
a
a
a
a
a
a
a
a
a
a
"}
