//MAP CONVERTED BY dmm2tgm.py THIS HEADER COMMENT PREVENTS RECONVERSION, DO NOT REMOVE
"a" = (
/turf/unsimulated/chasm_mask,
/area/mine/unexplored)
"b" = (
/turf/simulated/mineral/random,
/area/mine/unexplored)
"c" = (
/turf/simulated/shuttle/wall,
/area/mine/unexplored)
"d" = (
/obj/structure/window/shuttle,
/obj/structure/grille,
/turf/simulated/shuttle/plating,
/area/mine/unexplored)
"e" = (
/obj/structure/bed/chair{
	dir = 1
	},
/obj/effect/decal/remains/human,
/obj/random/voidsuit,
/obj/random/energy_antag,
/obj/random/smalltank,
/obj/item/device/gps,
/turf/simulated/shuttle/floor,
/area/mine/unexplored)
"f" = (
/obj/item/weapon/archaeological_find,
/turf/simulated/shuttle/floor,
/area/mine/unexplored)
"g" = (
/obj/structure/shuttle/engine/propulsion/burst,
/turf/simulated/shuttle/wall{
	icon_state = "swall";
	dir = 1
	},
/area/mine/unexplored)
"h" = (
/obj/machinery/door/airlock/external,
/turf/simulated/shuttle/floor,
/area/mine/unexplored)
"i" = (
/turf/simulated/floor/asteroid/ash/rocky,
/area/mine/unexplored)
"j" = (
/mob/living/simple_animal/hostile/carp/shark,
/turf/simulated/floor/asteroid/ash/rocky,
/area/mine/unexplored)
"k" = (
/turf/simulated/open/airless,
/area/mine/unexplored)
"l" = (
/obj/structure/closet/crate/secure/loot,
/turf/simulated/floor/asteroid/ash/rocky,
/area/mine/unexplored)

(1,1,1) = {"
a
a
a
a
a
a
a
a
a
a
a
a
a
a
a
a
a
a
a
a
a
a
k
a
a
a
a
a
a
a
a
i
"}
(2,1,1) = {"
a
a
a
a
a
a
a
a
a
a
a
a
a
a
a
a
a
a
a
a
a
a
k
a
a
a
a
a
a
a
i
i
"}
(3,1,1) = {"
a
a
a
a
a
a
a
a
a
a
a
a
a
a
a
a
a
a
a
a
a
k
k
a
a
a
a
a
a
i
i
i
"}
(4,1,1) = {"
a
a
a
a
a
a
a
a
a
a
a
a
a
a
a
a
a
a
a
a
a
k
a
a
a
a
a
a
i
i
i
i
"}
(5,1,1) = {"
a
a
a
a
a
a
a
a
a
a
a
a
a
a
a
a
a
a
a
a
a
k
a
a
a
a
a
i
i
i
i
i
"}
(6,1,1) = {"
a
a
a
a
a
a
a
a
a
a
a
a
a
a
a
a
a
a
a
a
k
k
a
a
a
a
a
i
i
i
i
i
"}
(7,1,1) = {"
a
a
a
a
a
a
a
a
a
a
a
a
a
a
a
a
a
a
a
a
k
a
a
a
a
a
i
i
i
i
i
i
"}
(8,1,1) = {"
a
a
a
a
a
a
a
a
a
a
a
a
a
a
a
a
a
a
a
k
k
a
a
a
a
i
i
i
i
i
i
i
"}
(9,1,1) = {"
a
a
a
a
a
a
a
a
a
a
a
a
a
a
a
a
a
a
k
k
a
a
a
a
i
i
i
i
i
i
i
i
"}
(10,1,1) = {"
a
a
a
a
a
a
a
a
a
a
a
a
a
a
a
a
a
k
k
a
a
a
a
i
i
i
i
i
i
i
i
i
"}
(11,1,1) = {"
a
a
a
a
a
a
a
a
a
a
a
a
a
a
a
a
a
k
a
a
a
a
i
i
i
i
i
i
i
i
i
i
"}
(12,1,1) = {"
a
a
a
a
a
a
a
a
a
a
a
a
a
a
a
a
a
k
a
a
a
i
i
i
i
i
i
i
i
i
i
i
"}
(13,1,1) = {"
a
a
a
a
a
a
a
a
a
a
a
b
b
b
a
a
k
k
a
a
i
i
i
i
i
i
i
i
i
i
i
i
"}
(14,1,1) = {"
a
a
a
a
a
a
a
a
a
a
b
b
b
b
b
b
k
a
a
i
i
i
i
i
i
i
i
i
i
i
i
i
"}
(15,1,1) = {"
a
a
a
a
a
a
a
a
b
b
b
b
b
b
b
b
b
a
i
i
i
i
i
i
i
i
i
i
i
i
i
i
"}
(16,1,1) = {"
a
a
a
a
a
a
a
a
b
b
b
b
i
c
c
c
g
i
i
i
i
i
i
i
i
i
i
i
i
i
i
i
"}
(17,1,1) = {"
a
a
a
a
a
a
a
a
b
i
l
i
j
d
f
e
h
i
i
i
i
i
i
i
i
i
i
i
i
i
i
i
"}
(18,1,1) = {"
a
a
a
a
a
a
a
a
b
k
k
b
i
c
c
c
g
i
i
i
i
i
i
i
i
i
i
i
i
i
i
i
"}
(19,1,1) = {"
a
a
a
a
a
a
a
a
b
b
k
b
b
b
b
b
b
a
i
i
i
i
i
i
i
i
i
i
i
i
i
i
"}
(20,1,1) = {"
a
a
a
a
a
a
a
a
a
b
b
b
b
b
b
b
k
a
a
i
i
i
i
i
i
i
i
i
i
i
i
i
"}
(21,1,1) = {"
a
a
a
a
a
a
a
a
a
a
a
a
a
b
b
b
k
k
a
a
i
i
i
i
i
i
i
i
i
i
i
i
"}
(22,1,1) = {"
a
a
a
a
a
a
a
a
a
a
a
a
a
a
a
a
a
k
a
a
a
i
i
i
i
i
i
i
i
i
i
i
"}
(23,1,1) = {"
a
a
a
a
a
a
a
a
a
a
a
a
a
a
a
a
a
k
a
a
a
a
i
i
i
i
i
i
i
i
i
i
"}
(24,1,1) = {"
a
a
a
a
a
a
a
a
a
a
a
a
a
a
a
a
a
k
k
a
a
a
a
i
i
i
i
i
i
i
i
i
"}
(25,1,1) = {"
a
a
a
a
a
a
a
a
a
a
a
a
a
a
a
a
a
a
k
a
a
a
a
a
i
i
i
i
i
i
i
i
"}
(26,1,1) = {"
a
a
a
a
a
a
a
a
a
a
a
a
a
a
a
a
a
a
k
k
a
a
a
a
a
i
i
i
i
i
i
i
"}
(27,1,1) = {"
a
a
a
a
a
a
a
a
a
a
a
a
a
a
a
a
a
a
a
k
a
a
a
a
a
a
i
i
i
i
i
i
"}
(28,1,1) = {"
a
a
a
a
a
a
a
a
a
a
a
a
a
a
a
a
a
a
a
k
k
a
a
a
a
a
a
i
i
i
i
i
"}
(29,1,1) = {"
a
a
a
a
a
a
a
a
a
a
a
a
a
a
a
a
a
a
a
a
k
k
a
a
a
a
a
a
i
i
i
i
"}
(30,1,1) = {"
a
a
a
a
a
a
a
a
a
a
a
a
a
a
a
a
a
a
a
a
a
k
k
a
a
a
a
a
a
i
i
i
"}
(31,1,1) = {"
a
a
a
a
a
a
a
a
a
a
a
a
a
a
a
a
a
a
a
a
a
a
k
a
a
a
a
a
a
a
i
i
"}
(32,1,1) = {"
a
a
a
a
a
a
a
a
a
a
a
a
a
a
a
a
a
a
a
a
a
a
k
k
a
a
a
a
a
a
a
i
"}
