//MAP CONVERTED BY dmm2tgm.py THIS HEADER COMMENT PREVENTS RECONVERSION, DO NOT REMOVE
"a" = (
/turf/unsimulated/chasm_mask,
/area/mine/unexplored)
"b" = (
/turf/simulated/mineral,
/area/mine/unexplored)
"c" = (
/obj/random/spacecash,
/turf/simulated/floor/asteroid/ash/rocky,
/area/mine/unexplored)
"d" = (
/turf/simulated/floor/asteroid/ash/rocky,
/area/mine/unexplored)
"e" = (
/obj/item/weapon/ore/phoron,
/turf/simulated/floor/asteroid/ash/rocky,
/area/mine/unexplored)
"f" = (
/obj/item/weapon/ore,
/turf/simulated/floor/asteroid/ash/rocky,
/area/mine/unexplored)
"g" = (
/mob/living/simple_animal/hostile/retaliate/minedrone,
/turf/simulated/floor/asteroid/ash/rocky,
/area/mine/unexplored)
"h" = (
/obj/structure/table/rack,
/obj/item/clothing/suit/space/void/mining,
/obj/item/clothing/head/helmet/space/void/mining,
/turf/simulated/floor/airless/ceiling,
/area/mine/unexplored)
"i" = (
/obj/structure/table/rack,
/obj/item/weapon/pickaxe/jackhammer,
/turf/simulated/floor/airless/ceiling,
/area/mine/unexplored)
"j" = (
/obj/random/custom_ka,
/obj/structure/table/rack,
/turf/simulated/floor/airless/ceiling,
/area/mine/unexplored)
"k" = (
/obj/structure/ore_box,
/turf/simulated/floor/airless/ceiling,
/area/mine/unexplored)
"l" = (
/obj/structure/table/rack,
/obj/random/firstaid,
/turf/simulated/floor/airless/ceiling,
/area/mine/unexplored)
"m" = (
/obj/structure/table/rack,
/obj/random/backpack,
/turf/simulated/floor/airless/ceiling,
/area/mine/unexplored)
"n" = (
/obj/random/junk,
/turf/simulated/floor/asteroid/ash/rocky,
/area/mine/unexplored)
"o" = (
/obj/machinery/floodlight{
	on = 1
	},
/turf/simulated/floor/asteroid/ash/rocky,
/area/mine/unexplored)
"p" = (
/obj/item/weapon/ore/iron,
/turf/simulated/floor/asteroid/ash/rocky,
/area/mine/unexplored)
"q" = (
/obj/structure/ore_box,
/turf/simulated/floor/asteroid/ash/rocky,
/area/mine/unexplored)
"r" = (
/mob/living/silicon/robot/drone/mining,
/turf/simulated/floor/asteroid/ash/rocky,
/area/mine/unexplored)
"s" = (
/turf/simulated/floor/airless/ceiling,
/area/mine/unexplored)
"t" = (
/obj/item/weapon/ore/hydrogen,
/turf/simulated/floor/asteroid/ash/rocky,
/area/mine/unexplored)
"u" = (
/obj/structure/table/standard,
/obj/random/toolbox,
/turf/simulated/floor/airless/ceiling,
/area/mine/unexplored)
"v" = (
/obj/mecha/working/ripley/mining,
/obj/machinery/mech_recharger,
/turf/simulated/floor/airless/ceiling,
/area/mine/unexplored)
"w" = (
/obj/structure/table/rack,
/obj/random/tech_supply,
/turf/simulated/floor/airless/ceiling,
/area/mine/unexplored)
"x" = (
/obj/structure/closet/crate,
/obj/item/weapon/ore/diamond,
/obj/item/weapon/ore/diamond,
/obj/item/weapon/ore/diamond,
/obj/item/weapon/ore/diamond,
/turf/simulated/floor/asteroid/ash/rocky,
/area/mine/unexplored)
"y" = (
/obj/item/weapon/ore/uranium,
/turf/simulated/floor/asteroid/ash/rocky,
/area/mine/unexplored)
"z" = (
/obj/structure/closet/crate/secure/loot,
/turf/simulated/floor/airless/ceiling,
/area/mine/unexplored)
"A" = (
/obj/structure/closet/excavation,
/turf/simulated/floor/airless/ceiling,
/area/mine/unexplored)
"B" = (
/obj/structure/closet/toolcloset,
/turf/simulated/floor/airless/ceiling,
/area/mine/unexplored)
"C" = (
/obj/item/weapon/ore/osmium,
/turf/simulated/floor/asteroid/ash/rocky,
/area/mine/unexplored)
"D" = (
/obj/item/weapon/storage/bag/ore,
/turf/simulated/floor/asteroid/ash/rocky,
/area/mine/unexplored)
"E" = (
/obj/structure/closet/crate,
/obj/item/weapon/ore/strangerock,
/turf/simulated/floor/asteroid/ash/rocky,
/area/mine/unexplored)

(1,1,1) = {"
a
a
a
a
a
a
a
a
a
a
a
a
a
a
a
a
a
a
a
a
a
a
a
a
a
a
a
a
a
a
a
a
"}
(2,1,1) = {"
a
a
a
a
a
a
a
a
a
a
a
a
a
a
a
a
a
a
a
a
a
a
a
a
a
a
a
a
a
a
a
a
"}
(3,1,1) = {"
a
a
a
a
a
a
a
a
a
a
a
a
a
a
a
a
a
a
a
a
a
a
a
a
a
a
a
a
a
a
a
a
"}
(4,1,1) = {"
a
a
a
a
a
a
a
a
a
a
a
a
a
a
a
a
a
a
a
a
a
a
a
a
a
a
a
a
a
a
a
a
"}
(5,1,1) = {"
a
a
a
a
a
a
a
a
a
a
a
a
a
a
a
a
a
a
a
a
a
a
a
a
a
b
a
a
a
a
a
a
"}
(6,1,1) = {"
a
a
a
a
a
a
a
a
a
a
a
a
a
a
a
a
a
a
a
b
b
b
b
b
b
b
a
a
a
a
a
a
"}
(7,1,1) = {"
a
a
a
a
a
a
a
a
a
a
a
a
a
a
a
a
a
a
b
b
q
d
d
d
b
b
a
a
a
a
a
a
"}
(8,1,1) = {"
a
a
a
a
a
a
a
a
a
a
a
a
a
a
a
a
a
a
b
b
q
d
C
d
E
b
a
a
a
a
a
a
"}
(9,1,1) = {"
a
a
a
a
a
a
a
a
a
a
a
a
a
a
a
a
a
a
b
x
d
d
d
f
d
b
a
a
a
a
a
a
"}
(10,1,1) = {"
a
a
a
a
a
a
a
a
a
a
a
b
b
b
b
b
b
b
b
d
d
d
d
d
g
b
a
a
a
a
a
a
"}
(11,1,1) = {"
a
a
a
a
a
a
a
a
a
a
a
b
d
d
d
g
b
d
f
d
d
d
n
d
f
b
a
a
a
a
a
a
"}
(12,1,1) = {"
a
a
a
a
a
a
a
a
a
a
b
b
d
d
d
d
d
d
d
y
d
f
d
d
d
b
b
a
a
a
a
a
"}
(13,1,1) = {"
a
a
a
a
a
a
a
a
a
a
b
h
f
d
r
d
d
n
d
d
d
d
d
D
b
b
b
a
a
a
a
a
"}
(14,1,1) = {"
a
a
a
a
a
a
a
a
a
a
b
i
d
n
d
d
d
d
d
d
d
d
d
b
b
b
b
a
a
a
a
a
"}
(15,1,1) = {"
a
a
a
a
a
a
a
a
a
a
b
j
d
d
d
s
u
s
d
d
d
d
d
b
b
b
a
a
a
a
a
a
"}
(16,1,1) = {"
a
a
a
a
a
a
a
a
a
a
b
k
d
o
d
s
v
s
d
d
d
d
b
b
b
a
a
a
a
a
a
a
"}
(17,1,1) = {"
a
a
a
a
a
a
a
a
a
a
b
b
d
d
d
s
w
s
d
d
d
b
b
b
a
a
a
a
a
a
a
a
"}
(18,1,1) = {"
a
a
a
a
a
a
a
a
a
a
b
b
d
d
d
d
d
d
d
d
d
d
b
a
a
a
a
a
a
a
a
a
"}
(19,1,1) = {"
a
a
a
a
a
a
a
a
a
a
b
b
d
p
d
g
d
d
d
d
d
n
b
a
a
a
a
a
a
a
a
a
"}
(20,1,1) = {"
a
a
a
a
a
a
a
a
a
a
b
d
d
d
d
d
d
d
f
d
d
d
b
a
a
a
a
a
a
a
a
a
"}
(21,1,1) = {"
a
a
a
a
a
a
a
a
a
a
b
d
e
d
d
d
d
d
d
d
d
z
b
a
a
a
a
a
a
a
a
a
"}
(22,1,1) = {"
a
a
a
a
a
a
a
a
a
a
b
b
d
d
d
d
f
d
d
d
d
z
b
a
a
a
a
a
a
a
a
a
"}
(23,1,1) = {"
a
a
a
a
a
a
a
a
a
a
a
b
d
f
d
d
d
p
d
d
d
A
b
a
a
a
a
a
a
a
a
a
"}
(24,1,1) = {"
a
a
a
a
a
a
a
a
a
b
b
b
d
d
d
d
d
d
d
d
g
B
b
a
a
a
a
a
a
a
a
a
"}
(25,1,1) = {"
a
a
a
a
a
a
b
b
b
b
d
d
d
d
d
t
d
d
d
d
d
b
b
a
a
a
a
a
a
a
a
a
"}
(26,1,1) = {"
a
a
a
a
a
a
b
c
f
d
d
d
d
d
d
f
d
d
b
d
b
b
b
a
a
a
a
a
a
a
a
a
"}
(27,1,1) = {"
a
a
a
a
a
a
b
d
d
d
e
d
d
d
d
d
d
b
b
b
b
a
a
a
a
a
a
a
a
a
a
a
"}
(28,1,1) = {"
a
a
a
a
a
a
b
d
d
g
d
d
f
d
d
d
d
b
b
a
a
a
a
a
a
a
a
a
a
a
a
a
"}
(29,1,1) = {"
a
a
a
a
a
a
b
e
d
d
d
l
m
q
q
b
b
b
b
a
a
a
a
a
a
a
a
a
a
a
a
a
"}
(30,1,1) = {"
a
a
a
a
a
a
b
b
b
b
b
b
b
b
b
b
b
a
a
a
a
a
a
a
a
a
a
a
a
a
a
a
"}
(31,1,1) = {"
a
a
a
a
a
a
b
b
b
a
a
b
b
b
b
b
a
a
a
a
a
a
a
a
a
a
a
a
a
a
a
a
"}
(32,1,1) = {"
a
a
a
a
a
a
a
a
a
a
a
a
a
a
a
a
a
a
a
a
a
a
a
a
a
a
a
a
a
a
a
a
"}
