//MAP CONVERTED BY dmm2tgm.py THIS HEADER COMMENT PREVENTS RECONVERSION, DO NOT REMOVE
"a" = (
/turf/unsimulated/chasm_mask,
/area/mine/unexplored)
"b" = (
/turf/unsimulated/floor/asteroid/ash/rocky,
/area/mine/unexplored)
"c" = (
/turf/simulated/mineral,
/area/mine/unexplored)
"d" = (
/obj/structure/girder,
/turf/unsimulated/floor/asteroid/ash/rocky,
/area/mine/unexplored)
"e" = (
/obj/structure/girder,
/turf/unsimulated/floor/asteroid/ash/rocky,
/area/dungeon/crashed_satellite)
"f" = (
/obj/effect/decal/cleanable/liquid_fuel,
/obj/machinery/power/smes/batteryrack,
/turf/simulated/floor/airless,
/area/dungeon/crashed_satellite)
"g" = (
/obj/structure/lattice,
/obj/item/stack/cable_coil/cut,
/turf/unsimulated/floor/asteroid/ash/rocky,
/area/mine/unexplored)
"h" = (
/obj/effect/decal/cleanable/liquid_fuel,
/obj/structure/computerframe,
/obj/item/material/shard,
/turf/simulated/floor/airless,
/area/dungeon/crashed_satellite)
"i" = (
/obj/effect/decal/cleanable/liquid_fuel,
/obj/structure/computerframe{
	},
/obj/item/device/gps,
/obj/item/material/shard,
/turf/simulated/floor/airless,
/area/dungeon/crashed_satellite)
"j" = (
/obj/effect/decal/cleanable/liquid_fuel,
/obj/random/tool,
/turf/simulated/floor/airless,
/area/dungeon/crashed_satellite)
"k" = (
/obj/effect/decal/cleanable/liquid_fuel,
/obj/effect/decal/cleanable/blood/oil,
/turf/simulated/floor/airless,
/area/dungeon/crashed_satellite)
"l" = (
/obj/item/stack/material/steel,
/turf/unsimulated/floor/asteroid/ash/rocky,
/area/mine/unexplored)
"m" = (
/obj/effect/decal/cleanable/liquid_fuel,
/turf/unsimulated/floor/asteroid/ash/rocky,
/area/mine/unexplored)
"n" = (
/obj/item/arrow/rod,
/turf/unsimulated/floor/asteroid/ash/rocky,
/area/mine/unexplored)
"o" = (
/obj/effect/decal/remains/robot,
/turf/unsimulated/floor/asteroid/ash/rocky,
/area/mine/unexplored)
"p" = (
/obj/structure/lattice,
/obj/effect/decal/cleanable/liquid_fuel,
/turf/unsimulated/floor/asteroid/ash/rocky,
/area/mine/unexplored)
"q" = (
/obj/effect/decal/cleanable/liquid_fuel,
/obj/effect/decal/cleanable/liquid_fuel,
/turf/unsimulated/floor/asteroid/ash/rocky,
/area/mine/unexplored)
"r" = (
/obj/effect/decal/cleanable/liquid_fuel,
/obj/effect/decal/cleanable/liquid_fuel,
/obj/effect/decal/cleanable/blood/oil,
/turf/unsimulated/floor/asteroid/ash/rocky,
/area/mine/unexplored)
"s" = (
/obj/effect/decal/cleanable/liquid_fuel,
/obj/random/junk,
/turf/simulated/floor/airless,
/area/dungeon/crashed_satellite)
"t" = (
/obj/structure/lattice,
/obj/item/stack/material/steel,
/obj/effect/decal/cleanable/liquid_fuel,
/turf/unsimulated/floor/asteroid/ash/rocky,
/area/mine/unexplored)
"u" = (
/obj/item/arrow/rod,
/obj/effect/decal/cleanable/liquid_fuel,
/obj/effect/decal/cleanable/liquid_fuel,
/obj/effect/decal/cleanable/liquid_fuel,
/turf/unsimulated/floor/asteroid/ash/rocky,
/area/mine/unexplored)
"v" = (
/obj/structure/lattice,
/obj/effect/decal/cleanable/liquid_fuel,
/obj/effect/decal/cleanable/ash,
/turf/unsimulated/floor/asteroid/ash/rocky,
/area/mine/unexplored)
"w" = (
/obj/effect/decal/cleanable/liquid_fuel,
/obj/effect/decal/cleanable/liquid_fuel,
/obj/effect/decal/cleanable/liquid_fuel,
/turf/unsimulated/floor/asteroid/ash/rocky,
/area/mine/unexplored)
"x" = (
/obj/item/stack/material/steel,
/obj/effect/decal/cleanable/liquid_fuel,
/obj/effect/decal/cleanable/liquid_fuel,
/turf/unsimulated/floor/asteroid/ash/rocky,
/area/mine/unexplored)
"y" = (
/obj/effect/decal/cleanable/liquid_fuel,
/obj/effect/decal/cleanable/blood/oil,
/turf/unsimulated/floor/asteroid/ash/rocky,
/area/mine/unexplored)
"z" = (
/obj/item/arrow/rod,
/obj/effect/decal/cleanable/liquid_fuel,
/turf/unsimulated/floor/asteroid/ash/rocky,
/area/mine/unexplored)
"A" = (
/obj/item/stack/material/steel,
/obj/effect/decal/cleanable/liquid_fuel,
/obj/effect/decal/cleanable/ash,
/turf/unsimulated/floor/asteroid/ash/rocky,
/area/mine/unexplored)
"B" = (
/obj/effect/decal/cleanable/liquid_fuel,
/obj/effect/decal/cleanable/ash,
/turf/unsimulated/floor/asteroid/ash/rocky,
/area/mine/unexplored)
"C" = (
/obj/effect/decal/remains/robot,
/obj/effect/decal/cleanable/liquid_fuel,
/turf/unsimulated/floor/asteroid/ash/rocky,
/area/mine/unexplored)
"D" = (
/obj/structure/lattice,
/obj/item/material/shard,
/turf/unsimulated/floor/asteroid/ash/rocky,
/area/mine/unexplored)
"E" = (
/turf/simulated/wall/shuttle/dark,
/area/dungeon/crashed_satellite)
"F" = (
/obj/structure/lattice,
/turf/unsimulated/floor/asteroid/ash/rocky,
/area/mine/unexplored)
"G" = (
/obj/structure/lattice,
/obj/item/solar_assembly,
/turf/unsimulated/floor/asteroid/ash/rocky,
/area/mine/unexplored)
"H" = (
/obj/effect/decal/cleanable/liquid_fuel,
/obj/effect/decal/cleanable/blood/oil,
/obj/item/bluespace_crystal,
/turf/simulated/floor/airless,
/area/dungeon/crashed_satellite)
"I" = (
/obj/effect/decal/cleanable/liquid_fuel,
/obj/item/bluespace_crystal,
/turf/simulated/floor/airless,
/area/dungeon/crashed_satellite)
"J" = (
/obj/effect/decal/cleanable/liquid_fuel,
/obj/effect/decal/cleanable/liquid_fuel,
/obj/random/junk,
/turf/unsimulated/floor/asteroid/ash/rocky,
/area/mine/unexplored)
"K" = (
/obj/effect/decal/cleanable/liquid_fuel,
/obj/random/junk,
/turf/unsimulated/floor/asteroid/ash/rocky,
/area/mine/unexplored)
"L" = (
/obj/random/tool,
/turf/unsimulated/floor/asteroid/ash/rocky,
/area/mine/unexplored)
"M" = (
/obj/random/loot,
/turf/unsimulated/floor/asteroid/ash/rocky,
/area/mine/unexplored)
"N" = (
/obj/item/material/shard,
/turf/unsimulated/floor/asteroid/ash/rocky,
/area/mine/unexplored)
"O" = (
/mob/living/simple_animal/hostile/carp,
/turf/unsimulated/floor/asteroid/ash/rocky,
/area/mine/unexplored)
"P" = (
/obj/effect/decal/cleanable/liquid_fuel,
/obj/effect/decal/cleanable/ash,
/obj/effect/decal/cleanable/liquid_fuel,
/turf/simulated/floor/airless,
/area/dungeon/crashed_satellite)
"Q" = (
/obj/item/bluespace_crystal,
/mob/living/simple_animal/hostile/carp/shark{
	dir = 8;
	wander = 0
	},
/turf/simulated/floor/airless,
/area/dungeon/crashed_satellite)
"R" = (
/obj/effect/decal/remains/robot,
/obj/effect/decal/cleanable/liquid_fuel,
/obj/item/stack/cable_coil/cut,
/turf/simulated/floor/airless,
/area/dungeon/crashed_satellite)
"S" = (
/obj/structure/lattice,
/obj/effect/decal/cleanable/liquid_fuel,
/obj/item/stack/cable_coil/cut,
/turf/unsimulated/floor/asteroid/ash/rocky,
/area/mine/unexplored)
"T" = (
/obj/effect/decal/cleanable/liquid_fuel,
/obj/effect/decal/cleanable/liquid_fuel,
/turf/simulated/floor/airless,
/area/dungeon/crashed_satellite)
"U" = (
/obj/effect/decal/cleanable/liquid_fuel,
/turf/simulated/wall/shuttle/dark,
/area/dungeon/crashed_satellite)
"V" = (
/obj/structure/lattice,
/obj/effect/decal/cleanable/liquid_fuel,
/obj/effect/decal/cleanable/liquid_fuel,
/obj/item/solar_assembly,
/obj/item/material/shard,
/turf/unsimulated/floor/asteroid/ash/rocky,
/area/mine/unexplored)

(1,1,1) = {"
a
a
a
a
a
a
a
a
a
a
a
a
a
a
a
a
a
a
a
a
a
a
a
a
a
a
a
a
a
a
a
a
"}
(2,1,1) = {"
a
a
a
a
a
a
a
a
a
a
a
a
a
a
a
a
a
a
a
a
a
a
a
a
a
a
a
a
a
a
a
a
"}
(3,1,1) = {"
a
a
a
a
a
a
a
a
a
a
a
a
a
a
a
a
a
a
a
a
a
a
a
a
a
a
a
a
a
a
a
a
"}
(4,1,1) = {"
a
a
a
a
a
a
a
a
a
a
a
a
a
a
a
a
a
a
a
a
a
a
a
a
a
a
a
a
a
a
a
a
"}
(5,1,1) = {"
a
a
a
a
a
a
a
a
a
a
a
a
a
a
a
a
a
a
a
a
a
a
a
a
a
a
a
a
a
a
a
a
"}
(6,1,1) = {"
a
a
a
a
a
a
a
a
a
a
a
a
a
a
a
a
a
a
a
a
a
a
a
a
a
a
a
a
a
a
a
a
"}
(7,1,1) = {"
a
a
a
a
a
a
a
a
a
a
a
a
a
a
a
a
a
a
a
a
a
a
a
a
a
a
a
a
a
a
a
a
"}
(8,1,1) = {"
a
a
a
a
a
a
a
a
a
a
a
a
a
a
a
c
c
c
c
a
a
a
a
a
a
a
a
a
a
a
a
a
"}
(9,1,1) = {"
a
a
a
a
a
a
a
a
a
a
a
a
a
a
c
c
c
c
c
c
c
c
a
a
a
a
a
a
a
a
a
a
"}
(10,1,1) = {"
a
a
a
a
a
a
a
a
a
a
a
a
a
c
c
c
c
c
c
c
c
c
c
a
a
a
a
a
a
a
a
a
"}
(11,1,1) = {"
a
a
a
a
a
a
a
a
a
a
a
a
c
c
c
c
c
c
c
c
c
c
c
c
a
a
a
a
a
a
a
a
"}
(12,1,1) = {"
a
a
a
a
a
a
a
a
a
a
a
a
c
c
c
c
c
c
c
c
c
c
c
b
b
a
a
a
a
a
a
a
"}
(13,1,1) = {"
a
a
a
a
a
a
a
a
a
a
a
c
c
c
c
c
c
c
c
c
c
c
b
b
b
a
a
a
a
a
a
a
"}
(14,1,1) = {"
a
a
a
a
a
a
a
a
a
a
a
c
c
c
c
c
c
c
c
E
b
b
b
b
b
b
a
a
a
a
a
a
"}
(15,1,1) = {"
a
a
a
a
a
a
a
a
a
a
a
c
c
c
c
c
c
i
H
E
E
b
b
b
b
b
b
a
a
a
a
a
"}
(16,1,1) = {"
a
a
a
a
a
a
a
a
a
a
a
c
c
c
c
c
c
j
I
R
E
b
b
b
M
b
b
a
a
a
a
a
"}
(17,1,1) = {"
a
a
a
a
a
a
a
a
a
a
a
c
c
c
c
c
f
k
P
T
I
d
b
O
b
b
b
a
a
a
a
a
"}
(18,1,1) = {"
a
a
a
a
a
a
a
a
a
a
a
a
c
c
c
c
h
s
Q
U
p
r
q
l
b
b
b
b
a
a
a
a
"}
(19,1,1) = {"
a
a
a
a
a
a
a
a
a
a
a
a
c
c
c
e
e
E
E
l
S
V
u
m
K
n
b
b
b
a
a
a
"}
(20,1,1) = {"
a
a
a
a
a
a
a
a
a
a
a
a
c
c
b
N
g
M
b
m
q
t
v
m
y
L
b
b
b
a
a
a
"}
(21,1,1) = {"
a
a
a
a
a
a
a
a
a
a
a
a
b
b
D
F
G
N
b
n
m
J
w
q
A
m
l
b
b
a
a
a
"}
(22,1,1) = {"
a
a
a
a
a
a
a
a
a
a
a
a
b
b
b
F
b
b
b
o
b
m
x
y
z
C
b
b
b
a
a
a
"}
(23,1,1) = {"
a
a
a
a
a
a
a
a
a
a
a
a
b
F
G
b
b
N
b
b
b
m
q
z
B
l
n
b
b
a
a
a
"}
(24,1,1) = {"
a
a
a
a
a
a
a
a
a
a
a
a
b
b
b
b
b
b
b
b
b
b
b
m
q
b
b
b
b
b
a
a
"}
(25,1,1) = {"
a
a
a
a
a
a
a
a
a
a
a
a
a
b
b
b
b
b
b
b
b
b
b
b
b
b
b
n
b
b
a
a
"}
(26,1,1) = {"
a
a
a
a
a
a
a
a
a
a
a
a
a
a
a
a
b
b
b
b
b
b
b
b
b
b
b
b
b
b
a
a
"}
(27,1,1) = {"
a
a
a
a
a
a
a
a
a
a
a
a
a
a
a
a
a
a
a
b
b
b
b
b
b
b
b
b
b
b
b
a
"}
(28,1,1) = {"
a
a
a
a
a
a
a
a
a
a
a
a
a
a
a
a
a
a
a
a
b
b
b
b
b
b
b
b
b
b
b
a
"}
(29,1,1) = {"
a
a
a
a
a
a
a
a
a
a
a
a
a
a
a
a
a
a
a
a
a
b
b
b
b
b
b
b
b
b
b
a
"}
(30,1,1) = {"
a
a
a
a
a
a
a
a
a
a
a
a
a
a
a
a
a
a
a
a
a
a
a
a
a
a
a
b
b
b
b
a
"}
(31,1,1) = {"
a
a
a
a
a
a
a
a
a
a
a
a
a
a
a
a
a
a
a
a
a
a
a
a
a
a
a
a
a
a
a
a
"}
(32,1,1) = {"
a
a
a
a
a
a
a
a
a
a
a
a
a
a
a
a
a
a
a
a
a
a
a
a
a
a
a
a
a
a
a
a
"}
