//MAP CONVERTED BY dmm2tgm.py THIS HEADER COMMENT PREVENTS RECONVERSION, DO NOT REMOVE
"a" = (
/turf/unsimulated/chasm_mask,
/area/mine/unexplored)
"b" = (
/turf/simulated/wall/phoron,
/area/mine/unexplored)
"c" = (
/turf/simulated/floor/phoron,
/area/mine/unexplored)
"d" = (
/obj/structure/simple_door/phoron,
/turf/simulated/floor/phoron,
/area/mine/unexplored)
"e" = (
/turf/simulated/wall/sandstonediamond,
/area/mine/unexplored)
"f" = (
/obj/structure/window/phoronreinforced,
/turf/simulated/floor/phoron,
/area/mine/unexplored)
"g" = (
/obj/structure/window/phoronreinforced{
	icon_state = "phoronrwindow";
	dir = 4
	},
/turf/simulated/floor/phoron,
/area/mine/unexplored)
"h" = (
/obj/machinery/artifact,
/turf/simulated/floor/airless/ceiling,
/area/mine/unexplored)
"i" = (
/obj/structure/window/phoronreinforced{
	icon_state = "phoronrwindow";
	dir = 8
	},
/turf/simulated/floor/phoron,
/area/mine/unexplored)
"j" = (
/obj/structure/window/phoronreinforced{
	icon_state = "phoronrwindow";
	dir = 1
	},
/turf/simulated/floor/phoron,
/area/mine/unexplored)
"k" = (
/turf/simulated/floor/airless/ceiling,
/area/mine/unexplored)
"l" = (
/turf/unsimulated/floor/asteroid/ash,
/area/mine/unexplored)
"m" = (
/turf/simulated/open/airless,
/area/mine/unexplored)

(1,1,1) = {"
a
a
a
a
a
a
a
a
a
a
a
a
a
a
a
a
a
a
a
a
a
a
a
a
a
a
a
a
a
a
a
a
"}
(2,1,1) = {"
a
a
a
a
a
a
a
a
a
a
a
a
a
a
a
a
a
a
a
a
a
a
a
a
a
a
a
a
a
a
a
a
"}
(3,1,1) = {"
a
a
a
a
a
a
a
a
a
a
a
a
a
a
a
a
a
a
a
a
a
a
a
a
a
a
a
a
a
a
a
a
"}
(4,1,1) = {"
a
a
a
a
a
l
l
l
l
l
l
l
l
l
l
l
l
l
l
l
l
l
l
l
l
l
a
a
a
a
a
a
"}
(5,1,1) = {"
a
a
a
a
l
l
l
l
l
l
l
l
l
l
l
l
l
l
l
l
l
l
l
l
l
l
l
a
a
a
a
a
"}
(6,1,1) = {"
a
a
a
l
l
l
m
m
m
m
m
m
m
m
l
l
l
m
m
m
m
m
m
m
m
l
l
l
a
a
a
a
"}
(7,1,1) = {"
a
a
a
l
l
m
m
m
m
m
m
m
m
m
m
l
m
m
m
m
m
m
m
m
m
m
l
l
a
a
a
a
"}
(8,1,1) = {"
a
a
a
l
l
m
m
m
m
a
a
m
m
m
m
l
m
m
m
m
m
a
a
m
m
m
l
l
a
a
a
a
"}
(9,1,1) = {"
a
a
a
l
l
m
m
a
a
a
a
m
m
m
m
l
m
m
m
m
a
a
a
a
m
m
l
l
a
a
a
a
"}
(10,1,1) = {"
a
a
a
l
l
m
m
a
l
l
a
m
m
m
m
l
m
m
m
m
a
l
l
a
m
m
l
l
a
a
a
a
"}
(11,1,1) = {"
a
a
a
l
l
m
m
a
l
l
a
a
a
a
m
l
m
a
a
a
a
l
l
a
m
m
l
l
a
a
a
a
"}
(12,1,1) = {"
a
a
a
l
l
m
m
m
m
a
a
b
b
a
b
k
b
a
b
b
a
a
a
a
m
m
l
l
a
a
a
a
"}
(13,1,1) = {"
a
a
a
l
l
m
m
m
m
m
a
b
b
b
b
d
b
b
b
b
a
m
m
m
m
m
l
l
a
a
a
a
"}
(14,1,1) = {"
a
a
a
l
l
m
m
m
m
m
a
a
b
c
c
c
c
c
b
a
a
m
m
m
m
m
l
l
a
a
a
a
"}
(15,1,1) = {"
a
a
a
l
l
l
m
m
m
m
m
b
b
c
e
g
e
c
b
b
m
m
m
m
m
m
l
l
a
a
a
a
"}
(16,1,1) = {"
a
a
a
l
l
l
l
l
l
l
l
k
d
c
f
h
j
c
d
k
l
l
l
l
l
l
l
l
a
a
a
a
"}
(17,1,1) = {"
a
a
a
l
l
l
m
m
m
m
m
b
b
c
e
i
e
c
b
b
m
m
m
m
m
m
l
l
a
a
a
a
"}
(18,1,1) = {"
a
a
a
l
l
m
m
m
m
m
a
a
b
c
c
c
c
c
b
a
a
m
m
m
m
m
l
l
a
a
a
a
"}
(19,1,1) = {"
a
a
a
l
l
m
m
m
m
m
a
b
b
b
b
d
b
b
b
b
a
a
a
m
m
m
l
l
a
a
a
a
"}
(20,1,1) = {"
a
a
a
l
l
m
m
m
m
a
a
b
b
a
b
k
b
a
b
b
a
a
a
a
m
m
l
l
a
a
a
a
"}
(21,1,1) = {"
a
a
a
l
l
m
m
a
a
l
l
a
a
a
m
l
m
a
a
a
a
l
l
a
m
m
l
l
a
a
a
a
"}
(22,1,1) = {"
a
a
a
l
l
m
m
a
a
l
l
a
m
m
m
l
m
m
m
m
a
l
l
a
a
m
l
l
a
a
a
a
"}
(23,1,1) = {"
a
a
a
l
l
m
m
a
a
a
a
a
m
m
m
l
m
m
m
m
a
a
a
a
a
m
l
l
a
a
a
a
"}
(24,1,1) = {"
a
a
a
l
l
m
m
m
a
a
a
m
m
m
m
l
m
m
m
m
m
a
a
a
m
m
l
l
a
a
a
a
"}
(25,1,1) = {"
a
a
a
l
l
m
m
m
m
m
m
m
m
m
m
l
m
m
m
m
m
m
m
m
m
m
l
l
a
a
a
a
"}
(26,1,1) = {"
a
a
a
l
l
l
m
m
m
m
m
m
m
m
l
l
l
m
m
m
m
m
m
m
m
l
l
l
a
a
a
a
"}
(27,1,1) = {"
a
a
a
a
l
l
l
l
l
l
l
l
l
l
l
l
l
l
l
l
l
l
l
l
l
l
l
a
a
a
a
a
"}
(28,1,1) = {"
a
a
a
a
a
l
l
l
l
l
l
l
l
l
l
l
l
l
l
l
l
l
l
l
l
l
a
a
a
a
a
a
"}
(29,1,1) = {"
a
a
a
a
a
a
a
a
a
a
a
a
a
a
a
a
a
a
a
a
a
a
a
a
a
a
a
a
a
a
a
a
"}
(30,1,1) = {"
a
a
a
a
a
a
a
a
a
a
a
a
a
a
a
a
a
a
a
a
a
a
a
a
a
a
a
a
a
a
a
a
"}
(31,1,1) = {"
a
a
a
a
a
a
a
a
a
a
a
a
a
a
a
a
a
a
a
a
a
a
a
a
a
a
a
a
a
a
a
a
"}
(32,1,1) = {"
a
a
a
a
a
a
a
a
a
a
a
a
a
a
a
a
a
a
a
a
a
a
a
a
a
a
a
a
a
a
a
a
"}
