//MAP CONVERTED BY dmm2tgm.py THIS HEADER COMMENT PREVENTS RECONVERSION, DO NOT REMOVE
"a" = (
/turf/unsimulated/chasm_mask,
/area/mine/unexplored)
"b" = (
/turf/unsimulated/floor/asteroid/ash/rocky,
/area/mine/unexplored)
"c" = (
/turf/simulated/mineral/random,
/area/mine/unexplored)
"d" = (
/turf/simulated/shuttle/wall/dark,
/area/mine/unexplored)
"e" = (
/obj/item/weapon/archaeological_find,
/turf/simulated/floor,
/area/mine/unexplored)
"f" = (
/obj/structure/closet/crate/secure/loot,
/turf/simulated/shuttle/floor4/vox,
/area/mine/unexplored)
"g" = (
/obj/effect/decal/cleanable/dirt,
/turf/simulated/shuttle/floor4/vox,
/area/mine/unexplored)
"h" = (
/turf/simulated/shuttle/floor4/vox,
/area/mine/unexplored)
"i" = (
/obj/effect/decal/cleanable/generic,
/turf/simulated/shuttle/floor4/vox,
/area/mine/unexplored)
"j" = (
/obj/effect/decal/cleanable/generic,
/turf/unsimulated/floor/asteroid/ash/rocky,
/area/mine/unexplored)
"k" = (
/obj/effect/floor_decal/industrial/warning{
	icon_state = "warning";
	dir = 4
	},
/turf/simulated/shuttle/floor4/vox,
/area/mine/unexplored)
"l" = (
/obj/random/energy_antag,
/turf/simulated/shuttle/floor4/vox,
/area/mine/unexplored)
"p" = (
/turf/simulated/wall/r_wall,
/area/mine/unexplored)
"r" = (
/obj/machinery/door/airlock/vault/bolted,
/turf/simulated/shuttle/floor4/vox,
/area/mine/unexplored)
"s" = (
/obj/effect/decal/cleanable/generic,
/obj/effect/floor_decal/industrial/warning{
	icon_state = "warning";
	dir = 4
	},
/turf/simulated/shuttle/floor4/vox,
/area/mine/unexplored)
"t" = (
/obj/structure/sign/securearea,
/turf/simulated/wall/r_wall,
/area/mine/unexplored)
"u" = (
/obj/effect/floor_decal/industrial/warning/corner{
	dir = 4
	},
/turf/simulated/shuttle/floor4/vox,
/area/mine/unexplored)
"v" = (
/obj/effect/floor_decal/industrial/warning{
	dir = 1
	},
/turf/simulated/shuttle/floor4/vox,
/area/mine/unexplored)
"w" = (
/obj/effect/decal/cleanable/dirt,
/obj/effect/floor_decal/industrial/warning{
	dir = 1
	},
/turf/simulated/shuttle/floor4/vox,
/area/mine/unexplored)
"x" = (
/obj/effect/decal/cleanable/dirt,
/obj/effect/landmark/corpse/syndicatesoldier,
/obj/effect/floor_decal/industrial/warning{
	dir = 1
	},
/turf/simulated/shuttle/floor4/vox,
/area/mine/unexplored)
"y" = (
/obj/effect/floor_decal/industrial/warning/corner{
	icon_state = "warningcorner";
	dir = 1
	},
/turf/simulated/shuttle/floor4/vox,
/area/mine/unexplored)
"z" = (
/turf/simulated/open/airless,
/area/mine/unexplored)

(1,1,1) = {"
a
a
a
a
a
a
a
a
a
a
a
a
a
a
a
a
a
a
a
a
a
a
a
a
a
a
a
a
a
a
a
a
"}
(2,1,1) = {"
a
a
a
a
a
a
a
a
a
a
a
a
a
a
a
a
a
a
a
a
a
a
a
a
a
a
a
a
a
a
a
a
"}
(3,1,1) = {"
a
a
a
a
a
z
z
z
z
a
a
a
a
a
a
a
a
a
a
a
a
a
a
a
a
a
a
a
a
a
a
a
"}
(4,1,1) = {"
a
a
z
z
z
z
a
a
z
z
z
z
a
a
a
a
a
a
a
a
a
a
a
z
z
z
z
z
z
a
a
a
"}
(5,1,1) = {"
a
z
z
a
a
a
a
a
a
a
a
z
z
z
a
a
a
a
a
a
a
a
z
z
a
a
a
a
z
z
z
a
"}
(6,1,1) = {"
a
z
a
a
a
b
b
b
a
a
a
a
a
z
z
a
a
a
a
a
a
z
z
a
a
a
a
a
a
a
z
z
"}
(7,1,1) = {"
a
z
a
a
b
b
b
b
b
a
a
a
a
a
z
z
a
a
a
a
z
z
a
a
a
a
b
b
a
a
a
z
"}
(8,1,1) = {"
a
z
a
b
b
b
b
b
b
b
b
b
a
a
a
z
z
z
z
z
z
a
a
a
a
b
b
b
a
a
a
a
"}
(9,1,1) = {"
z
z
a
b
b
b
b
b
b
b
b
b
b
b
a
a
a
a
a
a
a
a
a
a
b
b
b
b
b
a
a
a
"}
(10,1,1) = {"
z
a
a
b
b
b
b
b
b
b
a
a
a
b
b
b
b
b
b
a
a
a
a
b
b
b
b
b
b
b
b
b
"}
(11,1,1) = {"
z
a
a
b
b
b
b
b
a
a
a
a
d
j
j
b
b
d
b
b
a
b
b
b
b
b
b
b
b
b
a
a
"}
(12,1,1) = {"
z
z
a
b
b
a
b
z
z
d
d
d
d
z
z
h
i
d
d
b
b
b
b
b
b
b
b
b
b
b
b
a
"}
(13,1,1) = {"
a
z
a
b
b
z
z
z
c
c
f
g
h
i
z
z
h
h
d
d
b
b
b
b
b
b
b
b
b
b
b
a
"}
(14,1,1) = {"
a
z
a
b
a
z
c
c
c
a
k
k
s
u
h
z
z
h
h
d
b
b
b
b
b
b
b
b
b
b
b
b
"}
(15,1,1) = {"
a
z
a
b
a
z
c
c
c
a
p
p
t
v
a
a
z
a
a
a
b
b
b
b
b
b
b
b
b
b
b
b
"}
(16,1,1) = {"
a
z
a
b
b
z
c
c
c
c
p
e
r
w
h
a
z
a
a
a
a
b
a
a
a
b
b
b
b
b
b
b
"}
(17,1,1) = {"
a
z
a
b
b
z
c
c
c
c
p
p
t
x
h
h
z
a
a
a
a
b
a
a
a
a
b
b
b
b
b
b
"}
(18,1,1) = {"
a
z
a
b
b
z
z
c
c
c
c
a
a
y
l
z
z
i
h
d
b
a
a
a
a
a
a
b
b
b
b
b
"}
(19,1,1) = {"
a
z
a
b
b
a
z
c
c
c
c
c
a
z
z
z
g
h
d
d
b
a
a
a
a
a
a
a
b
b
b
b
"}
(20,1,1) = {"
a
z
a
b
b
b
c
c
c
c
c
z
z
z
z
i
h
d
d
b
b
a
a
a
a
a
a
a
a
b
b
b
"}
(21,1,1) = {"
a
z
a
b
b
b
b
c
c
c
z
z
c
c
c
d
d
d
b
b
b
a
a
a
a
a
a
a
a
b
b
b
"}
(22,1,1) = {"
a
z
a
b
c
c
b
b
c
c
c
c
c
c
c
c
b
b
b
b
a
z
z
z
z
z
a
a
a
a
a
b
"}
(23,1,1) = {"
a
z
a
c
c
c
c
b
b
a
c
c
c
c
c
c
b
b
b
a
z
z
a
a
a
z
z
z
a
a
a
b
"}
(24,1,1) = {"
a
z
a
a
c
c
c
c
b
a
a
a
c
c
c
c
c
b
a
a
z
a
a
a
a
a
a
z
z
a
a
a
"}
(25,1,1) = {"
a
z
z
a
a
c
c
b
b
a
a
a
c
c
a
a
a
a
a
z
z
a
a
a
a
a
a
a
z
z
a
a
"}
(26,1,1) = {"
a
a
z
z
a
a
a
b
b
b
a
a
a
a
a
a
a
a
a
z
a
a
a
a
a
a
a
a
a
z
z
a
"}
(27,1,1) = {"
a
a
a
z
z
a
a
a
b
b
b
a
a
a
a
a
a
a
z
z
a
a
a
a
a
a
a
a
a
a
z
z
"}
(28,1,1) = {"
a
a
a
a
z
z
a
a
a
b
b
a
a
a
a
z
z
z
z
a
a
a
a
a
a
a
a
a
a
a
a
z
"}
(29,1,1) = {"
a
a
a
a
a
z
a
a
a
b
b
b
a
a
a
z
a
a
a
a
a
a
a
a
a
a
a
a
a
a
a
a
"}
(30,1,1) = {"
a
a
a
a
a
z
a
a
a
b
b
b
b
a
z
z
a
a
a
a
a
a
a
a
a
a
a
a
a
a
a
a
"}
(31,1,1) = {"
a
a
a
a
a
z
z
a
b
b
b
b
b
a
z
a
a
a
a
a
a
a
a
a
a
a
a
a
a
a
a
a
"}
(32,1,1) = {"
a
a
a
a
a
a
z
a
b
b
b
b
b
b
z
a
a
a
a
a
a
a
a
a
a
a
a
a
a
a
a
a
"}
