//MAP CONVERTED BY dmm2tgm.py THIS HEADER COMMENT PREVENTS RECONVERSION, DO NOT REMOVE
"a" = (
/turf/unsimulated/chasm_mask,
/area/mine/unexplored)
"b" = (
/turf/simulated/mineral/random,
/area/mine/unexplored)
"c" = (
/turf/simulated/wall/r_wall,
/area/turret_protected/corp_vault)
"d" = (
/obj/machinery/power/port_gen/pacman,
/obj/structure/cable/yellow{
	d2 = 4;
	icon_state = "0-4"
	},
/turf/simulated/floor/holofloor/tiled/dark,
/area/turret_protected/corp_vault)
"e" = (
/obj/machinery/power/smes/buildable{
	charge = 5e+006;
	input_attempt = 0;
	input_level = 200000;
	output_attempt = 1;
	output_level = 200000;
	RCon = 0
	},
/obj/structure/cable/yellow{
	d2 = 8;
	icon_state = "0-8"
	},
/obj/structure/cable/blue{
	icon_state = "0-4"
	},
/obj/machinery/light/small/emergency{
	dir = 1
	},
/turf/simulated/floor/holofloor/tiled/dark,
/area/turret_protected/corp_vault)
"f" = (
/obj/structure/cable/blue{
	d1 = 2;
	d2 = 8;
	icon_state = "2-8"
	},
/turf/simulated/floor/holofloor/tiled/dark,
/area/turret_protected/corp_vault)
"g" = (
/obj/structure/table/reinforced,
/obj/item/stack/material/phoron{
	amount = 50
	},
/turf/simulated/floor/holofloor/tiled/dark,
/area/turret_protected/corp_vault)
"h" = (
/obj/structure/table/reinforced,
/obj/machinery/light/small/emergency{
	dir = 1
	},
/obj/item/stack/material/phoron{
	amount = 50
	},
/turf/simulated/floor/holofloor/tiled/dark,
/area/turret_protected/corp_vault)
"i" = (
/obj/structure/table/reinforced,
/obj/item/weapon/wrench,
/turf/simulated/floor/holofloor/tiled/dark,
/area/turret_protected/corp_vault)
"j" = (
/turf/simulated/floor/holofloor/tiled/dark,
/area/turret_protected/corp_vault)
"k" = (
/obj/structure/cable/blue{
	d1 = 1;
	d2 = 4;
	icon_state = "1-4"
	},
/turf/simulated/floor/holofloor/tiled/dark,
/area/turret_protected/corp_vault)
"l" = (
/obj/structure/table/reinforced,
/obj/structure/cable/blue{
	d2 = 8;
	icon_state = "0-8"
	},
/obj/item/weapon/gun/energy/toxgun,
/obj/item/frame/apc,
/obj/item/weapon/circuitboard/broken,
/turf/simulated/floor/holofloor/tiled/dark,
/area/turret_protected/corp_vault)
"m" = (
/obj/structure/table/reinforced,
/obj/machinery/light/small/emergency{
	dir = 8
	},
/obj/item/stack/material/phoron{
	amount = 50
	},
/turf/simulated/floor/holofloor/tiled/dark,
/area/turret_protected/corp_vault)
"n" = (
/obj/machinery/porta_turret/thermal,
/obj/effect/decal/warning_stripes,
/turf/simulated/floor/holofloor/tiled/dark,
/area/turret_protected/corp_vault)
"o" = (
/obj/item/weapon/archaeological_find,
/turf/simulated/floor/holofloor/tiled/dark,
/area/turret_protected/corp_vault)
"p" = (
/obj/structure/table/reinforced,
/obj/machinery/light/small/emergency{
	icon_state = "bulb1";
	dir = 4
	},
/obj/item/stack/material/phoron{
	amount = 50
	},
/turf/simulated/floor/holofloor/tiled/dark,
/area/turret_protected/corp_vault)
"q" = (
/obj/machinery/light/small/emergency,
/turf/simulated/floor/holofloor/tiled/dark,
/area/turret_protected/corp_vault)
"r" = (
/obj/structure/sign/securearea,
/turf/simulated/wall/r_wall,
/area/turret_protected/corp_vault)
"s" = (
/obj/machinery/door/airlock/vault/bolted,
/turf/simulated/floor/holofloor/tiled/dark,
/area/turret_protected/corp_vault)
"t" = (
/obj/machinery/atmospherics/portables_connector{
	dir = 4
	},
/obj/machinery/portable_atmospherics/canister/air/airlock,
/turf/simulated/floor/holofloor/tiled/dark,
/area/turret_protected/corp_vault)
"u" = (
/obj/machinery/atmospherics/pipe/simple/hidden{
	dir = 10
	},
/turf/simulated/floor/holofloor/tiled/dark,
/area/turret_protected/corp_vault)
"v" = (
/obj/machinery/light/small/emergency{
	dir = 1
	},
/turf/simulated/floor/holofloor/tiled/dark,
/area/turret_protected/corp_vault)
"w" = (
/obj/machinery/atmospherics/pipe/manifold/hidden,
/turf/simulated/floor/holofloor/tiled/dark,
/area/turret_protected/corp_vault)
"x" = (
/turf/unsimulated/floor/asteroid/ash/rocky,
/area/mine/unexplored)
"y" = (
/obj/machinery/atmospherics/pipe/simple/hidden{
	dir = 4
	},
/obj/machinery/light/small/emergency,
/turf/simulated/floor/holofloor/tiled/dark,
/area/turret_protected/corp_vault)
"z" = (
/obj/machinery/atmospherics/pipe/simple/hidden{
	dir = 4
	},
/turf/simulated/floor/holofloor/tiled/dark,
/area/turret_protected/corp_vault)
"A" = (
/obj/structure/grille,
/obj/structure/window/reinforced{
	icon_state = "rwindow";
	dir = 1
	},
/obj/structure/window/reinforced{
	dir = 4
	},
/obj/structure/window/reinforced{
	dir = 8
	},
/obj/structure/window/reinforced,
/turf/simulated/floor,
/area/turret_protected/corp_vault)
"B" = (
/obj/machinery/atmospherics/pipe/simple/hidden,
/obj/machinery/door/airlock/external{
	frequency = 1379;
	icon_state = "door_locked";
	id_tag = "hidden_vault_inner";
	locked = 1;
	name = "Vault Inner Access";
	req_access = list(13)
	},
/obj/machinery/access_button{
	command = "cycle_interior";
	frequency = 1379;
	master_tag = "hidden_vault_airlock";
	name = "interior access button";
	pixel_x = -28;
	pixel_y = 0;
	req_access = list(53);
	req_one_access = null
	},
/turf/simulated/floor,
/area/turret_protected/corp_vault)
"C" = (
/obj/machinery/atmospherics/unary/vent_pump/high_volume{
	dir = 4;
	frequency = 1380;
	id_tag = "hidden_vault_airpump";
	name = "Large Air Vent"
	},
/obj/machinery/airlock_sensor{
	frequency = 1379;
	id_tag = "hidden_vault_airlock_sensor";
	layer = 3.3;
	pixel_x = -24;
	pixel_y = 0
	},
/obj/machinery/light/small/emergency,
/turf/simulated/floor,
/area/turret_protected/corp_vault)
"D" = (
/obj/machinery/atmospherics/pipe/manifold/hidden,
/turf/simulated/floor,
/area/turret_protected/corp_vault)
"E" = (
/obj/machinery/atmospherics/unary/vent_pump/high_volume{
	dir = 8;
	frequency = 1380;
	id_tag = "hidden_vault_airpump"
	},
/obj/machinery/embedded_controller/radio/airlock/docking_port{
	frequency = 1379;
	id_tag = "hidden_vault_airlock";
	pixel_x = 30;
	pixel_y = 0;
	req_one_access = list(13);
	tag_airpump = "hidden_vault_airpump";
	tag_chamber_sensor = "hidden_vault_airlock_sensor";
	tag_exterior_door = "hidden_vault_outer";
	tag_interior_door = "hidden_vault_inner"
	},
/obj/machinery/light/small/emergency,
/turf/simulated/floor,
/area/turret_protected/corp_vault)
"F" = (
/obj/machinery/door/airlock/external{
	frequency = 1379;
	icon_state = "door_locked";
	id_tag = "hidden_vault_outer";
	locked = 1;
	name = "Vault Outer Access";
	req_access = list(13)
	},
/obj/machinery/access_button{
	command = "cycle_exterior";
	frequency = 1379;
	master_tag = "hidden_vault_airlock";
	name = "exterior access button";
	pixel_x = -28;
	pixel_y = 0;
	req_access = list(53);
	req_one_access = null
	},
/turf/simulated/floor,
/area/turret_protected/corp_vault)
"G" = (
/obj/machinery/light/small/emergency{
	dir = 1
	},
/turf/simulated/floor/airless{
	icon_state = "asteroidplating"
	},
/area/turret_protected/corp_vault)
"H" = (
/turf/simulated/floor/airless{
	icon_state = "asteroidplating"
	},
/area/turret_protected/corp_vault)
"I" = (
/obj/machinery/turretid/lethal{
	ailock = 1;
	check_synth = 1;
	control_area = "\improper *CLASSIFIED*";
	desc = "A firewall prevents AIs from interacting with this device.";
	name = "lethal turret control";
	pixel_y = 29;
	req_access = list(61)
	},
/turf/simulated/floor/airless{
	icon_state = "asteroidplating"
	},
/area/turret_protected/corp_vault)

(1,1,1) = {"
a
a
a
a
a
a
a
a
a
a
a
a
a
a
a
a
a
a
a
a
a
a
a
a
a
a
a
a
a
a
a
a
"}
(2,1,1) = {"
a
a
a
a
a
a
a
a
a
a
a
a
a
a
a
a
a
a
a
a
a
a
a
a
a
a
a
a
a
a
a
a
"}
(3,1,1) = {"
a
a
a
a
a
a
a
a
a
a
a
a
a
a
a
a
a
a
a
a
a
a
a
a
a
a
a
a
a
a
a
a
"}
(4,1,1) = {"
a
a
a
a
a
b
b
b
b
a
a
b
b
b
a
a
b
b
b
b
a
a
a
a
a
a
a
a
a
a
a
a
"}
(5,1,1) = {"
a
a
a
a
a
b
b
b
b
b
b
b
b
b
b
b
b
b
b
b
b
a
a
a
a
a
a
a
a
a
a
a
"}
(6,1,1) = {"
a
a
a
a
b
b
b
b
b
b
b
b
b
b
b
b
b
b
b
b
b
b
b
b
b
a
a
a
a
a
a
a
"}
(7,1,1) = {"
a
a
a
a
b
b
c
c
b
b
b
c
c
c
c
c
b
b
c
c
b
b
b
b
b
b
b
a
a
a
a
a
"}
(8,1,1) = {"
a
a
a
a
b
b
c
c
c
c
c
c
c
c
c
c
c
c
c
c
b
x
b
b
b
b
b
b
a
a
a
a
"}
(9,1,1) = {"
a
a
a
a
b
b
b
c
c
c
c
c
c
c
c
c
c
c
c
b
x
x
x
b
b
b
x
a
a
a
a
a
"}
(10,1,1) = {"
a
a
a
a
b
b
b
c
c
g
g
m
g
j
c
t
t
c
c
x
x
x
x
b
b
x
x
x
a
a
a
a
"}
(11,1,1) = {"
a
a
a
a
a
b
b
c
c
g
j
j
j
j
c
u
w
c
c
c
x
x
x
b
b
b
x
x
a
a
x
a
"}
(12,1,1) = {"
a
a
a
a
b
b
b
c
c
h
j
n
j
c
c
j
y
c
c
c
x
x
x
x
b
b
b
x
x
a
x
a
"}
(13,1,1) = {"
a
a
a
a
b
b
b
c
c
g
j
j
j
c
n
j
z
c
c
x
x
x
x
x
b
b
b
x
x
x
x
a
"}
(14,1,1) = {"
a
a
a
a
b
b
c
c
c
i
j
j
q
c
c
v
z
c
c
r
G
H
H
x
x
x
b
b
x
x
x
a
"}
(15,1,1) = {"
a
a
a
a
b
b
c
c
d
j
j
j
j
j
r
j
z
A
C
c
H
H
H
x
x
x
x
x
x
x
x
a
"}
(16,1,1) = {"
a
a
a
a
a
b
c
c
e
j
j
o
j
j
s
j
u
B
D
F
H
H
H
x
x
x
x
x
x
x
x
x
"}
(17,1,1) = {"
a
a
a
a
a
b
c
c
f
k
j
j
j
j
r
j
j
A
E
c
I
H
H
x
x
x
x
x
x
x
x
x
"}
(18,1,1) = {"
a
a
a
a
a
b
c
c
c
l
j
j
q
c
c
v
j
c
c
r
G
H
H
x
x
x
x
x
x
a
x
x
"}
(19,1,1) = {"
a
a
a
a
a
b
b
c
c
g
j
j
j
c
n
j
j
c
c
x
x
x
x
x
x
x
x
x
x
a
x
x
"}
(20,1,1) = {"
a
a
a
a
b
b
b
c
c
h
j
n
j
c
c
j
q
c
c
c
x
x
x
x
x
x
x
x
a
a
x
x
"}
(21,1,1) = {"
a
a
a
a
b
b
b
c
c
g
j
j
j
j
c
j
j
c
c
c
x
x
x
x
x
b
x
x
a
a
a
x
"}
(22,1,1) = {"
a
a
a
b
b
b
b
c
c
g
g
p
g
j
c
j
j
c
c
x
x
x
x
x
b
b
x
x
a
a
a
x
"}
(23,1,1) = {"
a
a
b
b
b
b
b
c
c
c
c
c
c
c
c
c
c
c
c
b
b
x
x
b
b
b
x
a
a
a
a
a
"}
(24,1,1) = {"
a
a
a
b
b
b
c
c
c
c
c
c
c
c
c
c
c
c
c
c
b
b
b
b
b
b
b
b
a
a
a
a
"}
(25,1,1) = {"
a
a
a
a
b
b
c
c
b
b
b
c
c
c
c
c
b
b
c
c
b
b
b
b
b
b
b
b
b
a
a
a
"}
(26,1,1) = {"
a
a
a
a
b
b
b
b
b
b
b
b
b
b
b
b
b
b
b
b
b
a
a
b
b
a
a
a
a
a
a
a
"}
(27,1,1) = {"
a
a
a
a
a
b
b
b
b
b
b
b
b
b
b
b
b
b
b
b
a
a
a
a
a
a
a
a
a
a
a
a
"}
(28,1,1) = {"
a
a
a
a
a
a
b
b
a
a
a
b
b
a
a
a
b
b
b
a
a
a
a
a
a
a
a
a
a
a
a
a
"}
(29,1,1) = {"
a
a
a
a
a
a
a
a
a
a
a
a
a
a
a
a
a
a
a
a
a
a
a
a
a
a
a
a
a
a
a
a
"}
(30,1,1) = {"
a
a
a
a
a
a
a
a
a
a
a
a
a
a
a
a
a
a
a
a
a
a
a
a
a
a
a
a
a
a
a
a
"}
(31,1,1) = {"
a
a
a
a
a
a
a
a
a
a
a
a
a
a
a
a
a
a
a
a
a
a
a
a
a
a
a
a
a
a
a
a
"}
(32,1,1) = {"
a
a
a
a
a
a
a
a
a
a
a
a
a
a
a
a
a
a
a
a
a
a
a
a
a
a
a
a
a
a
a
a
"}
