//MAP CONVERTED BY dmm2tgm.py THIS HEADER COMMENT PREVENTS RECONVERSION, DO NOT REMOVE
"a" = (
/turf/unsimulated/chasm_mask,
/area/mine/unexplored)
"b" = (
/turf/unsimulated/floor/asteroid/ash/rocky,
/area/mine/unexplored)
"c" = (
/obj/structure/greatworm,
/turf/unsimulated/floor/asteroid/ash/rocky,
/area/mine/unexplored)
"e" = (
/mob/living/simple_animal/hostile/greatworm,
/turf/unsimulated/floor/asteroid/ash/rocky,
/area/mine/unexplored)
"g" = (
/mob/living/simple_animal/hostile/greatwormking,
/turf/unsimulated/floor/asteroid/ash/rocky,
/area/mine/unexplored)
"h" = (
/turf/simulated/mineral,
/area/mine/unexplored)
"i" = (
/obj/effect/decal/remains/human,
/turf/unsimulated/floor/asteroid/ash/rocky,
/area/mine/unexplored)
"j" = (
/obj/item/weapon/archaeological_find,
/turf/unsimulated/floor/asteroid/ash/rocky,
/area/mine/unexplored)

(1,1,1) = {"
h
h
a
b
b
b
b
b
b
b
b
b
b
b
i
b
b
b
b
b
i
b
a
a
a
a
h
h
a
a
a
a
"}
(2,1,1) = {"
h
a
a
b
i
b
b
b
b
b
a
a
b
b
b
b
b
b
b
b
b
b
b
a
a
a
a
h
h
a
a
a
"}
(3,1,1) = {"
h
a
b
b
b
b
a
a
a
h
h
h
h
h
h
h
a
a
a
a
b
b
b
b
a
a
a
a
h
a
a
a
"}
(4,1,1) = {"
a
a
b
i
b
a
a
h
h
h
a
a
a
a
a
h
h
h
a
a
a
b
b
i
b
a
a
a
h
h
a
a
"}
(5,1,1) = {"
a
b
b
b
a
a
h
h
a
a
a
b
b
i
b
b
b
h
h
h
a
a
b
b
b
a
a
a
a
h
a
a
"}
(6,1,1) = {"
a
b
b
a
a
h
h
a
b
b
b
b
b
b
b
b
b
b
b
h
h
a
a
b
b
b
a
a
a
h
a
a
"}
(7,1,1) = {"
a
a
b
a
h
h
a
b
b
b
b
b
b
b
b
b
b
b
b
a
h
a
a
a
b
b
b
a
a
h
h
a
"}
(8,1,1) = {"
a
a
e
a
h
a
a
b
b
b
e
b
b
b
b
e
b
b
b
a
h
h
a
a
a
b
b
a
a
a
h
a
"}
(9,1,1) = {"
a
i
b
a
h
a
a
b
b
b
b
b
i
b
b
b
b
b
b
a
a
h
a
a
a
b
b
b
a
a
h
a
"}
(10,1,1) = {"
a
b
c
a
h
a
b
b
e
b
b
b
b
b
b
b
b
i
b
b
a
h
h
a
a
b
b
b
a
a
h
a
"}
(11,1,1) = {"
a
b
b
a
h
a
b
b
b
b
b
b
j
b
b
b
b
b
b
b
a
a
h
a
a
b
b
i
a
a
h
h
"}
(12,1,1) = {"
a
b
b
a
h
a
b
b
b
b
b
b
b
b
b
b
b
b
b
b
a
a
h
a
a
b
c
b
a
a
a
h
"}
(13,1,1) = {"
a
b
b
a
h
a
b
b
e
b
b
b
g
b
b
e
b
b
e
b
a
a
h
a
a
b
b
b
a
a
a
h
"}
(14,1,1) = {"
a
b
b
a
h
a
b
b
b
b
i
b
b
b
b
b
b
b
b
b
a
a
h
a
a
b
b
b
a
a
a
h
"}
(15,1,1) = {"
a
b
i
h
h
a
b
b
b
b
b
b
b
b
b
b
b
i
b
b
a
a
h
a
b
b
b
b
a
a
a
h
"}
(16,1,1) = {"
a
b
b
h
a
b
b
i
b
b
b
b
b
b
i
b
b
b
b
b
a
a
h
a
b
b
b
a
a
a
a
h
"}
(17,1,1) = {"
a
i
b
h
a
b
b
b
b
e
b
b
b
b
b
b
b
b
b
b
a
a
h
a
b
b
b
a
a
a
a
h
"}
(18,1,1) = {"
a
b
c
h
h
b
b
b
b
b
b
b
e
b
b
b
b
b
b
a
a
h
h
a
b
b
b
a
a
a
a
h
"}
(19,1,1) = {"
a
b
b
a
h
a
b
b
b
b
b
b
b
b
b
e
b
b
b
a
a
h
a
a
b
b
b
a
a
a
a
h
"}
(20,1,1) = {"
a
b
b
a
h
h
a
a
b
i
b
b
i
b
b
b
b
b
i
a
a
h
a
a
b
i
b
a
a
a
a
h
"}
(21,1,1) = {"
a
a
b
b
a
h
a
a
b
b
b
b
b
b
b
b
b
b
b
a
h
h
a
b
b
b
b
a
a
a
a
h
"}
(22,1,1) = {"
a
a
b
b
a
h
h
a
a
a
a
b
b
b
b
b
b
a
a
h
h
a
b
b
b
b
a
a
a
a
h
h
"}
(23,1,1) = {"
a
b
b
b
b
a
h
h
h
h
b
b
b
b
a
a
a
h
h
h
a
a
b
b
b
b
a
a
a
a
h
a
"}
(24,1,1) = {"
a
b
b
c
b
b
a
a
a
h
b
e
b
b
h
h
h
h
a
a
a
b
b
i
b
b
a
a
a
a
h
a
"}
(25,1,1) = {"
a
b
i
b
b
b
b
a
a
a
b
b
b
a
a
a
a
a
b
b
b
b
b
b
a
a
a
a
a
a
h
a
"}
(26,1,1) = {"
h
a
a
a
b
b
b
b
b
b
b
b
b
b
b
b
b
b
b
b
b
b
c
b
b
a
a
a
a
a
h
a
"}
(27,1,1) = {"
h
h
a
a
a
b
b
b
b
b
b
c
b
b
b
b
b
b
b
b
b
b
b
i
b
a
a
a
a
a
h
a
"}
(28,1,1) = {"
a
h
h
h
a
a
a
b
b
b
b
b
i
b
b
b
b
a
a
a
a
b
b
b
b
a
a
a
a
h
h
a
"}
(29,1,1) = {"
a
a
a
h
h
a
a
a
a
a
a
a
a
a
a
b
b
a
a
a
a
a
a
a
a
a
a
a
a
h
a
a
"}
(30,1,1) = {"
a
a
a
a
h
h
h
a
a
a
a
a
a
a
a
a
a
a
a
a
a
a
a
a
a
a
a
a
h
h
a
a
"}
(31,1,1) = {"
a
a
a
a
a
a
h
h
h
h
h
h
h
h
h
h
h
h
h
h
h
h
a
a
a
h
h
h
h
a
a
a
"}
(32,1,1) = {"
a
a
a
a
a
a
a
a
a
a
a
a
a
a
a
a
a
a
a
a
a
h
h
h
h
h
a
a
a
a
a
a
"}
