//MAP CONVERTED BY dmm2tgm.py THIS HEADER COMMENT PREVENTS RECONVERSION, DO NOT REMOVE
"a" = (
/turf/template_noop,
/area/space)
"b" = (
/obj/machinery/atmospherics/pipe/simple/hidden/scrubbers{
	dir = 6
	},
/obj/machinery/atmospherics/pipe/simple/hidden/supply{
	dir = 6
	},
/turf/simulated/floor,
/area/space)
"c" = (
/obj/machinery/atmospherics/unary/vent_scrubber/on{
	dir = 1
	},
/turf/simulated/floor,
/area/space)
"e" = (
/obj/machinery/atmospherics/pipe/simple/hidden/scrubbers{
	dir = 4
	},
/obj/machinery/atmospherics/pipe/simple/hidden/supply{
	dir = 4
	},
/turf/simulated/floor,
/area/space)
"f" = (
/turf/simulated/wall/r_wall,
/area/space)
"g" = (
/turf/simulated/floor,
/area/space)
"h" = (
/obj/machinery/atmospherics/unary/vent_pump/on{
	dir = 4
	},
/turf/simulated/floor,
/area/space)
"k" = (
/obj/machinery/atmospherics/unary/vent_pump/on{
	dir = 1;
	level = 2
	},
/turf/simulated/floor,
/area/space)
"l" = (
/obj/effect/map_effect/map_helper/mark_acceptable,
/turf/template_noop,
/area/space)
"o" = (
/obj/machinery/atmospherics/unary/vent_pump/on{
	dir = 8
	},
/turf/simulated/floor,
/area/space)
"p" = (
/obj/machinery/atmospherics/pipe/manifold/hidden/supply{
	dir = 1
	},
/obj/machinery/atmospherics/pipe/manifold/hidden/scrubbers,
/turf/simulated/floor,
/area/space)
"q" = (
/obj/machinery/atmospherics/pipe/manifold/hidden/supply{
	dir = 1
	},
/obj/machinery/atmospherics/pipe/manifold/hidden/scrubbers{
	dir = 1
	},
/turf/simulated/floor,
/area/space)
"r" = (
/obj/machinery/atmospherics/pipe/simple/hidden/scrubbers{
	dir = 9
	},
/obj/machinery/atmospherics/pipe/simple/hidden/supply{
	dir = 9
	},
/turf/simulated/floor,
/area/space)
"t" = (
/obj/machinery/atmospherics/pipe/manifold/hidden/supply{
	dir = 4
	},
/obj/machinery/atmospherics/pipe/manifold/hidden/scrubbers{
	dir = 4
	},
/turf/simulated/floor,
/area/space)
"u" = (
/obj/machinery/atmospherics/pipe/simple/hidden/supply{
	dir = 6
	},
/obj/machinery/atmospherics/pipe/simple/hidden/scrubbers{
	dir = 10
	},
/turf/simulated/floor,
/area/space)
"w" = (
/obj/machinery/atmospherics/pipe/simple/hidden/scrubbers{
	dir = 1
	},
/obj/machinery/atmospherics/pipe/simple/hidden/supply,
/turf/simulated/floor,
/area/space)
"x" = (
/obj/machinery/atmospherics/pipe/simple/hidden/scrubbers{
	dir = 9
	},
/obj/machinery/atmospherics/pipe/simple/hidden/supply{
	dir = 10
	},
/turf/simulated/floor,
/area/space)
"y" = (
/obj/machinery/atmospherics/unary/vent_scrubber/on{
	dir = 4
	},
/turf/simulated/floor,
/area/space)
"z" = (
/obj/machinery/atmospherics/pipe/simple/hidden/supply{
	dir = 10
	},
/obj/machinery/atmospherics/pipe/simple/hidden/scrubbers{
	dir = 6
	},
/turf/simulated/floor,
/area/space)
"A" = (
/obj/machinery/atmospherics/pipe/simple/hidden/scrubbers,
/obj/machinery/atmospherics/pipe/simple/hidden/supply,
/turf/simulated/floor,
/area/space)
"C" = (
/obj/machinery/atmospherics/pipe/simple/hidden/supply{
	dir = 9
	},
/obj/machinery/atmospherics/pipe/simple/hidden/scrubbers{
	dir = 10
	},
/turf/simulated/floor,
/area/space)
"D" = (
/obj/machinery/atmospherics/unary/vent_pump/on,
/turf/simulated/floor,
/area/space)
"E" = (
/obj/machinery/atmospherics/pipe/simple/hidden/scrubbers{
	dir = 10
	},
/obj/machinery/atmospherics/pipe/simple/hidden/supply{
	dir = 10
	},
/turf/simulated/floor,
/area/space)
"F" = (
/obj/effect/map_effect/map_helper/mark_good,
/turf/template_noop,
/area/space)
"G" = (
/obj/machinery/atmospherics/unary/vent_scrubber/on,
/turf/simulated/floor,
/area/space)
"I" = (
/obj/machinery/atmospherics/pipe/manifold/hidden/supply,
/obj/machinery/atmospherics/pipe/manifold/hidden/scrubbers,
/turf/simulated/floor,
/area/space)
"L" = (
/obj/machinery/atmospherics/pipe/manifold/hidden/supply,
/obj/machinery/atmospherics/pipe/manifold/hidden/scrubbers{
	dir = 1
	},
/turf/simulated/floor,
/area/space)
"M" = (
/obj/machinery/atmospherics/pipe/simple/hidden/scrubbers{
	dir = 5
	},
/obj/machinery/atmospherics/pipe/simple/hidden/supply{
	dir = 5
	},
/turf/simulated/floor,
/area/space)
"O" = (
/obj/machinery/atmospherics/unary/vent_scrubber/on{
	dir = 8
	},
/turf/simulated/floor,
/area/space)
"R" = (
/obj/machinery/atmospherics/pipe/simple/hidden/scrubbers{
	dir = 5
	},
/obj/machinery/atmospherics/pipe/simple/hidden/supply{
	dir = 6
	},
/turf/simulated/floor,
/area/space)
"T" = (
/obj/machinery/atmospherics/pipe/manifold/hidden/supply{
	dir = 8
	},
/obj/machinery/atmospherics/pipe/manifold/hidden/scrubbers{
	dir = 8
	},
/turf/simulated/floor,
/area/space)
"W" = (
/obj/machinery/atmospherics/pipe/simple/hidden/scrubbers{
	dir = 8
	},
/obj/machinery/atmospherics/pipe/simple/hidden/supply{
	dir = 4
	},
/turf/simulated/floor,
/area/space)
"X" = (
/obj/machinery/atmospherics/pipe/simple/hidden/supply{
	dir = 9
	},
/obj/machinery/atmospherics/pipe/simple/hidden/scrubbers{
	dir = 5
	},
/turf/simulated/floor,
/area/space)
"Y" = (
/obj/machinery/atmospherics/pipe/manifold/hidden/supply{
	dir = 4
	},
/obj/machinery/atmospherics/pipe/manifold/hidden/scrubbers{
	dir = 8
	},
/turf/simulated/floor,
/area/space)
"Z" = (
/obj/machinery/atmospherics/pipe/manifold/hidden/supply{
	dir = 8
	},
/obj/machinery/atmospherics/pipe/manifold/hidden/scrubbers{
	dir = 4
	},
/turf/simulated/floor,
/area/space)

(1,1,1) = {"
f
a
a
a
a
a
a
a
a
a
a
a
a
a
a
a
a
a
a
a
a
a
"}
(2,1,1) = {"
f
a
a
a
a
a
a
a
a
a
a
a
a
a
a
a
a
a
a
g
e
a
"}
(3,1,1) = {"
f
a
a
a
a
a
a
a
a
a
h
a
a
a
a
a
a
a
a
A
r
a
"}
(4,1,1) = {"
f
a
G
p
k
a
G
R
k
a
z
a
g
e
g
a
e
g
a
a
a
a
"}
(5,1,1) = {"
f
a
a
a
a
a
a
a
a
a
O
a
A
t
A
a
q
A
a
A
M
a
"}
(6,1,1) = {"
f
a
a
a
a
a
a
a
a
a
a
a
a
a
a
a
e
g
a
g
e
a
"}
(7,1,1) = {"
f
a
a
h
a
a
a
a
a
a
h
a
a
a
a
a
a
a
a
a
a
a
"}
(8,1,1) = {"
f
a
a
Y
a
a
G
x
k
a
X
a
A
T
A
a
g
e
a
b
A
a
"}
(9,1,1) = {"
f
a
a
O
a
a
a
a
a
a
O
a
g
e
g
a
A
I
a
e
g
a
"}
(10,1,1) = {"
f
a
a
a
a
a
a
a
a
a
a
a
a
a
a
a
g
e
a
a
a
a
"}
(11,1,1) = {"
f
a
a
a
a
a
a
a
a
a
a
a
a
a
a
a
a
a
a
W
g
a
"}
(12,1,1) = {"
f
a
a
a
a
a
a
a
a
a
a
a
a
a
a
a
a
a
a
E
w
a
"}
(13,1,1) = {"
f
a
a
a
a
a
a
a
a
a
a
a
a
a
a
a
a
a
a
a
a
a
"}
(14,1,1) = {"
f
f
f
f
f
f
f
f
f
f
f
f
f
f
f
f
f
f
f
f
f
f
"}
(15,1,1) = {"
a
a
a
a
a
a
a
a
f
a
a
a
a
a
a
a
a
a
a
a
a
a
"}
(16,1,1) = {"
a
a
a
a
a
a
a
a
f
a
a
a
F
a
G
p
k
a
h
a
h
a
"}
(17,1,1) = {"
a
a
a
a
a
a
a
a
f
a
a
a
a
a
a
a
a
a
z
a
Y
a
"}
(18,1,1) = {"
a
a
a
a
a
a
a
a
f
a
a
a
a
a
G
x
k
a
O
a
O
a
"}
(19,1,1) = {"
a
a
a
a
a
a
a
a
f
a
a
a
a
a
a
a
a
a
a
a
a
a
"}
(20,1,1) = {"
a
a
a
a
a
a
a
a
f
f
f
f
f
f
f
f
f
f
f
f
f
f
"}
(21,1,1) = {"
a
a
a
a
a
a
a
a
f
a
a
a
a
a
a
a
a
a
a
a
a
a
"}
(22,1,1) = {"
a
a
a
a
a
a
a
a
f
a
a
a
l
a
D
L
c
a
y
a
y
a
"}
(23,1,1) = {"
a
a
a
a
a
a
a
a
f
a
a
a
a
a
a
a
a
a
u
a
Z
a
"}
(24,1,1) = {"
a
a
a
a
a
a
a
a
f
a
a
a
a
a
D
C
k
a
o
a
o
a
"}
(25,1,1) = {"
a
a
a
a
a
a
a
a
f
a
a
a
a
a
a
a
a
a
a
a
a
a
"}
(26,1,1) = {"
a
a
a
a
a
a
a
a
f
f
f
f
f
f
f
f
f
f
f
f
f
f
"}
