//MAP CONVERTED BY dmm2tgm.py THIS HEADER COMMENT PREVENTS RECONVERSION, DO NOT REMOVE
"a" = (
/turf/simulated/floor/exoplanet/konyang,
/area/space)
"b" = (
/obj/structure/ladder/mining,
/turf/simulated/floor/exoplanet/dirt_konyang,
/area/space)
"c" = (
/obj/structure/track,
/turf/simulated/floor/exoplanet/dirt_konyang,
/area/space)
"d" = (
/obj/structure/rope_post{
	dir = 8
	},
/obj/machinery/floodlight,
/turf/simulated/floor/exoplanet/dirt_konyang,
/area/space)
"e" = (
/obj/item/archaeological_find,
/turf/simulated/floor/exoplanet/dirt_konyang,
/area/space)
"g" = (
/turf/simulated/floor/exoplanet/konyang/wilting,
/area/space)
"h" = (
/obj/effect/landmark/corpse/scientist,
/turf/simulated/floor/exoplanet/dirt_konyang,
/area/space)
"j" = (
/obj/structure/rope_railing,
/turf/simulated/floor/exoplanet/dirt_konyang,
/area/space)
"k" = (
/obj/item/pickaxe,
/turf/simulated/floor/exoplanet/konyang,
/area/space)
"l" = (
/obj/structure/ore_box,
/turf/simulated/floor/exoplanet/konyang,
/area/space)
"m" = (
/obj/effect/decal/remains/robot,
/turf/simulated/floor/exoplanet/dirt_konyang,
/area/space)
"n" = (
/obj/structure/rod_railing,
/turf/simulated/floor/exoplanet/konyang,
/area/space)
"o" = (
/obj/effect/floor_decal/konyang_flowers,
/turf/simulated/floor/exoplanet/konyang,
/area/space)
"p" = (
/obj/structure/rope_post,
/obj/effect/mist,
/turf/simulated/floor/exoplanet/dirt_konyang,
/area/space)
"q" = (
/obj/structure/chainlink_fence,
/turf/simulated/floor/exoplanet/konyang,
/area/space)
"r" = (
/obj/structure/lattice/catwalk/indoor/planks,
/turf/simulated/floor/exoplanet/konyang,
/area/space)
"s" = (
/turf/simulated/floor/exoplanet/basalt,
/area/space)
"t" = (
/obj/effect/decal/cleanable/blood,
/turf/simulated/floor/exoplanet/konyang,
/area/space)
"u" = (
/turf/simulated/floor/exoplanet/barren,
/area/space)
"v" = (
/obj/structure/grille/broken,
/turf/simulated/floor/exoplanet/konyang,
/area/space)
"w" = (
/turf/simulated/mineral,
/area/space)
"x" = (
/obj/structure/track,
/obj/vehicle/train/cargo/trolley/mining,
/turf/simulated/floor/exoplanet/dirt_konyang,
/area/space)
"y" = (
/obj/item/clothing/head/hardhat,
/turf/simulated/floor/exoplanet/konyang,
/area/space)
"A" = (
/obj/machinery/artifact,
/turf/simulated/floor/exoplanet/dirt_konyang,
/area/space)
"D" = (
/obj/structure/railing/fence,
/turf/simulated/floor/exoplanet/konyang,
/area/space)
"E" = (
/obj/structure/pit/closed/grave,
/obj/structure/gravemarker,
/turf/simulated/floor/exoplanet/dirt_konyang,
/area/space)
"F" = (
/obj/structure/barricade/wooden,
/turf/simulated/floor/exoplanet/konyang,
/area/space)
"G" = (
/obj/effect/konyang_waterfall,
/obj/effect/konyang_waterfall/mist,
/turf/simulated/floor/exoplanet/dirt_konyang,
/area/space)
"H" = (
/obj/structure/bonfire,
/turf/simulated/floor/exoplanet/konyang,
/area/space)
"I" = (
/obj/structure/anomaly_container,
/turf/simulated/floor/exoplanet/konyang,
/area/space)
"J" = (
/obj/effect/decal/remains/robot/burned,
/turf/simulated/floor/exoplanet/dirt_konyang,
/area/space)
"K" = (
/obj/structure/flora/ausbushes,
/turf/simulated/floor/exoplanet/dirt_konyang,
/area/space)
"M" = (
/obj/effect/landmark/corpse/miner,
/turf/simulated/floor/exoplanet/dirt_konyang,
/area/space)
"N" = (
/obj/structure/girder,
/turf/simulated/floor/exoplanet/konyang,
/area/space)
"P" = (
/obj/structure/pit,
/turf/simulated/floor/exoplanet/dirt_konyang,
/area/space)
"Q" = (
/obj/structure/clearing,
/turf/simulated/floor/exoplanet/dirt_konyang,
/area/space)
"R" = (
/obj/effect/decal/cleanable/blood/oil,
/turf/simulated/floor/exoplanet/dirt_konyang,
/area/space)
"S" = (
/obj/item/shovel,
/turf/simulated/floor/exoplanet/konyang,
/area/space)
"T" = (
/obj/effect/decal/remains/human,
/turf/simulated/floor/exoplanet/konyang,
/area/space)
"U" = (
/obj/item/pickaxe/drill,
/turf/simulated/floor/exoplanet/konyang,
/area/space)
"V" = (
/obj/effect/decal/remains/human/burned,
/turf/simulated/floor/exoplanet/konyang,
/area/space)
"W" = (
/turf/simulated/floor/exoplanet/dirt_konyang,
/area/space)
"X" = (
/obj/structure/flora/rock/konyang,
/turf/simulated/floor/exoplanet/dirt_konyang,
/area/space)
"Y" = (
/obj/effect/floor_decal/asteroid_dug,
/turf/simulated/floor/exoplanet/dirt_konyang,
/area/space)
"Z" = (
/obj/structure/headspear,
/turf/simulated/floor/exoplanet/dirt_konyang,
/area/space)

(1,1,1) = {"
a
a
a
a
a
a
a
a
a
a
a
a
a
a
a
a
a
a
a
W
W
W
W
W
W
a
a
a
a
a
a
a
a
a
a
a
a
a
a
a
"}
(2,1,1) = {"
a
W
W
W
a
a
a
a
a
a
a
W
W
W
a
a
a
W
W
W
g
g
g
g
W
W
W
a
a
a
a
a
a
a
a
a
W
W
a
a
"}
(3,1,1) = {"
W
W
a
a
a
a
a
w
W
W
W
W
W
W
W
W
W
W
g
g
g
g
w
w
g
g
W
W
W
W
a
a
a
a
a
W
W
a
W
a
"}
(4,1,1) = {"
W
a
a
a
a
a
w
w
w
W
W
W
W
W
W
w
w
W
W
g
g
w
w
w
w
g
g
g
g
g
W
W
W
a
a
W
a
a
W
W
"}
(5,1,1) = {"
a
a
a
a
a
a
a
w
w
w
w
W
W
w
w
w
w
w
W
W
W
w
u
u
w
W
W
W
W
g
g
W
w
w
a
a
a
a
a
W
"}
(6,1,1) = {"
a
a
a
a
W
W
W
w
u
u
w
w
w
w
w
w
w
w
w
u
w
w
u
w
w
w
W
W
w
w
w
w
w
w
w
a
a
R
a
W
"}
(7,1,1) = {"
a
a
a
W
W
w
w
w
u
s
s
s
s
s
w
w
w
w
w
u
w
w
u
w
w
w
w
w
w
w
s
s
s
w
w
a
y
J
a
a
"}
(8,1,1) = {"
a
a
W
W
w
w
w
u
u
u
u
s
s
s
s
w
w
w
u
u
u
u
u
u
u
w
w
w
w
s
s
w
s
w
w
w
U
m
E
a
"}
(9,1,1) = {"
a
a
W
W
u
u
u
u
w
w
u
u
w
s
s
u
u
u
u
w
w
w
w
u
s
u
s
w
s
s
w
w
s
w
w
h
k
V
W
a
"}
(10,1,1) = {"
a
W
W
w
w
w
u
u
w
w
u
w
w
w
w
w
w
w
w
w
w
w
w
w
s
u
u
s
s
w
w
s
s
w
G
M
S
T
q
a
"}
(11,1,1) = {"
a
W
w
w
s
w
u
w
w
w
s
w
w
w
s
s
s
s
s
s
s
s
w
w
s
s
u
s
s
w
w
s
w
w
w
A
e
t
H
a
"}
(12,1,1) = {"
a
W
w
s
s
w
w
w
s
s
s
w
w
s
s
w
w
w
w
w
w
s
s
w
w
s
s
s
s
w
w
s
s
u
w
w
w
a
F
a
"}
(13,1,1) = {"
a
W
w
w
s
w
w
w
s
w
w
w
s
s
w
w
s
s
s
w
w
w
s
s
w
w
s
s
s
w
w
w
w
u
w
w
K
o
I
a
"}
(14,1,1) = {"
W
W
W
w
s
s
w
s
s
w
w
w
s
w
w
s
s
s
s
s
s
w
w
s
s
w
w
s
s
s
s
u
u
s
w
b
Q
a
N
a
"}
(15,1,1) = {"
W
w
w
w
w
s
s
s
w
w
w
w
s
w
w
w
s
s
s
s
s
s
w
w
s
w
w
s
w
w
w
u
w
w
w
Y
P
a
v
a
"}
(16,1,1) = {"
W
W
w
w
s
s
w
w
w
w
s
s
s
w
w
w
w
w
w
s
s
s
s
w
s
s
w
s
w
w
u
u
u
w
w
w
X
a
r
a
"}
(17,1,1) = {"
W
w
w
s
s
s
s
w
w
s
s
s
s
w
s
s
s
w
s
s
s
s
s
w
w
s
s
s
w
w
u
w
u
u
w
w
Z
p
l
a
"}
(18,1,1) = {"
W
w
w
s
s
s
s
w
w
s
s
s
w
w
s
s
s
s
s
w
w
s
s
w
w
s
s
s
s
w
s
w
w
u
u
w
w
j
D
a
"}
(19,1,1) = {"
W
w
w
s
s
s
s
w
w
s
s
s
w
w
s
s
s
s
w
w
s
s
w
w
w
s
s
s
s
w
s
s
w
w
u
W
w
d
n
a
"}
(20,1,1) = {"
W
W
w
s
s
s
s
w
w
s
s
s
s
s
s
s
s
s
w
w
s
w
w
w
w
s
s
s
w
w
w
s
s
w
w
W
W
c
a
a
"}
(21,1,1) = {"
W
W
w
w
w
s
s
w
w
w
w
s
w
w
w
s
s
s
w
s
s
w
s
s
s
s
s
w
w
w
w
w
s
s
w
w
W
x
a
a
"}
(22,1,1) = {"
W
W
w
s
w
w
s
s
s
w
w
w
w
w
w
w
s
s
w
s
w
w
s
w
w
s
w
w
s
s
s
w
w
u
w
w
W
W
a
a
"}
(23,1,1) = {"
W
w
w
s
s
w
s
w
s
s
s
s
s
w
w
w
w
w
w
s
w
s
s
w
w
w
w
w
w
w
s
s
u
u
w
W
W
W
a
a
"}
(24,1,1) = {"
W
W
w
w
s
s
s
w
w
w
w
w
s
s
s
w
w
s
s
s
w
s
w
w
w
w
w
w
u
w
w
w
u
w
w
W
W
W
a
a
"}
(25,1,1) = {"
W
W
W
w
w
w
w
w
u
u
w
w
w
w
s
s
s
s
w
w
w
s
s
u
u
w
w
u
u
u
u
s
s
w
w
W
W
a
a
a
"}
(26,1,1) = {"
a
W
W
w
w
u
u
u
u
u
s
w
w
w
w
w
s
w
w
w
s
s
w
s
u
u
u
u
u
u
u
w
w
w
w
w
W
a
a
a
"}
(27,1,1) = {"
a
W
W
w
u
u
w
w
u
s
s
s
w
w
w
w
w
w
w
s
s
w
w
s
s
s
w
w
u
u
u
u
w
w
W
w
a
a
W
a
"}
(28,1,1) = {"
a
W
W
W
u
w
w
w
u
u
s
s
s
w
w
w
w
w
w
s
w
w
w
w
u
s
w
w
u
u
W
W
w
W
W
W
a
a
W
a
"}
(29,1,1) = {"
a
a
W
W
w
w
w
w
w
u
u
s
s
s
s
s
w
w
s
s
s
s
s
w
u
w
w
W
W
W
W
w
w
w
W
a
a
W
W
a
"}
(30,1,1) = {"
a
a
a
W
W
W
w
w
w
w
w
s
s
w
w
s
s
s
s
s
s
s
s
w
u
w
w
W
W
W
w
w
w
W
W
a
a
W
a
a
"}
(31,1,1) = {"
a
a
a
a
W
W
W
W
w
w
s
s
s
w
w
w
w
s
s
s
s
s
s
s
s
w
w
w
w
W
W
W
W
W
a
a
a
a
a
a
"}
(32,1,1) = {"
a
a
a
a
a
W
W
W
W
w
s
w
w
w
u
w
w
w
w
w
w
w
w
w
s
u
w
w
W
W
W
W
a
a
a
a
a
a
a
a
"}
(33,1,1) = {"
a
a
a
a
a
a
W
W
w
w
s
s
w
u
u
u
u
w
w
w
w
w
w
w
w
u
w
W
W
a
a
a
a
a
a
a
a
a
a
a
"}
(34,1,1) = {"
a
a
a
a
a
a
a
w
w
w
w
w
w
u
u
u
u
u
u
u
u
u
w
s
s
s
w
W
a
a
a
a
a
a
a
a
a
W
a
a
"}
(35,1,1) = {"
a
W
W
a
a
a
a
w
w
w
u
u
u
u
u
w
u
u
w
w
u
u
w
w
w
w
w
a
a
a
a
a
a
a
a
a
W
W
a
a
"}
(36,1,1) = {"
a
W
W
W
a
a
a
a
w
w
w
w
w
u
w
w
w
w
w
u
u
w
w
w
a
a
a
a
a
W
W
a
a
a
W
W
W
W
a
a
"}
(37,1,1) = {"
a
a
W
W
W
a
a
a
a
a
W
W
w
u
w
W
W
W
W
W
W
W
W
a
a
a
a
a
W
W
a
a
a
W
W
W
W
a
a
a
"}
(38,1,1) = {"
a
a
a
W
W
W
a
a
a
a
a
W
W
W
W
W
W
a
a
W
W
W
a
a
a
a
W
W
W
a
a
a
a
a
W
a
a
a
a
a
"}
(39,1,1) = {"
a
a
a
a
W
W
a
a
a
a
a
a
a
a
a
a
a
a
a
a
a
a
a
a
a
a
a
a
a
a
a
a
a
a
a
a
a
a
a
a
"}
(40,1,1) = {"
a
a
a
a
a
a
a
a
a
a
a
a
a
a
a
a
a
a
a
a
a
a
a
a
a
a
a
a
a
a
a
a
a
a
a
a
a
a
a
a
"}
