//MAP CONVERTED BY dmm2tgm.py THIS HEADER COMMENT PREVENTS RECONVERSION, DO NOT REMOVE
"a" = (
/turf/simulated/floor/exoplanet/konyang,
/area/exoplanet/grass/konyang)
"b" = (
/obj/effect/decal/cleanable/blood/drip,
/turf/simulated/floor/exoplanet/konyang,
/area/exoplanet/grass/konyang)
"c" = (
/obj/effect/decal/cleanable/blood/drip,
/turf/simulated/floor/exoplanet/konyang/wilting,
/area/exoplanet/grass/konyang)
"d" = (
/obj/item/trap/animal/large,
/turf/simulated/floor/wood,
/area/konyang/infected_recovery_post)
"e" = (
/obj/structure/flora/tree/konyang/spring,
/turf/simulated/floor/exoplanet/konyang/wilting,
/area/exoplanet/grass/konyang)
"f" = (
/obj/effect/map_effect/window_spawner/full/wood,
/turf/template_noop,
/area/exoplanet/grass/konyang)
"g" = (
/obj/machinery/door/urban{
	dir = 4
	},
/turf/simulated/floor/wood,
/area/konyang/infected_recovery_post)
"h" = (
/obj/structure/cable/green{
	icon_state = "0-4"
	},
/obj/machinery/power/portgen/basic,
/turf/simulated/floor/wood,
/area/konyang/infected_recovery_post)
"i" = (
/obj/effect/floor_decal/konyang_flowers,
/obj/effect/decal/cleanable/generic/beet_tree_petals,
/turf/simulated/floor/exoplanet/konyang/pink,
/area/exoplanet/grass/konyang)
"j" = (
/turf/simulated/floor/exoplanet/konyang/pink,
/area/exoplanet/grass/konyang)
"k" = (
/obj/effect/decal/cleanable/blood,
/turf/simulated/floor/exoplanet/konyang,
/area/exoplanet/grass/konyang)
"l" = (
/obj/structure/flora/tree/konyang/blossom,
/obj/effect/floor_decal/konyang_flowers,
/obj/effect/decal/cleanable/generic/beet_tree_petals,
/turf/simulated/floor/exoplanet/konyang/pink,
/area/exoplanet/grass/konyang)
"m" = (
/obj/structure/window_frame/wood,
/obj/item/material/shard,
/obj/item/material/shard,
/turf/template_noop,
/area/exoplanet/grass/konyang)
"n" = (
/obj/structure/flora/tree/konyang/spring,
/turf/simulated/floor/exoplanet/konyang,
/area/exoplanet/grass/konyang)
"o" = (
/obj/machinery/light{
	dir = 1;
	pixel_y = 4
	},
/obj/item/trap/animal/large,
/turf/simulated/floor/wood,
/area/konyang/infected_recovery_post)
"p" = (
/obj/effect/floor_decal/konyang_flowers,
/turf/simulated/floor/exoplanet/konyang/wilting,
/area/exoplanet/grass/konyang)
"q" = (
/obj/structure/closet{
	name = "KRC Researcher Gear"
	},
/obj/item/stack/nanopaste,
/obj/item/stack/nanopaste,
/obj/item/clothing/suit/storage/toggle/labcoat,
/obj/item/device/taperecorder,
/obj/item/device/camera,
/obj/item/device/camera_film,
/turf/simulated/floor/wood,
/area/konyang/infected_recovery_post)
"t" = (
/turf/simulated/floor/exoplanet/konyang/wilting,
/area/exoplanet/grass/konyang)
"u" = (
/obj/structure/chainlink_fence{
	dir = 1
	},
/obj/structure/chainlink_fence{
	dir = 4
	},
/turf/simulated/floor/exoplanet/dirt_konyang,
/area/konyang)
"v" = (
/obj/item/bedsheet,
/obj/structure/bed/padded,
/obj/effect/ghostspawpoint{
	identifier = "konyang_infected_recovery_researcher";
	name = "igs - infected_recovery_researcher"
	},
/turf/simulated/floor/wood,
/area/konyang/infected_recovery_post)
"w" = (
/obj/structure/chainlink_fence{
	dir = 2
	},
/turf/simulated/floor/exoplanet/dirt_konyang,
/area/konyang)
"y" = (
/turf/simulated/floor/wood,
/area/exoplanet/grass/konyang)
"z" = (
/obj/machinery/power/apc{
	dir = 4;
	pixel_y = 0;
	pixel_x = 11
	},
/obj/structure/cable/green{
	icon_state = "0-8"
	},
/turf/simulated/floor/wood,
/area/konyang/infected_recovery_post)
"A" = (
/turf/simulated/floor/wood,
/area/konyang/infected_recovery_post)
"B" = (
/obj/structure/flora/bush/konyang_reeds,
/turf/simulated/floor/exoplanet/konyang,
/area/exoplanet/grass/konyang)
"C" = (
/obj/effect/floor_decal/konyang_flowers,
/turf/simulated/floor/exoplanet/konyang,
/area/exoplanet/grass/konyang)
"D" = (
/obj/structure/closet{
	name = "Infected Recovery Policeman Gear"
	},
/obj/item/gun/projectile/revolver/konyang/police,
/obj/item/ammo_magazine/c45/revolver,
/obj/item/ammo_magazine/c45/revolver,
/obj/item/ammo_magazine/c45/revolver,
/obj/item/clothing/head/helmet/riot,
/obj/item/clothing/suit/armor/carrier/riot,
/obj/item/shield/riot,
/obj/item/melee/baton/stunrod,
/obj/item/reagent_containers/spray/pepper,
/obj/item/handcuffs,
/turf/simulated/floor/wood,
/area/konyang/infected_recovery_post)
"E" = (
/obj/item/bedsheet,
/obj/structure/bed/padded,
/obj/effect/ghostspawpoint{
	name = "igs - infected_recovery_cop";
	identifier = "konyang_infected_recovery_cop"
	},
/turf/simulated/floor/wood,
/area/konyang/infected_recovery_post)
"F" = (
/obj/machinery/door/urban{
	dir = 1
	},
/obj/effect/decal/cleanable/blood,
/turf/simulated/floor/wood,
/area/exoplanet/grass/konyang)
"G" = (
/obj/structure/table/steel,
/obj/item/storage/firstaid/adv{
	pixel_x = 5;
	pixel_y = -1
	},
/obj/item/storage/firstaid/regular{
	pixel_y = 8;
	pixel_x = -4
	},
/turf/simulated/floor/wood,
/area/konyang/infected_recovery_post)
"H" = (
/obj/machinery/recharger/wallcharger{
	pixel_x = 32;
	pixel_y = -3
	},
/turf/simulated/floor/wood,
/area/konyang/infected_recovery_post)
"I" = (
/obj/structure/chainlink_fence,
/turf/simulated/floor/exoplanet/dirt_konyang,
/area/konyang)
"J" = (
/obj/structure/table/steel,
/obj/item/storage/box/bodybags,
/obj/item/storage/box/bodybags,
/obj/item/stack/material/graphite/full{
	pixel_y = 7;
	pixel_x = 7
	},
/turf/simulated/floor/wood,
/area/konyang/infected_recovery_post)
"K" = (
/obj/effect/decal/cleanable/generic/beet_tree_petals,
/turf/simulated/floor/exoplanet/konyang,
/area/exoplanet/grass/konyang)
"L" = (
/obj/effect/landmark/corpse/konyang_villager,
/obj/effect/decal/cleanable/blood,
/turf/simulated/floor/wood,
/area/exoplanet/grass/konyang)
"M" = (
/turf/simulated/wall/wood,
/area/exoplanet/grass/konyang)
"N" = (
/obj/machinery/recharger/wallcharger{
	pixel_x = 33;
	pixel_y = 4
	},
/turf/simulated/floor/wood,
/area/konyang/infected_recovery_post)
"O" = (
/obj/structure/chainlink_fence{
	dir = 1
	},
/turf/simulated/floor/exoplanet/dirt_konyang,
/area/konyang)
"P" = (
/turf/simulated/floor/exoplanet/dirt_konyang,
/area/konyang)
"Q" = (
/obj/structure/chainlink_fence{
	dir = 4
	},
/turf/simulated/floor/exoplanet/dirt_konyang,
/area/konyang)
"S" = (
/obj/effect/decal/cleanable/blood,
/turf/simulated/floor/wood,
/area/exoplanet/grass/konyang)
"U" = (
/obj/structure/automobile/police,
/turf/simulated/floor/exoplanet/dirt_konyang,
/area/konyang)
"V" = (
/obj/machinery/light,
/turf/simulated/floor/wood,
/area/konyang/infected_recovery_post)
"W" = (
/turf/simulated/wall/wood,
/area/konyang/infected_recovery_post)
"X" = (
/obj/structure/flora/bush/konyang_reeds,
/turf/simulated/floor/exoplanet/konyang/wilting,
/area/exoplanet/grass/konyang)
"Y" = (
/mob/living/simple_animal/hostile/ipc_zombie,
/turf/simulated/floor/wood,
/area/exoplanet/grass/konyang)
"Z" = (
/obj/effect/floor_decal/konyang_flowers,
/turf/simulated/floor/exoplanet/konyang/pink,
/area/exoplanet/grass/konyang)

(1,1,1) = {"
a
a
a
a
a
a
a
a
a
a
a
a
a
a
a
a
a
a
a
a
a
a
a
a
a
a
a
a
a
a
"}
(2,1,1) = {"
a
a
a
a
a
a
t
t
t
a
a
a
a
a
a
a
a
a
a
a
a
a
a
a
a
a
a
a
a
a
"}
(3,1,1) = {"
a
a
n
a
a
a
t
e
t
a
C
p
p
p
p
C
a
a
a
a
a
a
n
a
a
a
a
a
a
a
"}
(4,1,1) = {"
a
a
a
a
a
a
t
t
t
a
C
p
t
t
t
a
a
a
a
a
a
a
a
a
a
a
a
a
a
a
"}
(5,1,1) = {"
a
a
a
B
a
a
C
a
a
a
a
a
a
a
a
a
a
C
a
a
a
a
B
a
a
C
a
t
a
a
"}
(6,1,1) = {"
a
a
B
B
a
a
C
a
a
a
a
B
B
B
B
a
a
a
a
a
a
a
B
a
a
C
C
a
a
a
"}
(7,1,1) = {"
a
t
t
a
a
a
a
a
a
a
a
a
a
a
a
a
a
a
a
Z
a
a
B
a
a
a
a
a
a
a
"}
(8,1,1) = {"
a
X
X
a
a
t
a
a
a
W
W
W
W
W
W
W
W
a
a
Z
i
a
a
a
a
a
a
a
a
a
"}
(9,1,1) = {"
a
t
t
a
a
a
a
a
a
W
E
D
E
D
v
q
W
a
a
Z
Z
j
a
a
a
a
n
a
a
a
"}
(10,1,1) = {"
a
a
a
a
a
a
a
B
a
W
A
A
A
A
A
A
W
a
Z
Z
Z
Z
a
a
a
a
a
a
a
a
"}
(11,1,1) = {"
a
a
a
a
a
a
a
B
a
W
o
A
A
A
A
V
W
a
a
Z
l
Z
i
a
a
a
a
a
a
a
"}
(12,1,1) = {"
a
a
a
a
a
a
a
a
a
W
d
A
J
G
A
h
W
a
a
Z
Z
Z
Z
a
C
a
a
a
B
a
"}
(13,1,1) = {"
a
a
a
n
a
p
a
a
a
W
d
A
A
H
N
z
W
a
a
a
Z
Z
Z
a
C
a
a
a
X
t
"}
(14,1,1) = {"
a
a
a
a
a
C
a
a
a
W
W
W
g
W
W
W
W
a
a
a
Z
Z
a
K
a
a
a
a
t
X
"}
(15,1,1) = {"
a
a
a
a
a
a
a
a
a
O
P
P
P
P
P
P
I
a
a
a
a
a
a
a
a
a
a
C
t
X
"}
(16,1,1) = {"
a
a
a
a
a
a
a
a
a
O
P
P
P
P
P
U
I
a
a
a
a
a
a
a
a
a
C
C
t
X
"}
(17,1,1) = {"
a
a
C
C
t
a
a
a
a
O
P
P
P
P
P
P
I
a
a
a
a
a
a
a
a
a
a
a
t
X
"}
(18,1,1) = {"
a
a
C
C
a
C
a
a
a
O
P
P
P
P
P
P
I
a
a
a
a
C
a
a
a
a
a
a
t
X
"}
(19,1,1) = {"
a
a
a
a
a
C
a
a
a
O
P
P
P
P
P
P
I
a
a
B
a
C
M
f
f
M
M
a
a
B
"}
(20,1,1) = {"
a
a
a
a
t
p
a
a
a
O
P
P
P
P
P
P
I
a
a
B
a
a
f
y
y
y
M
a
a
a
"}
(21,1,1) = {"
a
a
a
a
t
p
a
a
a
O
P
P
P
P
P
P
I
a
B
B
a
b
F
y
Y
L
M
a
a
a
"}
(22,1,1) = {"
a
a
a
a
a
a
a
a
a
O
P
P
P
P
P
P
I
a
B
a
a
a
m
y
y
S
M
a
a
a
"}
(23,1,1) = {"
C
a
C
C
a
a
a
a
a
u
Q
Q
Q
P
P
P
w
a
B
a
b
a
M
m
m
M
M
a
C
a
"}
(24,1,1) = {"
C
a
a
C
a
a
t
t
a
a
a
a
B
a
a
a
a
a
a
a
a
a
a
a
a
a
a
a
C
a
"}
(25,1,1) = {"
a
a
a
a
n
a
t
t
a
a
a
a
a
B
B
a
a
a
a
a
k
a
a
a
a
a
a
t
t
a
"}
(26,1,1) = {"
a
a
a
a
a
a
a
a
a
n
a
B
B
B
B
B
a
a
C
a
a
a
a
a
a
a
a
t
t
a
"}
(27,1,1) = {"
a
a
a
a
a
a
a
a
a
a
a
a
a
a
a
a
a
C
a
c
t
a
B
a
a
n
a
a
B
B
"}
(28,1,1) = {"
a
a
a
a
a
a
a
a
a
a
a
C
C
a
a
a
C
a
a
t
t
a
B
a
a
a
a
a
a
a
"}
(29,1,1) = {"
a
a
a
a
a
a
a
a
a
C
C
a
a
a
a
a
a
a
b
a
a
a
B
a
a
a
C
C
C
a
"}
(30,1,1) = {"
a
a
a
a
a
a
a
a
a
a
a
a
t
t
t
a
a
a
a
a
a
B
B
a
a
C
C
a
a
a
"}
