//MAP CONVERTED BY dmm2tgm.py THIS HEADER COMMENT PREVENTS RECONVERSION, DO NOT REMOVE
"a" = (
/turf/simulated/floor/exoplanet/konyang,
/area/exoplanet/grass/konyang)
"b" = (
/obj/structure/flora/bush/konyang_reeds,
/turf/simulated/floor/exoplanet/konyang/wilting,
/area/exoplanet/grass/konyang)
"c" = (
/obj/effect/decal/cleanable/blood/drip,
/turf/simulated/floor/exoplanet/konyang,
/area/exoplanet/grass/konyang)
"d" = (
/obj/item/trap/animal/large,
/turf/simulated/floor/wood,
/area/konyang/infected_recovery_post)
"f" = (
/obj/effect/map_effect/window_spawner/full/wood,
/turf/simulated/floor/exoplanet/konyang,
/area/exoplanet/grass/konyang)
"g" = (
/obj/machinery/door/urban{
	dir = 4
	},
/turf/simulated/floor/wood,
/area/konyang/infected_recovery_post)
"h" = (
/obj/structure/cable/green{
	icon_state = "0-4"
	},
/obj/machinery/power/portgen/basic,
/turf/simulated/floor/wood,
/area/konyang/infected_recovery_post)
"i" = (
/obj/structure/flora/tree/konyang/blossom,
/obj/effect/floor_decal/konyang_flowers,
/obj/effect/decal/cleanable/generic/beet_tree_petals,
/turf/simulated/floor/exoplanet/konyang/pink,
/area/exoplanet/grass/konyang)
"j" = (
/turf/simulated/floor/exoplanet/konyang/wilting,
/area/exoplanet/grass/konyang)
"k" = (
/obj/effect/decal/cleanable/blood,
/turf/simulated/floor/exoplanet/konyang,
/area/exoplanet/grass/konyang)
"l" = (
/obj/effect/decal/cleanable/blood/drip,
/turf/simulated/floor/exoplanet/konyang/wilting,
/area/exoplanet/grass/konyang)
"m" = (
/obj/structure/window_frame/wood,
/obj/item/material/shard,
/obj/item/material/shard,
/turf/template_noop,
/area/exoplanet/grass/konyang)
"o" = (
/obj/machinery/light{
	dir = 1;
	pixel_y = 4
	},
/obj/item/trap/animal/large,
/turf/simulated/floor/wood,
/area/konyang/infected_recovery_post)
"q" = (
/obj/structure/closet{
	name = "KRC Researcher Gear"
	},
/obj/item/stack/nanopaste,
/obj/item/stack/nanopaste,
/obj/item/clothing/suit/storage/toggle/labcoat,
/obj/item/device/taperecorder,
/obj/item/device/camera,
/obj/item/device/camera_film,
/turf/simulated/floor/wood,
/area/konyang/infected_recovery_post)
"r" = (
/obj/structure/flora/tree/konyang/spring,
/turf/simulated/floor/exoplanet/konyang/wilting,
/area/exoplanet/grass/konyang)
"s" = (
/obj/structure/flora/bush/konyang_reeds,
/turf/simulated/floor/exoplanet/konyang,
/area/exoplanet/grass/konyang)
"t" = (
/obj/effect/floor_decal/konyang_flowers,
/turf/simulated/floor/exoplanet/konyang/pink,
/area/exoplanet/grass/konyang)
"u" = (
/obj/structure/chainlink_fence{
	dir = 1
	},
/obj/structure/chainlink_fence{
	dir = 4
	},
/turf/simulated/floor/exoplanet/dirt_konyang,
/area/konyang)
"v" = (
/obj/item/bedsheet,
/obj/structure/bed/padded,
/obj/effect/ghostspawpoint{
	identifier = "konyang_infected_recovery_researcher";
	name = "igs - infected_recovery_researcher"
	},
/turf/simulated/floor/wood,
/area/konyang/infected_recovery_post)
"w" = (
/obj/structure/chainlink_fence{
	dir = 2
	},
/turf/simulated/floor/exoplanet/dirt_konyang,
/area/konyang)
"y" = (
/turf/simulated/floor/wood,
/area/exoplanet/grass/konyang)
"z" = (
/obj/machinery/power/apc{
	dir = 4;
	pixel_y = 0;
	pixel_x = 11
	},
/obj/structure/cable/green{
	icon_state = "0-8"
	},
/turf/simulated/floor/wood,
/area/konyang/infected_recovery_post)
"A" = (
/turf/simulated/floor/wood,
/area/konyang/infected_recovery_post)
"B" = (
/turf/simulated/floor/exoplanet/konyang/pink,
/area/exoplanet/grass/konyang)
"C" = (
/obj/effect/floor_decal/konyang_flowers,
/obj/effect/decal/cleanable/generic/beet_tree_petals,
/turf/simulated/floor/exoplanet/konyang/pink,
/area/exoplanet/grass/konyang)
"D" = (
/obj/structure/closet{
	name = "Infected Recovery Policeman Gear"
	},
/obj/item/gun/projectile/revolver/konyang/police,
/obj/item/ammo_magazine/c45/revolver,
/obj/item/ammo_magazine/c45/revolver,
/obj/item/ammo_magazine/c45/revolver,
/obj/item/clothing/head/helmet/riot,
/obj/item/clothing/suit/armor/carrier/riot,
/obj/item/shield/riot,
/obj/item/melee/baton/stunrod,
/obj/item/reagent_containers/spray/pepper,
/obj/item/handcuffs,
/turf/simulated/floor/wood,
/area/konyang/infected_recovery_post)
"E" = (
/obj/item/bedsheet,
/obj/structure/bed/padded,
/obj/effect/ghostspawpoint{
	name = "igs - infected_recovery_cop";
	identifier = "konyang_infected_recovery_cop"
	},
/turf/simulated/floor/wood,
/area/konyang/infected_recovery_post)
"F" = (
/obj/machinery/door/urban{
	dir = 1
	},
/obj/effect/decal/cleanable/blood,
/turf/simulated/floor/wood,
/area/exoplanet/grass/konyang)
"G" = (
/obj/structure/table/steel,
/obj/item/storage/firstaid/adv{
	pixel_x = 5;
	pixel_y = -1
	},
/obj/item/storage/firstaid/regular{
	pixel_y = 8;
	pixel_x = -4
	},
/turf/simulated/floor/wood,
/area/konyang/infected_recovery_post)
"H" = (
/obj/machinery/recharger/wallcharger{
	pixel_x = 32;
	pixel_y = -3
	},
/turf/simulated/floor/wood,
/area/konyang/infected_recovery_post)
"I" = (
/obj/structure/chainlink_fence,
/turf/simulated/floor/exoplanet/dirt_konyang,
/area/konyang)
"J" = (
/obj/structure/table/steel,
/obj/item/storage/box/bodybags,
/obj/item/storage/box/bodybags,
/obj/item/stack/material/graphite/full{
	pixel_y = 7;
	pixel_x = 7
	},
/turf/simulated/floor/wood,
/area/konyang/infected_recovery_post)
"K" = (
/obj/structure/flora/tree/konyang/spring,
/turf/simulated/floor/exoplanet/konyang,
/area/exoplanet/grass/konyang)
"L" = (
/obj/effect/landmark/corpse/konyang_villager,
/obj/effect/decal/cleanable/blood,
/turf/simulated/floor/wood,
/area/exoplanet/grass/konyang)
"M" = (
/turf/simulated/wall/wood,
/area/exoplanet/grass/konyang)
"N" = (
/obj/machinery/recharger/wallcharger{
	pixel_x = 33;
	pixel_y = 4
	},
/turf/simulated/floor/wood,
/area/konyang/infected_recovery_post)
"O" = (
/obj/structure/chainlink_fence{
	dir = 1
	},
/turf/simulated/floor/exoplanet/dirt_konyang,
/area/konyang)
"P" = (
/turf/simulated/floor/exoplanet/dirt_konyang,
/area/konyang)
"Q" = (
/obj/structure/chainlink_fence{
	dir = 4
	},
/turf/simulated/floor/exoplanet/dirt_konyang,
/area/konyang)
"R" = (
/obj/effect/floor_decal/konyang_flowers,
/turf/simulated/floor/exoplanet/konyang/wilting,
/area/exoplanet/grass/konyang)
"S" = (
/obj/effect/decal/cleanable/blood,
/turf/simulated/floor/wood,
/area/exoplanet/grass/konyang)
"T" = (
/obj/effect/decal/cleanable/generic/beet_tree_petals,
/turf/simulated/floor/exoplanet/konyang,
/area/exoplanet/grass/konyang)
"U" = (
/obj/structure/automobile/police,
/turf/simulated/floor/exoplanet/dirt_konyang,
/area/konyang)
"V" = (
/obj/machinery/light,
/turf/simulated/floor/wood,
/area/konyang/infected_recovery_post)
"W" = (
/turf/simulated/wall/wood,
/area/konyang/infected_recovery_post)
"Y" = (
/mob/living/simple_animal/hostile/ipc_zombie,
/turf/simulated/floor/wood,
/area/exoplanet/grass/konyang)
"Z" = (
/obj/effect/floor_decal/konyang_flowers,
/turf/simulated/floor/exoplanet/konyang,
/area/exoplanet/grass/konyang)

(1,1,1) = {"
a
a
a
a
a
a
a
a
a
a
a
a
a
a
a
a
a
a
a
a
a
a
a
a
a
a
a
a
a
a
"}
(2,1,1) = {"
a
a
a
a
a
a
j
j
j
a
a
a
a
a
a
a
a
a
a
a
a
a
a
a
a
a
a
a
a
a
"}
(3,1,1) = {"
a
a
K
a
a
a
j
r
j
a
Z
R
R
R
R
Z
a
a
a
a
a
a
K
a
a
a
a
a
a
a
"}
(4,1,1) = {"
a
a
a
a
a
a
j
j
j
a
Z
R
j
j
j
a
a
a
a
a
a
a
a
a
a
a
a
a
a
a
"}
(5,1,1) = {"
a
a
a
s
a
a
Z
a
a
a
a
a
a
a
a
a
a
Z
a
a
a
a
s
a
a
Z
a
j
a
a
"}
(6,1,1) = {"
a
a
s
s
a
a
Z
a
a
a
a
s
s
s
s
a
a
a
a
a
a
a
s
a
a
Z
Z
a
a
a
"}
(7,1,1) = {"
a
j
j
a
a
a
a
a
a
a
a
a
a
a
a
a
a
a
a
t
a
a
s
a
a
a
a
a
a
a
"}
(8,1,1) = {"
a
b
b
a
a
j
a
a
a
W
W
W
W
W
W
W
W
a
a
t
C
a
a
a
a
a
a
a
a
a
"}
(9,1,1) = {"
a
j
j
a
a
a
a
a
a
W
E
D
E
D
v
q
W
a
a
t
t
B
a
a
a
a
K
a
a
a
"}
(10,1,1) = {"
a
a
a
a
a
a
a
s
a
W
A
A
A
A
A
A
W
a
t
t
t
t
a
a
a
a
a
a
a
a
"}
(11,1,1) = {"
a
a
a
a
a
a
a
s
a
W
o
A
A
A
A
V
W
a
a
t
i
t
C
a
a
a
a
a
a
a
"}
(12,1,1) = {"
a
a
a
a
a
a
a
a
a
W
d
A
J
G
A
h
W
a
a
t
t
t
t
a
Z
a
a
a
s
a
"}
(13,1,1) = {"
a
a
a
K
a
R
a
a
a
W
d
A
A
H
N
z
W
a
a
a
t
t
t
a
Z
a
a
a
b
j
"}
(14,1,1) = {"
a
a
a
a
a
Z
a
a
a
W
W
W
g
W
W
W
W
a
a
a
t
t
a
T
a
a
a
a
j
b
"}
(15,1,1) = {"
a
a
a
a
a
a
a
a
a
O
P
P
P
P
P
P
I
a
a
a
a
a
a
a
a
a
a
Z
j
b
"}
(16,1,1) = {"
a
a
a
a
a
a
a
a
a
O
P
P
P
P
P
U
I
a
a
a
a
a
a
a
a
a
Z
Z
j
b
"}
(17,1,1) = {"
a
a
Z
Z
j
a
a
a
a
O
P
P
P
P
P
P
I
a
a
a
a
a
a
a
a
a
a
a
j
b
"}
(18,1,1) = {"
a
a
Z
Z
a
Z
a
a
a
O
P
P
P
P
P
P
I
a
a
a
a
Z
a
a
a
a
a
a
j
b
"}
(19,1,1) = {"
a
a
a
a
a
Z
a
a
a
O
P
P
P
P
P
P
I
a
a
s
a
Z
M
f
f
M
M
a
a
s
"}
(20,1,1) = {"
a
a
a
a
j
R
a
a
a
O
P
P
P
P
P
P
I
a
a
s
a
a
f
y
y
y
M
a
a
a
"}
(21,1,1) = {"
a
a
a
a
j
R
a
a
a
O
P
P
P
P
P
P
I
a
s
s
a
c
F
y
Y
L
M
a
a
a
"}
(22,1,1) = {"
a
a
a
a
a
a
a
a
a
O
P
P
P
P
P
P
I
a
s
a
a
a
m
y
y
S
M
a
a
a
"}
(23,1,1) = {"
Z
a
Z
Z
a
a
a
a
a
u
Q
Q
Q
P
P
P
w
a
s
a
c
a
M
m
m
M
M
a
Z
a
"}
(24,1,1) = {"
Z
a
a
Z
a
a
j
j
a
a
a
a
s
a
a
a
a
a
a
a
a
a
a
a
a
a
a
a
Z
a
"}
(25,1,1) = {"
a
a
a
a
K
a
j
j
a
a
a
a
a
s
s
a
a
a
a
a
k
a
a
a
a
a
a
j
j
a
"}
(26,1,1) = {"
a
a
a
a
a
a
a
a
a
K
a
s
s
s
s
s
a
a
Z
a
a
a
a
a
a
a
a
j
j
a
"}
(27,1,1) = {"
a
a
a
a
a
a
a
a
a
a
a
a
a
a
a
a
a
Z
a
l
j
a
s
a
a
K
a
a
s
s
"}
(28,1,1) = {"
a
a
a
a
a
a
a
a
a
a
a
Z
Z
a
a
a
Z
a
a
j
j
a
s
a
a
a
a
a
a
a
"}
(29,1,1) = {"
a
a
a
a
a
a
a
a
a
Z
Z
a
a
a
a
a
a
a
c
a
a
a
s
a
a
a
Z
Z
Z
a
"}
(30,1,1) = {"
a
a
a
a
a
a
a
a
a
a
a
a
j
j
j
a
a
a
a
a
a
s
s
a
a
Z
Z
a
a
a
"}
