//MAP CONVERTED BY dmm2tgm.py THIS HEADER COMMENT PREVENTS RECONVERSION, DO NOT REMOVE
"a" = (
/turf/simulated/floor/exoplanet/konyang,
/area/exoplanet/grass/konyang)
"c" = (
/obj/structure/flora/rock/konyang/small,
/turf/simulated/floor/exoplanet/konyang,
/area/exoplanet/grass/konyang)
"g" = (
/obj/item/ore/silver,
/turf/simulated/floor/exoplanet/dirt_konyang,
/area/exoplanet/grass/konyang)
"h" = (
/turf/simulated/floor/exoplanet/water/shallow/konyang,
/area/exoplanet/grass/konyang)
"i" = (
/obj/structure/flora/rock/konyang/small,
/turf/simulated/floor/exoplanet/dirt_konyang,
/area/exoplanet/grass/konyang)
"l" = (
/mob/living/simple_animal/hostile/retaliate/jewelercockatoo,
/obj/structure/flora/rock/konyang,
/turf/simulated/floor/exoplanet/dirt_konyang,
/area/exoplanet/grass/konyang)
"q" = (
/obj/structure/flora/tree/konyang/spring,
/turf/simulated/floor/exoplanet/konyang,
/area/exoplanet/grass/konyang)
"v" = (
/obj/item/ore/osmium,
/turf/simulated/floor/exoplanet/dirt_konyang,
/area/exoplanet/grass/konyang)
"D" = (
/obj/structure/flora/ausbushes/ppflowers,
/turf/simulated/floor/exoplanet/konyang,
/area/exoplanet/grass/konyang)
"E" = (
/obj/structure/pit,
/obj/item/ore/osmium,
/turf/simulated/floor/exoplanet/dirt_konyang,
/area/exoplanet/grass/konyang)
"G" = (
/turf/simulated/floor/exoplanet/dirt_konyang,
/area/exoplanet/grass/konyang)
"L" = (
/obj/structure/flora/bush/konyang_reeds,
/turf/simulated/floor/exoplanet/konyang,
/area/exoplanet/grass/konyang)
"M" = (
/obj/item/ore/gold,
/turf/simulated/floor/exoplanet/dirt_konyang,
/area/exoplanet/grass/konyang)
"O" = (
/obj/item/clothing/accessory/necklace/chain,
/turf/simulated/floor/exoplanet/dirt_konyang,
/area/exoplanet/grass/konyang)
"P" = (
/obj/item/ore/diamond,
/turf/simulated/floor/exoplanet/dirt_konyang,
/area/exoplanet/grass/konyang)
"T" = (
/obj/structure/pit,
/turf/simulated/floor/exoplanet/dirt_konyang,
/area/exoplanet/grass/konyang)
"U" = (
/obj/item/stack/material/diamond,
/turf/simulated/floor/exoplanet/dirt_konyang,
/area/exoplanet/grass/konyang)
"W" = (
/obj/structure/flora/bush/konyang_reeds/water,
/turf/simulated/floor/exoplanet/water/shallow/konyang,
/area/exoplanet/grass/konyang)
"X" = (
/obj/structure/flora/rock/konyang/water,
/turf/simulated/floor/exoplanet/water/shallow/konyang,
/area/exoplanet/grass/konyang)
"Y" = (
/obj/item/ore/gold,
/obj/item/ore/osmium,
/turf/simulated/floor/exoplanet/dirt_konyang,
/area/exoplanet/grass/konyang)

(1,1,1) = {"
a
a
a
h
a
a
a
a
a
a
a
a
a
a
a
L
a
a
a
a
a
"}
(2,1,1) = {"
a
h
a
h
h
h
h
a
a
L
a
a
a
a
L
L
L
L
a
a
a
"}
(3,1,1) = {"
a
h
W
h
W
h
h
h
L
L
D
D
D
a
a
a
L
L
L
a
a
"}
(4,1,1) = {"
a
h
h
h
X
h
h
h
L
a
a
a
a
D
a
a
a
a
a
q
a
"}
(5,1,1) = {"
a
a
W
h
h
h
h
a
a
a
a
a
a
a
a
a
D
a
a
a
a
"}
(6,1,1) = {"
a
h
h
h
W
a
a
a
a
a
G
G
M
G
a
a
a
L
a
a
a
"}
(7,1,1) = {"
a
h
h
h
h
D
a
a
G
i
G
M
v
G
a
a
a
L
L
a
a
"}
(8,1,1) = {"
L
L
h
a
a
a
a
M
M
g
U
G
P
g
a
a
a
a
L
L
a
"}
(9,1,1) = {"
a
L
a
a
a
a
a
G
v
G
M
E
U
i
G
a
a
a
a
L
a
"}
(10,1,1) = {"
a
a
a
a
a
G
U
i
T
G
G
G
M
G
T
a
a
a
a
a
a
"}
(11,1,1) = {"
a
a
D
a
a
G
G
g
M
G
O
G
G
P
G
G
a
a
a
a
a
"}
(12,1,1) = {"
a
a
a
a
a
G
M
P
T
G
l
G
G
M
G
G
a
a
a
c
a
"}
(13,1,1) = {"
a
a
L
a
a
i
G
U
G
G
G
M
G
G
i
G
a
a
a
a
a
"}
(14,1,1) = {"
a
a
L
a
a
G
M
P
M
G
G
G
G
U
G
a
a
a
a
a
a
"}
(15,1,1) = {"
a
a
L
L
a
a
G
T
v
G
Y
v
g
G
a
a
a
a
a
a
a
"}
(16,1,1) = {"
a
a
L
L
a
a
a
G
G
M
G
P
T
G
a
a
D
a
a
L
L
"}
(17,1,1) = {"
a
a
a
L
c
a
a
G
G
i
G
G
G
a
a
a
a
a
a
L
a
"}
(18,1,1) = {"
a
q
a
L
a
a
a
a
a
a
a
a
a
a
a
a
a
a
L
L
a
"}
(19,1,1) = {"
a
a
a
a
a
a
a
a
D
a
a
a
a
a
L
L
a
a
L
a
a
"}
(20,1,1) = {"
a
a
D
a
a
a
a
a
a
a
c
a
a
a
a
a
a
a
a
a
a
"}
(21,1,1) = {"
a
a
a
a
a
a
a
a
a
a
a
a
a
D
a
a
a
a
a
a
a
"}
