//MAP CONVERTED BY dmm2tgm.py THIS HEADER COMMENT PREVENTS RECONVERSION, DO NOT REMOVE
"a" = (
/turf/simulated/floor/exoplanet/konyang,
/area/konyang_pirate_moonshine)
"b" = (
/obj/structure/flora/rock/konyang/water,
/turf/simulated/floor/exoplanet/water/shallow/konyang,
/area/konyang_pirate_moonshine)
"e" = (
/obj/item/storage/toolbox/mechanical,
/obj/structure/table/standard,
/obj/item/weldingtool,
/obj/item/weldingtool,
/turf/simulated/floor/wood,
/area/konyang_pirate_moonshine)
"f" = (
/obj/structure/undies_wardrobe,
/turf/simulated/floor/wood,
/area/konyang_pirate_moonshine)
"h" = (
/turf/simulated/floor/exoplanet/water/shallow/konyang,
/area/konyang_pirate_moonshine)
"i" = (
/obj/structure/reagent_dispensers/fueltank,
/obj/machinery/light{
	dir = 8
	},
/turf/simulated/floor/wood,
/area/konyang_pirate_moonshine)
"j" = (
/obj/structure/table/standard,
/obj/item/clothing/mask/gas,
/obj/item/clothing/mask/gas,
/obj/item/clothing/head/hazmat,
/obj/item/clothing/suit/hazmat,
/turf/simulated/floor/wood,
/area/konyang_pirate_moonshine)
"k" = (
/obj/structure/chemkit,
/obj/item/reagent_containers/glass/beaker/vial/random,
/turf/simulated/floor/wood,
/area/konyang_pirate_moonshine)
"l" = (
/obj/structure/distillery,
/turf/simulated/floor/wood,
/area/konyang_pirate_moonshine)
"n" = (
/obj/structure/closet/cabinet,
/obj/item/storage/box/fancy/cigarettes/rugged,
/obj/item/storage/box/fancy/cigarettes/rugged,
/obj/item/flame/lighter/random,
/obj/item/clothing/accessory/holster/armpit/brown,
/turf/simulated/floor/wood,
/area/konyang_pirate_moonshine)
"p" = (
/obj/structure/table/standard,
/obj/item/reagent_containers/food/condiment/small/packet/salt,
/obj/item/reagent_containers/food/condiment/small/packet/salt,
/obj/item/reagent_containers/food/condiment/small/packet/salt,
/obj/item/reagent_containers/food/condiment/small/packet/salt,
/obj/item/reagent_containers/spray/cleaner,
/obj/item/reagent_containers/spray/cleaner,
/obj/item/reagent_containers/spray/cleaner,
/turf/simulated/floor/wood,
/area/konyang_pirate_moonshine)
"q" = (
/obj/structure/table/standard,
/obj/item/reagent_containers/food/drinks/bottle,
/obj/item/reagent_containers/food/drinks/bottle,
/obj/item/reagent_containers/food/drinks/bottle,
/obj/item/reagent_containers/food/drinks/bottle,
/obj/item/reagent_containers/food/drinks/bottle,
/obj/item/reagent_containers/food/drinks/bottle,
/obj/machinery/light{
	dir = 8
	},
/turf/simulated/floor/wood,
/area/konyang_pirate_moonshine)
"r" = (
/obj/structure/reagent_dispensers/watertank,
/obj/machinery/light{
	dir = 4
	},
/turf/simulated/floor/wood,
/area/konyang_pirate_moonshine)
"t" = (
/obj/structure/closet/crate/secure/weapon/alt,
/obj/random/civgun,
/obj/random/civgun,
/obj/random/civgun/rifle,
/obj/machinery/light,
/turf/simulated/floor/wood,
/area/konyang_pirate_moonshine)
"w" = (
/obj/structure/table/standard,
/obj/structure/reagent_dispensers/keg/beerkeg/rice,
/turf/simulated/floor/wood,
/area/konyang_pirate_moonshine)
"x" = (
/obj/structure/flora/bush/konyang_reeds,
/turf/simulated/floor/exoplanet/konyang,
/area/konyang_pirate_moonshine)
"A" = (
/obj/structure/table/standard,
/obj/item/reagent_containers/glass/beaker/large,
/obj/item/reagent_containers/glass/beaker/large,
/obj/item/reagent_containers/glass/beaker/vial/random,
/turf/simulated/floor/wood,
/area/konyang_pirate_moonshine)
"B" = (
/turf/simulated/floor/wood,
/area/konyang_pirate_moonshine)
"C" = (
/obj/structure/flora/bush/konyang_reeds/water,
/turf/simulated/floor/exoplanet/water/shallow/konyang,
/area/konyang_pirate_moonshine)
"D" = (
/obj/structure/simple_door/wood,
/turf/simulated/floor/wood,
/area/konyang_pirate_moonshine)
"F" = (
/obj/item/reagent_containers/glass/bucket,
/obj/item/reagent_containers/glass/bucket,
/obj/item/storage/box/syringes,
/obj/structure/table/standard,
/obj/item/storage/box/gloves,
/turf/simulated/floor/wood,
/area/konyang_pirate_moonshine)
"G" = (
/obj/structure/table/standard,
/obj/item/flame/lighter/random,
/obj/item/flame/lighter/random,
/obj/item/reagent_containers/glass/beaker/vial/random,
/obj/machinery/light{
	dir = 4
	},
/turf/simulated/floor/wood,
/area/konyang_pirate_moonshine)
"H" = (
/obj/machinery/light{
	dir = 1
	},
/turf/simulated/floor/wood,
/area/konyang_pirate_moonshine)
"K" = (
/obj/structure/table/standard,
/obj/random/booze,
/obj/random/booze,
/turf/simulated/floor/wood,
/area/konyang_pirate_moonshine)
"M" = (
/obj/structure/reagent_dispensers/fueltank,
/turf/simulated/floor/wood,
/area/konyang_pirate_moonshine)
"P" = (
/turf/simulated/wall/wood,
/area/konyang_pirate_moonshine)
"Q" = (
/obj/structure/table/standard,
/obj/item/reagent_containers/glass/beaker/large,
/obj/item/reagent_containers/glass/beaker/large,
/turf/simulated/floor/wood,
/area/konyang_pirate_moonshine)
"S" = (
/obj/structure/closet/crate,
/obj/item/stack/material/steel/full,
/obj/item/reagent_containers/chem_disp_cartridge/phosphorus,
/obj/item/reagent_containers/chem_disp_cartridge/sulfur,
/obj/item/stack/material/iron/full,
/turf/simulated/floor/wood,
/area/konyang_pirate_moonshine)
"U" = (
/obj/structure/flora/bush/konyang_reeds,
/obj/structure/flora/tree/konyang/spring,
/turf/simulated/floor/exoplanet/konyang,
/area/konyang_pirate_moonshine)
"W" = (
/obj/structure/closet/crate/secure/weapon/alt,
/obj/random/contraband,
/obj/random/contraband,
/obj/random/contraband,
/obj/machinery/light,
/turf/simulated/floor/wood,
/area/konyang_pirate_moonshine)
"X" = (
/obj/structure/flora/tree/konyang/spring,
/obj/structure/flora/bush/konyang_reeds,
/turf/simulated/floor/exoplanet/konyang,
/area/konyang_pirate_moonshine)
"Y" = (
/obj/structure/bed,
/obj/structure/curtain/open/bed,
/obj/effect/ghostspawpoint{
	name = "igs - konyang_moonshine";
	identifier = "konyang_moonshine"
	},
/turf/simulated/floor/wood,
/area/konyang_pirate_moonshine)
"Z" = (
/obj/structure/flora/tree/konyang/spring,
/turf/simulated/floor/exoplanet/konyang,
/area/konyang_pirate_moonshine)

(1,1,1) = {"
a
a
a
a
a
a
a
a
a
a
a
a
a
a
a
a
a
a
a
a
a
a
a
a
a
a
a
a
a
a
a
a
a
a
a
"}
(2,1,1) = {"
a
a
a
a
a
a
a
a
a
a
a
a
x
U
a
a
a
P
P
P
P
P
P
P
P
P
P
a
a
Z
a
a
a
a
a
"}
(3,1,1) = {"
a
a
a
a
a
a
P
P
P
P
P
a
a
x
a
a
a
P
e
i
M
l
l
w
q
Q
P
a
a
a
a
a
a
a
a
"}
(4,1,1) = {"
a
a
x
a
Z
a
P
Y
B
Y
P
a
a
x
x
a
a
P
B
B
B
B
B
B
B
B
P
a
Z
a
a
a
a
a
a
"}
(5,1,1) = {"
a
a
x
x
a
a
P
B
B
B
P
a
x
a
x
a
a
P
B
B
B
B
B
B
B
B
P
a
a
a
a
a
a
a
a
"}
(6,1,1) = {"
a
x
x
x
x
a
P
H
B
B
D
a
x
a
x
a
a
D
B
B
B
B
B
B
B
t
P
a
a
a
a
a
Z
a
a
"}
(7,1,1) = {"
a
x
x
x
x
a
P
B
B
B
P
a
x
a
x
a
a
D
B
B
B
B
B
B
B
W
P
a
Z
a
a
a
a
a
a
"}
(8,1,1) = {"
a
a
x
x
a
a
P
f
n
K
P
a
x
a
x
a
a
P
B
B
B
B
B
B
B
B
P
a
a
a
a
a
a
a
a
"}
(9,1,1) = {"
a
a
a
x
x
a
P
P
P
P
P
a
x
a
x
a
a
P
B
B
B
B
B
B
B
B
P
a
a
a
a
Z
a
a
a
"}
(10,1,1) = {"
a
a
a
a
x
a
a
a
a
a
a
a
x
x
a
a
a
P
j
r
F
S
k
A
G
p
P
a
a
Z
a
a
a
a
a
"}
(11,1,1) = {"
a
a
Z
a
a
a
a
a
a
a
a
a
a
x
a
a
a
P
P
P
P
P
P
P
P
P
P
a
a
a
a
a
a
a
a
"}
(12,1,1) = {"
a
a
a
a
a
a
a
a
a
a
a
a
a
a
a
a
a
a
a
a
a
a
a
a
a
a
a
a
a
a
a
x
a
a
a
"}
(13,1,1) = {"
a
a
a
a
a
a
h
h
h
h
h
h
h
h
h
a
h
h
h
h
h
h
h
h
a
a
a
a
a
a
a
x
x
a
a
"}
(14,1,1) = {"
a
a
a
h
h
h
h
b
h
h
h
h
h
h
h
h
h
h
h
h
b
h
h
h
h
a
a
a
a
a
a
x
x
x
a
"}
(15,1,1) = {"
a
a
a
h
h
h
h
h
h
h
h
h
h
h
h
C
C
C
C
h
h
h
h
h
h
h
h
a
a
a
a
x
x
x
x
"}
(16,1,1) = {"
a
h
h
h
b
C
C
C
h
h
b
h
h
h
C
C
C
C
C
h
h
h
h
h
h
h
h
h
h
a
a
a
a
x
x
"}
(17,1,1) = {"
a
a
h
h
h
C
C
C
C
h
h
h
b
h
h
C
C
C
C
C
h
h
h
h
h
h
h
h
h
h
h
a
a
x
x
"}
(18,1,1) = {"
a
a
a
h
h
h
C
C
C
h
h
h
h
h
h
h
b
h
C
C
h
h
b
h
h
h
h
b
h
h
h
h
a
a
a
"}
(19,1,1) = {"
a
a
a
h
h
b
h
C
C
h
h
h
h
h
h
h
h
h
h
h
h
h
h
h
h
h
h
h
h
h
b
h
h
a
a
"}
(20,1,1) = {"
a
a
a
h
h
h
h
C
C
h
b
h
h
h
h
h
h
h
h
h
h
h
h
h
h
h
h
h
h
h
h
h
a
a
a
"}
(21,1,1) = {"
a
a
a
a
h
h
h
h
C
h
h
h
h
h
h
b
h
h
h
h
h
h
h
h
h
h
a
a
a
a
a
a
a
a
a
"}
(22,1,1) = {"
a
a
a
a
h
h
h
h
h
h
h
h
h
h
h
h
h
h
h
h
h
h
h
h
h
h
h
h
a
a
a
a
a
a
a
"}
(23,1,1) = {"
a
Z
a
a
a
a
a
h
h
h
h
h
h
h
h
h
h
h
h
h
a
a
a
a
a
a
a
a
a
a
a
a
a
a
a
"}
(24,1,1) = {"
a
a
a
a
a
a
a
a
a
a
a
a
a
a
a
h
h
h
a
a
a
a
a
a
a
a
a
a
a
a
a
a
a
a
a
"}
(25,1,1) = {"
a
a
a
a
a
a
a
a
a
a
a
a
a
a
a
a
a
a
a
a
a
Z
a
a
a
a
Z
a
a
a
a
a
Z
a
a
"}
(26,1,1) = {"
a
a
a
a
a
Z
a
a
a
a
a
a
a
a
Z
a
a
a
a
a
a
a
a
a
a
x
x
a
a
Z
a
a
a
a
a
"}
(27,1,1) = {"
a
Z
a
a
a
a
a
a
a
a
a
Z
a
x
a
a
a
a
a
a
a
a
a
a
a
x
x
a
a
a
a
a
Z
a
a
"}
(28,1,1) = {"
a
a
a
a
a
a
a
Z
a
a
a
a
x
x
x
x
a
a
a
a
a
a
a
a
a
X
x
x
x
x
a
a
a
a
a
"}
(29,1,1) = {"
a
a
a
Z
a
a
a
a
a
x
x
x
x
x
x
a
a
Z
a
a
a
Z
a
a
a
a
x
x
x
x
a
Z
a
a
a
"}
(30,1,1) = {"
a
a
a
a
a
a
a
a
a
a
a
a
x
x
x
a
a
a
a
a
a
a
a
a
a
a
a
a
x
x
a
a
a
a
a
"}
(31,1,1) = {"
a
a
a
a
Z
a
a
a
Z
x
x
a
a
Z
a
a
a
a
a
a
a
a
a
a
a
a
a
Z
x
x
a
a
a
a
a
"}
(32,1,1) = {"
a
a
a
a
a
a
a
a
a
a
x
x
a
a
a
a
a
Z
a
a
Z
a
a
Z
a
a
a
a
a
a
a
a
a
a
a
"}
(33,1,1) = {"
a
a
a
Z
a
a
a
a
a
a
a
x
x
a
a
a
a
a
a
a
a
a
a
a
a
a
a
a
a
Z
a
a
a
Z
a
"}
(34,1,1) = {"
a
a
a
a
a
a
Z
a
a
Z
a
a
x
a
a
Z
a
a
a
a
a
a
a
Z
a
a
a
a
a
a
a
a
a
a
a
"}
(35,1,1) = {"
a
a
a
a
a
a
a
a
a
a
a
a
a
a
a
a
a
a
a
a
a
a
a
a
a
a
a
a
a
a
a
a
a
a
a
"}
