//MAP CONVERTED BY dmm2tgm.py THIS HEADER COMMENT PREVENTS RECONVERSION, DO NOT REMOVE
"a" = (
/obj/effect/floor_decal/konyang_flowers,
/turf/simulated/floor/exoplanet/konyang,
/area/exoplanet/grass/konyang)
"b" = (
/obj/item/device/flashlight/maglight,
/turf/simulated/floor/exoplanet/dirt_konyang,
/area/exoplanet/grass/konyang)
"c" = (
/obj/item/gun/projectile/revolver/konyang/police,
/turf/simulated/floor/exoplanet/dirt_konyang,
/area/exoplanet/grass/konyang)
"h" = (
/obj/structure/flora/bush/konyang_reeds,
/turf/simulated/floor/exoplanet/konyang,
/area/exoplanet/grass/konyang)
"l" = (
/turf/simulated/floor/exoplanet/dirt_konyang,
/area/exoplanet/grass/konyang)
"m" = (
/obj/structure/flora/rock/konyang/moss,
/turf/simulated/floor/exoplanet/dirt_konyang,
/area/exoplanet/grass/konyang)
"n" = (
/turf/simulated/floor/exoplanet/konyang/wilting,
/area/exoplanet/grass/konyang)
"q" = (
/obj/item/gun/projectile/revolver/konyang/police,
/turf/simulated/floor/exoplanet/konyang,
/area/exoplanet/grass/konyang)
"s" = (
/obj/structure/flora/rock/konyang/moss,
/turf/simulated/floor/exoplanet/konyang,
/area/exoplanet/grass/konyang)
"u" = (
/obj/item/device/flashlight/maglight,
/turf/simulated/floor/exoplanet/konyang,
/area/exoplanet/grass/konyang)
"w" = (
/obj/structure/automobile/police{
	name = "broken police cruiser";
	desc = "A police vehicle with all the bells and whistles you'd expect from a decently-funded agency. This one seems to be broken beyond repair."
	},
/turf/simulated/floor/exoplanet/dirt_konyang,
/area/exoplanet/grass/konyang)
"A" = (
/obj/structure/flora/bush/konyang_reeds,
/turf/simulated/floor/exoplanet/konyang/wilting,
/area/exoplanet/grass/konyang)
"B" = (
/obj/structure/flora/rock/konyang/moss,
/turf/simulated/floor/exoplanet/konyang/wilting,
/area/exoplanet/grass/konyang)
"D" = (
/obj/item/ammo_magazine/c45/revolver,
/turf/simulated/floor/exoplanet/dirt_konyang,
/area/exoplanet/grass/konyang)
"J" = (
/turf/simulated/floor/exoplanet/konyang,
/area/exoplanet/grass/konyang)
"N" = (
/obj/effect/decal/cleanable/blood/drip,
/turf/simulated/floor/exoplanet/konyang,
/area/exoplanet/grass/konyang)
"P" = (
/obj/structure/flora/tree/konyang/spring,
/turf/simulated/floor/exoplanet/konyang,
/area/exoplanet/grass/konyang)
"R" = (
/obj/effect/ghostspawpoint{
	name = "igs - lost_cop";
	identifier = "konyang_lost_cop"
	},
/turf/simulated/floor/exoplanet/dirt_konyang,
/area/exoplanet/grass/konyang)
"U" = (
/obj/effect/floor_decal/konyang_flowers,
/turf/simulated/floor/exoplanet/konyang/wilting,
/area/exoplanet/grass/konyang)
"V" = (
/obj/structure/flora/tree/konyang/spring,
/turf/simulated/floor/exoplanet/konyang/wilting,
/area/exoplanet/grass/konyang)

(1,1,1) = {"
J
J
a
J
J
J
J
J
J
J
J
J
J
J
J
J
J
J
J
J
"}
(2,1,1) = {"
J
J
J
J
J
a
J
J
J
J
J
J
J
J
J
J
J
J
J
J
"}
(3,1,1) = {"
J
n
n
n
J
J
J
J
J
s
J
J
J
J
h
J
J
J
J
J
"}
(4,1,1) = {"
J
n
B
n
h
J
B
n
J
J
J
J
J
P
h
J
a
a
a
J
"}
(5,1,1) = {"
J
n
n
B
h
J
A
n
h
J
h
h
h
J
h
J
J
J
J
J
"}
(6,1,1) = {"
J
J
J
J
h
J
h
h
h
J
a
a
J
J
h
J
h
J
h
J
"}
(7,1,1) = {"
J
a
J
J
J
a
J
J
J
J
J
J
J
J
J
a
a
J
h
h
"}
(8,1,1) = {"
J
a
J
P
J
J
J
J
l
J
J
u
J
J
J
J
J
J
J
J
"}
(9,1,1) = {"
J
J
J
J
J
J
J
R
l
l
w
l
J
J
J
J
J
J
J
J
"}
(10,1,1) = {"
J
a
J
J
a
J
J
J
D
l
l
l
D
J
J
J
J
P
J
J
"}
(11,1,1) = {"
J
J
J
J
J
J
J
J
J
l
l
R
J
J
s
J
J
J
J
J
"}
(12,1,1) = {"
J
a
J
a
J
s
J
q
b
l
m
l
J
J
J
J
A
h
h
h
"}
(13,1,1) = {"
J
J
J
h
J
J
J
J
J
J
c
J
J
J
J
J
n
h
h
h
"}
(14,1,1) = {"
J
J
J
h
h
J
J
a
J
J
J
J
s
J
J
J
A
n
J
J
"}
(15,1,1) = {"
J
J
J
J
J
J
J
J
J
J
J
J
J
h
J
J
n
n
J
J
"}
(16,1,1) = {"
J
J
J
J
J
J
J
a
a
J
J
P
J
h
J
J
V
n
J
J
"}
(17,1,1) = {"
J
J
J
J
J
J
N
J
a
J
J
J
J
h
J
n
n
n
J
J
"}
(18,1,1) = {"
J
J
J
J
J
J
J
a
a
n
n
n
n
J
J
U
a
J
J
J
"}
(19,1,1) = {"
J
J
J
J
h
h
h
J
N
J
J
J
J
J
J
J
a
J
J
J
"}
(20,1,1) = {"
J
J
J
J
J
J
h
J
J
N
J
J
J
J
J
J
J
J
J
J
"}
