//MAP CONVERTED BY dmm2tgm.py THIS HEADER COMMENT PREVENTS RECONVERSION, DO NOT REMOVE
"a" = (
/obj/structure/flora/ausbushes/sparsegrass,
/turf/simulated/floor/exoplanet/konyang,
/area/exoplanet/grass/konyang)
"c" = (
/turf/simulated/floor/exoplanet/water/shallow/konyang,
/area/exoplanet/grass/konyang)
"d" = (
/obj/structure/flora/rock/konyang/small,
/turf/simulated/floor/exoplanet/konyang/wilting,
/area/exoplanet/grass/konyang)
"i" = (
/obj/structure/flora/rock/konyang/moss{
	density = 0
	},
/obj/effect/floor_decal/konyang_flowers,
/obj/structure/bed/stool/wood,
/obj/item/device/synthesized_instrument/guitar/multi/fluff/akinyi_symphette{
	pixel_x = 16;
	pixel_y = 6
	},
/turf/simulated/floor/exoplanet/konyang/pink,
/area/exoplanet/grass/konyang)
"j" = (
/obj/structure/flora/rock/konyang/small,
/obj/effect/floor_decal/konyang_flowers,
/turf/simulated/floor/exoplanet/konyang/pink,
/area/exoplanet/grass/konyang)
"o" = (
/obj/structure/flora/bush/konyang_reeds,
/turf/simulated/floor/exoplanet/konyang/wilting,
/area/exoplanet/grass/konyang)
"p" = (
/obj/structure/flora/ausbushes/sparsegrass,
/turf/simulated/floor/exoplanet/dirt_konyang,
/area/exoplanet/grass/konyang)
"q" = (
/obj/structure/flora/rock/konyang{
	density = 0
	},
/obj/effect/floor_decal/konyang_flowers,
/turf/simulated/floor/exoplanet/konyang/pink,
/area/exoplanet/grass/konyang)
"r" = (
/obj/effect/floor_decal/konyang_flowers,
/turf/simulated/floor/exoplanet/konyang,
/area/exoplanet/grass/konyang)
"s" = (
/obj/effect/floor_decal/konyang_flowers,
/obj/effect/floor_decal/konyang_flowers,
/turf/simulated/floor/exoplanet/konyang/pink,
/area/exoplanet/grass/konyang)
"t" = (
/obj/structure/flora/tree/konyang,
/turf/simulated/floor/exoplanet/konyang/wilting,
/area/exoplanet/grass/konyang)
"u" = (
/obj/structure/flora/rock/konyang/water,
/obj/structure/flora/bush/konyang_reeds/water,
/turf/simulated/floor/exoplanet/water/shallow/konyang,
/area/exoplanet/grass/konyang)
"v" = (
/obj/structure/flora/rock/konyang/small,
/obj/structure/flora/bush/konyang_reeds,
/turf/simulated/floor/exoplanet/konyang/wilting,
/area/exoplanet/grass/konyang)
"w" = (
/obj/random/dirt_75,
/obj/structure/flora/rock/konyang/small,
/turf/simulated/floor/exoplanet/dirt_konyang,
/area/exoplanet/grass/konyang)
"x" = (
/turf/simulated/floor/exoplanet/konyang,
/area/exoplanet/grass/konyang)
"y" = (
/obj/structure/flora/rock/konyang/water,
/turf/simulated/floor/exoplanet/water/shallow/konyang,
/area/exoplanet/grass/konyang)
"z" = (
/obj/structure/flora/tree/konyang/blossom,
/obj/effect/decal/cleanable/generic/beet_tree_petals,
/turf/simulated/floor/exoplanet/konyang/pink,
/area/exoplanet/grass/konyang)
"B" = (
/obj/structure/flora/bush/konyang_reeds,
/turf/simulated/floor/exoplanet/konyang,
/area/exoplanet/grass/konyang)
"C" = (
/obj/effect/floor_decal/konyang_flowers,
/turf/simulated/floor/exoplanet/konyang/wilting,
/area/exoplanet/grass/konyang)
"G" = (
/obj/structure/flora/tree/konyang,
/obj/structure/flora/ausbushes/sparsegrass,
/turf/simulated/floor/exoplanet/konyang,
/area/exoplanet/grass/konyang)
"H" = (
/turf/simulated/floor/exoplanet/konyang/wilting,
/area/exoplanet/grass/konyang)
"J" = (
/obj/effect/floor_decal/konyang_flowers,
/obj/item/material/sword/katana{
	pixel_x = 4;
	pixel_y = 14
	},
/obj/item/clothing/head/hachimaki{
	pixel_x = 10;
	pixel_y = 2;
	layer = 2.0
	},
/turf/simulated/floor/exoplanet/konyang/pink,
/area/exoplanet/grass/konyang)
"K" = (
/obj/random/dirt_75,
/turf/simulated/floor/exoplanet/dirt_konyang,
/area/exoplanet/grass/konyang)
"L" = (
/turf/simulated/floor/exoplanet/dirt_konyang,
/area/exoplanet/grass/konyang)
"N" = (
/obj/item/holder/fish,
/turf/simulated/floor/exoplanet/water/shallow/konyang,
/area/exoplanet/grass/konyang)
"O" = (
/obj/structure/flora/bush/konyang_reeds/water,
/turf/simulated/floor/exoplanet/water/shallow/konyang,
/area/exoplanet/grass/konyang)
"P" = (
/obj/item/holder/fish/cod,
/turf/simulated/floor/exoplanet/water/shallow/konyang,
/area/exoplanet/grass/konyang)
"Q" = (
/obj/item/holder/fish,
/obj/structure/flora/bush/konyang_reeds/water,
/turf/simulated/floor/exoplanet/water/shallow/konyang,
/area/exoplanet/grass/konyang)
"R" = (
/turf/template_noop,
/area/space)
"T" = (
/obj/structure/flora/ausbushes/sparsegrass,
/obj/structure/flora/ausbushes/reedbush,
/turf/simulated/floor/exoplanet/konyang,
/area/exoplanet/grass/konyang)
"U" = (
/obj/effect/floor_decal/konyang_flowers,
/turf/simulated/floor/exoplanet/konyang/pink,
/area/exoplanet/grass/konyang)
"V" = (
/obj/effect/decal/cleanable/generic/beet_tree_petals,
/obj/structure/flora/tree/konyang/fall{
	pixel_x = -36;
	pixel_y = -18
	},
/turf/simulated/floor/exoplanet/konyang/pink,
/area/exoplanet/grass/konyang)
"W" = (
/obj/structure/flora/tree/konyang,
/turf/simulated/floor/exoplanet/konyang,
/area/exoplanet/grass/konyang)
"Y" = (
/obj/structure/flora/bush/konyang_reeds/water,
/obj/structure/flora/bush/konyang_reeds/water,
/turf/simulated/floor/exoplanet/water/shallow/konyang,
/area/exoplanet/grass/konyang)

(1,1,1) = {"
R
R
R
R
R
B
x
B
B
B
x
r
o
H
B
x
a
B
B
r
a
B
a
a
B
r
R
R
R
R
"}
(2,1,1) = {"
R
R
R
r
B
a
a
r
a
x
B
d
U
U
B
x
W
r
a
B
H
H
o
o
B
a
x
R
R
R
"}
(3,1,1) = {"
R
R
R
x
a
B
B
x
x
W
a
U
U
U
B
r
B
B
B
r
B
x
t
H
H
x
a
a
R
R
"}
(4,1,1) = {"
R
R
x
W
B
B
r
a
B
a
B
U
U
H
a
B
B
B
B
B
T
B
r
a
r
x
W
B
r
a
"}
(5,1,1) = {"
R
a
B
a
a
L
K
B
B
r
x
o
o
B
B
B
O
O
O
O
O
O
B
B
B
B
a
x
B
a
"}
(6,1,1) = {"
R
B
B
r
p
K
K
r
x
a
a
B
T
B
O
O
O
O
c
O
O
O
O
O
B
a
r
a
B
B
"}
(7,1,1) = {"
a
r
a
B
L
K
p
B
a
B
B
B
O
O
O
O
c
c
c
O
O
O
O
B
r
x
B
B
a
B
"}
(8,1,1) = {"
x
B
x
K
w
L
B
a
B
O
O
O
O
O
c
c
u
c
c
c
c
O
B
B
a
U
U
o
a
r
"}
(9,1,1) = {"
r
a
B
p
K
B
x
r
B
O
O
O
c
c
c
c
c
c
c
c
y
O
O
T
a
U
U
U
d
a
"}
(10,1,1) = {"
a
B
a
x
L
r
a
B
O
O
O
c
c
O
c
O
c
c
Q
c
c
O
O
B
B
o
U
U
o
B
"}
(11,1,1) = {"
B
B
r
x
W
a
B
B
Y
O
c
y
c
c
c
P
c
c
c
c
c
c
O
O
B
r
H
U
H
W
"}
(12,1,1) = {"
a
x
a
a
r
a
B
T
Y
O
O
c
c
u
O
c
c
c
c
y
c
c
O
O
B
B
a
H
a
r
"}
(13,1,1) = {"
a
r
d
U
U
B
B
O
O
O
c
c
O
o
o
O
c
c
c
O
c
c
c
O
O
B
B
a
B
a
"}
(14,1,1) = {"
x
t
U
U
U
B
B
Y
O
O
c
O
o
q
J
v
O
c
c
c
c
c
y
O
O
T
a
r
B
B
"}
(15,1,1) = {"
B
U
U
z
U
B
O
O
c
c
O
o
s
V
i
o
u
c
c
c
c
c
c
c
O
O
B
x
a
B
"}
(16,1,1) = {"
B
U
U
U
o
O
O
c
y
c
O
o
j
U
v
O
c
c
c
c
O
c
c
y
O
O
B
B
a
B
"}
(17,1,1) = {"
r
U
U
o
O
O
c
c
c
c
c
O
o
o
O
c
c
c
O
c
c
c
c
O
O
O
B
a
r
B
"}
(18,1,1) = {"
a
B
B
O
O
O
c
c
O
c
c
c
u
O
c
c
c
c
y
N
c
y
O
O
O
B
o
H
W
B
"}
(19,1,1) = {"
x
G
T
O
O
c
c
c
c
N
c
c
c
c
c
y
O
c
c
c
O
O
O
O
B
d
U
U
B
B
"}
(20,1,1) = {"
a
r
B
O
O
c
y
O
c
c
c
O
c
c
P
c
c
c
c
c
O
O
O
T
o
U
U
U
o
r
"}
(21,1,1) = {"
r
B
O
O
O
c
c
c
c
O
c
c
c
O
c
c
c
c
c
O
O
O
O
r
U
U
U
z
U
a
"}
(22,1,1) = {"
a
B
O
O
O
c
c
y
c
c
c
c
y
c
c
c
c
O
O
O
O
O
B
B
H
U
U
U
U
B
"}
(23,1,1) = {"
B
O
O
c
c
u
N
c
c
c
c
c
c
c
c
O
O
O
O
O
O
B
B
a
r
H
t
U
U
B
"}
(24,1,1) = {"
B
O
O
O
c
c
c
c
c
O
O
O
O
O
O
O
O
B
B
B
B
B
r
x
B
a
B
o
U
B
"}
(25,1,1) = {"
r
O
O
O
y
c
c
O
O
O
O
O
O
O
a
B
T
B
a
r
a
B
a
H
a
r
B
B
B
x
"}
(26,1,1) = {"
B
O
O
O
O
O
O
O
r
T
B
B
o
H
B
r
B
x
x
W
a
r
B
H
o
a
x
r
B
r
"}
(27,1,1) = {"
a
T
O
O
O
O
B
B
w
K
p
d
U
U
H
a
a
r
a
a
B
B
r
d
H
a
x
W
a
R
"}
(28,1,1) = {"
r
K
a
O
O
r
K
p
K
K
o
U
U
U
o
x
r
B
U
U
U
a
B
B
o
r
x
a
a
R
"}
(29,1,1) = {"
R
p
w
B
a
K
K
L
W
B
U
U
U
C
x
G
B
a
d
U
U
U
a
r
a
a
B
x
R
R
"}
(30,1,1) = {"
R
R
R
p
L
a
B
B
r
a
o
U
U
a
B
B
a
r
x
o
U
U
a
B
B
B
B
R
R
R
"}
