//MAP CONVERTED BY dmm2tgm.py THIS HEADER COMMENT PREVENTS RECONVERSION, DO NOT REMOVE
"a" = (
/turf/simulated/floor/exoplanet/konyang/wilting,
/area/exoplanet/grass/konyang)
"b" = (
/obj/structure/flora/bush/konyang_reeds/water,
/obj/structure/flora/rock/konyang/water,
/turf/simulated/floor/exoplanet/water/shallow/konyang,
/area/exoplanet/grass/konyang)
"c" = (
/turf/simulated/floor/exoplanet/konyang,
/area/exoplanet/grass/konyang)
"d" = (
/obj/random/dirt_75,
/turf/simulated/floor/exoplanet/dirt_konyang,
/area/exoplanet/grass/konyang)
"e" = (
/obj/structure/flora/tree/konyang,
/turf/simulated/floor/exoplanet/konyang,
/area/exoplanet/grass/konyang)
"f" = (
/obj/random/dirt_75,
/obj/random/junk,
/turf/simulated/floor/exoplanet/dirt_konyang,
/area/exoplanet/grass/konyang)
"g" = (
/obj/structure/flora/tree/konyang/fall,
/obj/effect/decal/cleanable/generic/beet_tree_petals,
/turf/simulated/floor/exoplanet/konyang/pink,
/area/exoplanet/grass/konyang)
"h" = (
/obj/structure/flora/rock/konyang/moss,
/obj/structure/flora/bush/konyang_reeds,
/turf/simulated/floor/exoplanet/konyang,
/area/exoplanet/grass/konyang)
"j" = (
/obj/structure/flora/rock/konyang/small,
/turf/simulated/floor/exoplanet/dirt_konyang,
/area/exoplanet/grass/konyang)
"l" = (
/obj/random/dirt_75,
/obj/structure/table/wood/bamboo,
/obj/item/material/knife/butterfly{
	pixel_x = -1
	},
/obj/item/clothing/mask/smokable/cigarette/cigar{
	pixel_x = -8;
	pixel_y = 5
	},
/obj/item/reagent_containers/food/drinks/bottle/sake{
	pixel_x = 4;
	pixel_y = 14
	},
/obj/item/reagent_containers/food/drinks/drinkingglass/newglass/shot{
	pixel_x = 7
	},
/turf/simulated/floor/exoplanet/dirt_konyang,
/area/exoplanet/grass/konyang)
"m" = (
/obj/structure/flora/bush/konyang_reeds/water,
/turf/simulated/floor/exoplanet/water/shallow/konyang,
/area/exoplanet/grass/konyang)
"n" = (
/obj/structure/flora/ausbushes/sparsegrass,
/turf/simulated/floor/exoplanet/konyang,
/area/exoplanet/grass/konyang)
"o" = (
/obj/structure/flora/rock/konyang/small,
/obj/structure/flora/bush/konyang_reeds,
/turf/simulated/floor/exoplanet/konyang,
/area/exoplanet/grass/konyang)
"p" = (
/turf/template_noop,
/area/space)
"q" = (
/obj/structure/flora/rock/konyang/water,
/turf/simulated/floor/exoplanet/water/shallow/konyang,
/area/exoplanet/grass/konyang)
"r" = (
/obj/structure/flora/rock/konyang,
/turf/simulated/floor/exoplanet/konyang,
/area/exoplanet/grass/konyang)
"s" = (
/obj/effect/floor_decal/konyang_flowers,
/turf/simulated/floor/exoplanet/konyang/pink,
/area/exoplanet/grass/konyang)
"t" = (
/obj/random/junk,
/turf/simulated/floor/exoplanet/dirt_konyang,
/area/exoplanet/grass/konyang)
"u" = (
/obj/structure/flora/rock/konyang/moss,
/turf/simulated/floor/exoplanet/konyang/wilting,
/area/exoplanet/grass/konyang)
"v" = (
/obj/structure/flora/rock/konyang/small,
/obj/random/dirt_75,
/turf/simulated/floor/exoplanet/dirt_konyang,
/area/exoplanet/grass/konyang)
"w" = (
/obj/structure/flora/bush/konyang_reeds/water,
/obj/structure/flora/bush/konyang_reeds/water,
/turf/simulated/floor/exoplanet/water/shallow/konyang,
/area/exoplanet/grass/konyang)
"x" = (
/obj/structure/flora/tree/konyang/blossom,
/obj/effect/decal/cleanable/generic/beet_tree_petals,
/turf/simulated/floor/exoplanet/konyang/pink,
/area/exoplanet/grass/konyang)
"z" = (
/obj/structure/flora/tree/konyang,
/obj/structure/flora/bush/konyang_reeds,
/turf/simulated/floor/exoplanet/konyang,
/area/exoplanet/grass/konyang)
"A" = (
/obj/structure/flora/rock/konyang/small,
/turf/simulated/floor/exoplanet/konyang,
/area/exoplanet/grass/konyang)
"B" = (
/obj/structure/flora/ausbushes/sparsegrass,
/turf/simulated/floor/exoplanet/dirt_konyang,
/area/exoplanet/grass/konyang)
"C" = (
/obj/structure/flora/tree/konyang,
/turf/simulated/floor/exoplanet/konyang/wilting,
/area/exoplanet/grass/konyang)
"D" = (
/obj/random/dirt_75,
/obj/structure/flora/rock/konyang/small,
/obj/item/flame/lighter/zippo{
	pixel_y = -5;
	pixel_x = -15
	},
/turf/simulated/floor/exoplanet/dirt_konyang,
/area/exoplanet/grass/konyang)
"E" = (
/obj/random/dirt_75,
/obj/item/trash/can{
	pixel_y = 6;
	pixel_x = -10
	},
/obj/item/trash/can{
	pixel_x = -4
	},
/turf/simulated/floor/exoplanet/dirt_konyang,
/area/exoplanet/grass/konyang)
"F" = (
/obj/effect/floor_decal/konyang_flowers,
/obj/structure/flora/ausbushes/sparsegrass,
/turf/simulated/floor/exoplanet/konyang,
/area/exoplanet/grass/konyang)
"H" = (
/turf/simulated/floor/exoplanet/water/shallow/konyang,
/area/exoplanet/grass/konyang)
"I" = (
/obj/structure/flora/rock/konyang/water,
/obj/structure/flora/bush/konyang_reeds/water,
/turf/simulated/floor/exoplanet/water/shallow/konyang,
/area/exoplanet/grass/konyang)
"L" = (
/obj/random/dirt_75,
/obj/structure/flora/stump{
	pixel_y = 12;
	pixel_x = -8
	},
/turf/simulated/floor/exoplanet/dirt_konyang,
/area/exoplanet/grass/konyang)
"M" = (
/obj/random/dirt_75,
/obj/structure/flora/stump/log,
/turf/simulated/floor/exoplanet/dirt_konyang,
/area/exoplanet/grass/konyang)
"N" = (
/obj/random/dirt_75,
/obj/structure/flora/rock/konyang/small,
/turf/simulated/floor/exoplanet/dirt_konyang,
/area/exoplanet/grass/konyang)
"O" = (
/obj/structure/flora/bush/konyang_reeds,
/turf/simulated/floor/exoplanet/konyang/wilting,
/area/exoplanet/grass/konyang)
"P" = (
/obj/structure/flora/rock/konyang/moss,
/turf/simulated/floor/exoplanet/konyang,
/area/exoplanet/grass/konyang)
"Q" = (
/obj/structure/flora/bush/konyang_reeds/water,
/mob/living/simple_animal/aquatic/fish,
/turf/simulated/floor/exoplanet/water/shallow/konyang,
/area/exoplanet/grass/konyang)
"R" = (
/obj/random/dirt_75,
/obj/effect/decal/cleanable/generic,
/obj/item/stack/material/wood/branch/full,
/turf/simulated/floor/exoplanet/dirt_konyang,
/area/exoplanet/grass/konyang)
"S" = (
/obj/structure/flora/ausbushes/sparsegrass,
/obj/structure/flora/ausbushes/reedbush,
/turf/simulated/floor/exoplanet/konyang,
/area/exoplanet/grass/konyang)
"T" = (
/turf/simulated/floor/exoplanet/dirt_konyang,
/area/exoplanet/grass/konyang)
"U" = (
/obj/random/dirt_75,
/obj/structure/bed/stool/chair/plastic{
	dir = 4
	},
/obj/item/clothing/head/konyang{
	pixel_y = -2;
	pixel_x = 2
	},
/turf/simulated/floor/exoplanet/dirt_konyang,
/area/exoplanet/grass/konyang)
"V" = (
/obj/effect/decal/cleanable/generic/beet_tree_petals,
/obj/structure/flora/tree/konyang/fall,
/turf/simulated/floor/exoplanet/konyang/pink,
/area/exoplanet/grass/konyang)
"W" = (
/obj/structure/flora/bush/konyang_reeds,
/turf/simulated/floor/exoplanet/konyang,
/area/exoplanet/grass/konyang)
"X" = (
/obj/effect/floor_decal/konyang_flowers,
/turf/simulated/floor/exoplanet/konyang,
/area/exoplanet/grass/konyang)
"Y" = (
/obj/structure/flora/rock/konyang/small,
/turf/simulated/floor/exoplanet/konyang/wilting,
/area/exoplanet/grass/konyang)
"Z" = (
/obj/random/dirt_75,
/obj/structure/flora/log_bench,
/turf/simulated/floor/exoplanet/dirt_konyang,
/area/exoplanet/grass/konyang)

(1,1,1) = {"
p
p
p
p
X
n
X
n
n
X
p
p
p
p
p
c
W
n
c
W
X
X
n
W
W
n
p
p
p
p
"}
(2,1,1) = {"
p
p
n
W
W
n
c
X
c
A
W
W
p
p
o
W
W
X
n
W
W
W
n
n
X
n
W
c
p
p
"}
(3,1,1) = {"
p
c
e
W
c
W
e
W
O
Y
a
W
n
X
c
W
P
O
s
s
s
c
A
e
n
W
n
X
n
p
"}
(4,1,1) = {"
p
W
n
n
X
n
W
W
n
a
O
O
c
n
W
W
s
s
s
s
s
n
X
n
W
m
S
n
W
n
"}
(5,1,1) = {"
c
W
X
c
X
W
W
X
W
P
a
a
a
A
X
n
s
s
g
s
s
n
n
W
b
m
m
W
c
W
"}
(6,1,1) = {"
n
c
c
z
W
n
W
c
n
c
n
X
n
W
c
n
Y
s
s
s
O
c
S
m
m
m
m
W
n
X
"}
(7,1,1) = {"
X
r
n
W
n
Y
s
s
a
c
e
W
W
W
c
e
X
W
o
c
n
W
b
m
m
I
W
W
c
W
"}
(8,1,1) = {"
c
n
W
c
O
s
s
s
s
n
X
c
N
d
d
n
W
W
X
n
W
m
m
m
m
W
W
X
n
W
"}
(9,1,1) = {"
W
n
X
c
s
s
x
s
s
c
B
d
M
B
d
v
n
W
c
W
m
m
m
m
W
W
n
c
n
p
"}
(10,1,1) = {"
X
W
W
n
s
s
s
s
O
n
N
L
f
U
E
T
X
S
n
W
S
I
I
S
W
X
c
c
e
p
"}
(11,1,1) = {"
n
X
W
W
O
s
s
a
n
d
d
B
l
R
D
W
W
m
m
A
n
W
W
W
W
n
W
W
n
p
"}
(12,1,1) = {"
p
n
c
e
X
Y
a
W
c
X
t
Z
d
B
W
m
b
m
m
m
W
W
P
X
Y
s
s
O
r
p
"}
(13,1,1) = {"
p
n
F
W
W
n
n
n
n
W
n
d
d
n
W
m
m
m
m
I
X
W
n
n
s
s
s
s
X
p
"}
(14,1,1) = {"
p
p
n
W
c
n
X
W
n
e
X
n
X
S
m
m
H
m
H
m
m
W
c
W
s
s
x
s
W
c
"}
(15,1,1) = {"
p
p
u
c
c
e
n
W
c
W
n
c
W
b
m
m
H
H
m
m
S
W
n
n
s
s
s
s
W
W
"}
(16,1,1) = {"
p
n
O
a
n
c
W
X
n
X
W
n
P
m
m
H
Q
H
m
m
W
W
n
X
a
s
s
O
X
c
"}
(17,1,1) = {"
p
W
a
Y
O
r
d
B
d
A
n
W
m
m
H
H
H
H
m
A
W
c
W
c
n
O
a
c
c
e
"}
(18,1,1) = {"
p
X
W
O
a
n
n
N
d
T
n
W
m
H
m
Q
H
H
b
W
W
X
c
c
e
n
W
n
n
W
"}
(19,1,1) = {"
p
c
n
a
a
W
X
c
d
N
c
S
m
m
H
H
q
m
m
W
n
n
c
n
X
n
n
c
W
W
"}
(20,1,1) = {"
n
n
X
W
a
A
W
n
B
n
X
W
b
m
m
H
m
m
m
S
r
W
X
c
W
W
c
X
W
n
"}
(21,1,1) = {"
W
W
W
W
X
n
n
c
n
W
S
W
W
o
m
m
m
W
W
c
X
a
O
Y
c
d
B
n
c
n
"}
(22,1,1) = {"
n
Y
s
s
n
W
X
W
W
w
m
W
c
W
W
S
W
c
X
n
a
s
s
s
O
j
d
T
W
X
"}
(23,1,1) = {"
X
s
s
s
O
c
S
m
m
I
m
W
n
n
X
n
n
u
n
c
C
s
s
s
s
a
d
d
n
c
"}
(24,1,1) = {"
n
s
s
g
s
W
m
m
m
m
W
W
c
e
n
c
O
a
a
a
c
a
s
V
s
O
T
d
N
W
"}
(25,1,1) = {"
n
O
s
s
s
n
W
b
W
S
W
n
n
a
O
a
X
c
Y
O
a
Y
s
s
s
s
a
n
B
W
"}
(26,1,1) = {"
W
c
C
a
n
X
W
W
W
n
n
X
O
s
s
s
s
W
X
a
a
X
a
O
s
s
C
n
X
c
"}
(27,1,1) = {"
p
n
c
P
n
n
n
n
n
X
n
c
s
s
x
s
s
W
c
W
n
W
W
c
a
O
n
W
W
p
"}
(28,1,1) = {"
p
X
r
n
W
W
c
X
n
W
c
n
s
s
s
s
O
A
n
n
n
c
W
h
n
c
X
c
p
p
"}
(29,1,1) = {"
p
p
n
X
n
X
c
e
n
n
X
W
s
s
Y
W
n
X
p
p
c
n
X
c
n
W
c
r
p
p
"}
(30,1,1) = {"
p
p
p
p
p
n
n
W
c
r
c
n
W
n
W
n
X
p
p
p
p
p
c
W
W
c
p
p
p
p
"}
