//MAP CONVERTED BY dmm2tgm.py THIS HEADER COMMENT PREVENTS RECONVERSION, DO NOT REMOVE
"ab" = (
/turf/simulated/floor/tiled,
/area/space)
"ai" = (
/obj/structure/table/standard,
/obj/machinery/light/colored/decayed{
	dir = 1
	},
/turf/simulated/floor/tiled,
/area/space)
"aC" = (
/obj/structure/bed/padded,
/obj/item/bedsheet/dorms,
/obj/machinery/light/colored/decayed{
	dir = 1
	},
/turf/simulated/floor/wood/mahogany,
/area/space)
"aU" = (
/obj/effect/floor_decal/industrial/outline/grey,
/obj/random/dirt_75,
/obj/structure/closet/crate/loot,
/turf/simulated/floor/plating,
/area/cryo_outpost/inside/warehouse)
"bb" = (
/obj/structure/closet,
/obj/random/dirt_75,
/turf/simulated/floor/tiled,
/area/space)
"bx" = (
/obj/structure/bed/padded,
/obj/item/bedsheet/dorms,
/obj/machinery/light/colored/decayed{
	dir = 1
	},
/turf/simulated/floor/tiled,
/area/space)
"bM" = (
/turf/simulated/floor/plating,
/area/cryo_outpost/inside/warehouse)
"df" = (
/obj/structure/closet/cabinet,
/turf/simulated/floor/wood/bamboo,
/area/space)
"dl" = (
/obj/structure/table/steel,
/turf/simulated/floor/tiled,
/area/space)
"dJ" = (
/obj/random/dirt_75,
/obj/random/dirt_75,
/turf/simulated/floor/wood/mahogany,
/area/space)
"dK" = (
/obj/random/dirt_75,
/obj/random/dirt_75,
/turf/simulated/floor/plating,
/area/cryo_outpost/inside/warehouse)
"dN" = (
/obj/structure/table/steel,
/obj/random/pottedplant_small{
	pixel_x = -5;
	pixel_y = 6
	},
/obj/machinery/light/colored/decayed,
/turf/simulated/floor/lino/diamond,
/area/space)
"ff" = (
/obj/effect/floor_decal/industrial/outline/grey,
/obj/item/stack/material/plastic/full,
/obj/random/dirt_75,
/turf/simulated/floor/plating,
/area/cryo_outpost/inside/warehouse)
"fm" = (
/obj/effect/floor_decal/industrial/outline/grey,
/obj/item/stack/material/steel/full,
/obj/random/dirt_75,
/obj/random/dirt_75,
/turf/simulated/floor/plating,
/area/cryo_outpost/inside/warehouse)
"iD" = (
/obj/structure/bed/padded,
/obj/item/bedsheet/dorms,
/turf/simulated/floor/wood/bamboo,
/area/space)
"jg" = (
/obj/random/pottedplant,
/turf/simulated/floor/wood/bamboo,
/area/space)
"jh" = (
/obj/effect/map_effect/marker/mapmanip/submap/extract/cryo_outpost/crew_quarters_room,
/obj/structure/closet,
/obj/random/dirt_75,
/turf/simulated/floor/wood/bamboo,
/area/space)
"jq" = (
/obj/effect/floor_decal/industrial/outline/grey,
/obj/item/stack/material/gold/full,
/obj/random/dirt_75,
/turf/simulated/floor/plating,
/area/cryo_outpost/inside/warehouse)
"kJ" = (
/obj/structure/closet,
/obj/effect/map_effect/marker/mapmanip/submap/extract/cryo_outpost/crew_quarters_room,
/obj/random/dirt_75,
/turf/simulated/floor/tiled,
/area/space)
"mt" = (
/obj/random/dirt_75,
/turf/simulated/floor/tiled,
/area/space)
"na" = (
/obj/structure/table/rack/cafe_table,
/obj/item/reagent_containers/food/drinks/bottle/vodka/mushroom{
	pixel_y = 10;
	pixel_x = 6
	},
/obj/item/reagent_containers/food/drinks/drinkingglass/newglass/shot{
	pixel_x = -4;
	pixel_y = 8
	},
/obj/item/reagent_containers/food/drinks/drinkingglass/newglass/shot{
	pixel_x = -7;
	pixel_y = 1
	},
/turf/simulated/floor/wood/mahogany,
/area/space)
"nc" = (
/obj/random/dirt_75,
/obj/machinery/light/colored/decayed,
/turf/simulated/floor/tiled,
/area/space)
"ne" = (
/obj/structure/bed/padded,
/obj/item/bedsheet/random,
/turf/simulated/floor/tiled,
/area/space)
"nq" = (
/obj/effect/floor_decal/industrial/outline/grey,
/obj/structure/closet/crate/loot,
/obj/random/dirt_75,
/turf/simulated/floor/plating,
/area/cryo_outpost/inside/warehouse)
"ox" = (
/obj/effect/floor_decal/industrial/outline/grey,
/obj/structure/closet/crate/freezer/rations,
/obj/random/dirt_75,
/turf/simulated/floor/plating,
/area/cryo_outpost/inside/warehouse)
"pa" = (
/obj/random/dirt_75,
/obj/random/dirt_75,
/turf/simulated/floor/tiled,
/area/space)
"ph" = (
/obj/random/dirt_75,
/turf/simulated/floor/plating,
/area/cryo_outpost/inside/warehouse)
"pY" = (
/obj/effect/map_effect/marker/mapmanip/submap/extract/cryo_outpost/crew_quarters_room,
/obj/structure/closet,
/turf/simulated/floor/tiled,
/area/space)
"qi" = (
/obj/effect/map_effect/marker/mapmanip/submap/extract/cryo_outpost/crew_quarters_room,
/obj/random/dirt_75,
/obj/random/dirt_75,
/turf/simulated/floor/tiled,
/area/space)
"qK" = (
/obj/structure/closet/cabinet,
/obj/random/dirt_75,
/turf/simulated/floor/wood/mahogany,
/area/space)
"rW" = (
/obj/effect/floor_decal/industrial/outline/grey,
/obj/structure/closet/crate,
/obj/random/dirt_75,
/turf/simulated/floor/plating,
/area/cryo_outpost/inside/warehouse)
"sn" = (
/obj/effect/floor_decal/industrial/outline/grey,
/obj/item/stack/material/steel/full,
/obj/random/dirt_75,
/turf/simulated/floor/plating,
/area/cryo_outpost/inside/warehouse)
"sM" = (
/obj/effect/floor_decal/industrial/outline/grey,
/obj/item/stack/material/iron/full,
/obj/random/dirt_75,
/turf/simulated/floor/plating,
/area/cryo_outpost/inside/warehouse)
"sP" = (
/obj/random/dirt_75,
/turf/simulated/floor/lino/diamond,
/area/space)
"tn" = (
/obj/structure/table/standard,
/obj/item/trash/coffee{
	pixel_x = 4
	},
/turf/simulated/floor/tiled,
/area/space)
"tH" = (
/obj/structure/closet,
/turf/simulated/floor/tiled,
/area/space)
"ua" = (
/obj/effect/floor_decal/industrial/outline/grey,
/obj/random/dirt_75,
/obj/structure/closet/crate,
/turf/simulated/floor/plating,
/area/cryo_outpost/inside/warehouse)
"up" = (
/obj/random/dirt_75,
/obj/random/dirt_75,
/turf/simulated/floor/wood/bamboo,
/area/space)
"uA" = (
/obj/effect/floor_decal/industrial/outline/grey,
/obj/structure/closet/crate/drop,
/obj/item/clothing/suit/armor/carrier/generic,
/obj/item/clothing/suit/armor/carrier/generic,
/obj/item/clothing/head/helmet/security/generic,
/obj/item/clothing/head/helmet/security/generic,
/obj/random/dirt_75,
/turf/simulated/floor/plating,
/area/cryo_outpost/inside/warehouse)
"uL" = (
/obj/effect/floor_decal/industrial/outline/grey,
/obj/effect/map_effect/marker/mapmanip/submap/extract/cryo_outpost/warehouse,
/obj/random/dirt_75,
/obj/structure/closet/crate/loot,
/turf/simulated/floor/plating,
/area/cryo_outpost/inside/warehouse)
"ve" = (
/obj/structure/closet/cabinet,
/turf/simulated/floor/tiled,
/area/space)
"vn" = (
/obj/structure/table/steel,
/obj/random/mre{
	pixel_y = 5
	},
/turf/simulated/floor/tiled,
/area/space)
"wC" = (
/obj/structure/closet,
/obj/random/dirt_75,
/obj/random/dirt_75,
/obj/random/junk,
/obj/machinery/light/colored/decayed,
/turf/simulated/floor/tiled,
/area/space)
"xe" = (
/obj/effect/floor_decal/industrial/outline/grey,
/obj/structure/closet/crate/loot,
/obj/random/dirt_75,
/obj/random/dirt_75,
/turf/simulated/floor/plating,
/area/cryo_outpost/inside/warehouse)
"xC" = (
/obj/random/dirt_75,
/obj/random/dirt_75,
/obj/random/dirt_75,
/turf/simulated/floor/plating,
/area/cryo_outpost/inside/warehouse)
"xE" = (
/obj/effect/floor_decal/industrial/outline/grey,
/obj/structure/closet/crate,
/turf/simulated/floor/plating,
/area/cryo_outpost/inside/warehouse)
"xO" = (
/obj/structure/bed/padded,
/obj/item/bedsheet/dorms,
/obj/random/dirt_75,
/obj/random/dirt_75,
/turf/simulated/floor/tiled,
/area/space)
"xT" = (
/obj/structure/bed/padded,
/obj/item/bedsheet/dorms,
/obj/random/dirt_75,
/obj/machinery/light/colored/decayed{
	dir = 1
	},
/turf/simulated/floor/tiled,
/area/space)
"xX" = (
/obj/structure/closet/cabinet,
/obj/random/dirt_75,
/turf/simulated/floor/tiled,
/area/space)
"zn" = (
/obj/structure/table/steel,
/obj/item/towel/random{
	pixel_x = -2;
	pixel_y = 6
	},
/turf/simulated/floor/tiled,
/area/space)
"zG" = (
/turf/simulated/floor/lino/diamond,
/area/space)
"Ac" = (
/obj/effect/map_effect/marker/mapmanip/submap/extract/cryo_outpost/crew_quarters_room,
/obj/random/dirt_75,
/obj/random/pottedplant,
/turf/simulated/floor/wood/mahogany,
/area/space)
"Ay" = (
/obj/structure/table/steel,
/obj/random/pottedplant_small{
	pixel_x = -5;
	pixel_y = 6
	},
/obj/machinery/light/colored/decayed{
	dir = 1
	},
/turf/simulated/floor/wood/bamboo,
/area/space)
"AC" = (
/obj/effect/floor_decal/industrial/outline/grey,
/obj/structure/closet/crate,
/obj/random/loot,
/obj/random/loot,
/obj/random/dirt_75,
/turf/simulated/floor/plating,
/area/cryo_outpost/inside/warehouse)
"AK" = (
/obj/structure/bed/stool/chair/wood{
	dir = 4
	},
/obj/random/dirt_75,
/turf/simulated/floor/wood/mahogany,
/area/space)
"AO" = (
/obj/random/dirt_75,
/turf/simulated/floor/wood/mahogany,
/area/space)
"AR" = (
/obj/structure/bed/stool/chair{
	dir = 8
	},
/obj/machinery/light/colored/decayed{
	dir = 1
	},
/turf/simulated/floor/tiled,
/area/space)
"BC" = (
/obj/effect/floor_decal/industrial/outline/grey,
/obj/structure/largecrate,
/obj/random/dirt_75,
/turf/simulated/floor/plating,
/area/cryo_outpost/inside/warehouse)
"CA" = (
/obj/effect/floor_decal/industrial/outline/grey,
/obj/effect/map_effect/marker/mapmanip/submap/extract/cryo_outpost/warehouse,
/obj/structure/closet/crate/loot,
/obj/random/dirt_75,
/turf/simulated/floor/plating,
/area/cryo_outpost/inside/warehouse)
"CZ" = (
/obj/structure/table/steel,
/obj/random/medical{
	pixel_y = 6
	},
/turf/simulated/floor/tiled,
/area/space)
"Ds" = (
/obj/structure/closet/cabinet,
/turf/simulated/floor/lino/diamond,
/area/space)
"Es" = (
/obj/structure/bed/padded,
/obj/item/bedsheet/random,
/obj/random/dirt_75,
/turf/simulated/floor/tiled,
/area/space)
"Ge" = (
/obj/effect/floor_decal/industrial/outline/grey,
/obj/item/stack/material/plastic/full,
/obj/effect/map_effect/marker/mapmanip/submap/extract/cryo_outpost/warehouse,
/obj/random/dirt_75,
/turf/simulated/floor/plating,
/area/cryo_outpost/inside/warehouse)
"Gz" = (
/obj/effect/map_effect/marker/mapmanip/submap/extract/cryo_outpost/crew_quarters_room,
/obj/random/dirt_75,
/obj/random/pottedplant,
/turf/simulated/floor/tiled,
/area/space)
"Im" = (
/obj/effect/floor_decal/industrial/outline/grey,
/obj/structure/closet/crate/loot,
/obj/effect/map_effect/marker/mapmanip/submap/extract/cryo_outpost/warehouse,
/obj/random/dirt_75,
/turf/simulated/floor/plating,
/area/cryo_outpost/inside/warehouse)
"IB" = (
/obj/random/dirt_75,
/turf/simulated/floor/wood/bamboo,
/area/space)
"Jt" = (
/obj/structure/closet,
/obj/random/junk,
/turf/simulated/floor/tiled,
/area/space)
"JE" = (
/obj/structure/table/steel,
/obj/random/desktoy{
	pixel_y = 9
	},
/obj/machinery/light/colored/decayed,
/turf/simulated/floor/tiled,
/area/space)
"JJ" = (
/obj/effect/floor_decal/industrial/outline/grey,
/obj/effect/map_effect/marker/mapmanip/submap/extract/cryo_outpost/warehouse,
/obj/structure/closet/crate,
/obj/random/loot,
/obj/random/loot,
/obj/random/dirt_75,
/turf/simulated/floor/plating,
/area/cryo_outpost/inside/warehouse)
"JN" = (
/obj/structure/bed/padded,
/obj/item/bedsheet/random,
/obj/random/dirt_75,
/obj/machinery/light/colored/decayed{
	dir = 1
	},
/turf/simulated/floor/wood/bamboo,
/area/space)
"JS" = (
/obj/structure/table/standard,
/obj/random/pottedplant_small{
	pixel_x = -5;
	pixel_y = 6
	},
/turf/simulated/floor/wood/mahogany,
/area/space)
"Ko" = (
/obj/structure/bed/padded,
/obj/item/bedsheet/dorms,
/turf/simulated/floor/tiled,
/area/space)
"KF" = (
/obj/structure/table/steel,
/obj/random/medical{
	pixel_y = 6
	},
/obj/machinery/light/colored/decayed{
	dir = 1
	},
/turf/simulated/floor/tiled,
/area/space)
"MF" = (
/obj/effect/floor_decal/industrial/outline/grey,
/obj/structure/closet/crate/drop,
/obj/random/civgun,
/obj/random/civgun,
/obj/random/dirt_75,
/turf/simulated/floor/plating,
/area/cryo_outpost/inside/warehouse)
"MR" = (
/obj/structure/bed/padded,
/obj/item/bedsheet/dorms,
/obj/random/dirt_75,
/turf/simulated/floor/tiled,
/area/space)
"NE" = (
/obj/effect/map_effect/marker/mapmanip/submap/extract/cryo_outpost/crew_quarters_room,
/obj/random/dirt_75,
/turf/simulated/floor/tiled,
/area/space)
"OT" = (
/obj/structure/table/steel,
/obj/item/device/flashlight/lamp/off{
	pixel_y = 4
	},
/turf/simulated/floor/tiled,
/area/space)
"OV" = (
/obj/effect/floor_decal/industrial/outline/grey,
/obj/item/stack/material/glass/full,
/obj/random/dirt_75,
/turf/simulated/floor/plating,
/area/cryo_outpost/inside/warehouse)
"Pm" = (
/obj/effect/floor_decal/industrial/outline/grey,
/obj/structure/closet/crate/freezer/kois/rations,
/obj/random/dirt_75,
/turf/simulated/floor/plating,
/area/cryo_outpost/inside/warehouse)
"Py" = (
/obj/effect/floor_decal/industrial/outline/grey,
/turf/simulated/floor/plating,
/area/cryo_outpost/inside/warehouse)
"Qt" = (
/obj/effect/floor_decal/industrial/outline/grey,
/obj/random/dirt_75,
/obj/random/dirt_75,
/obj/structure/closet/crate/loot,
/turf/simulated/floor/plating,
/area/cryo_outpost/inside/warehouse)
"QG" = (
/obj/effect/floor_decal/industrial/outline/grey,
/obj/random/dirt_75,
/obj/random/dirt_75,
/turf/simulated/floor/plating,
/area/cryo_outpost/inside/warehouse)
"QJ" = (
/turf/template_noop,
/area/space)
"Rn" = (
/obj/effect/floor_decal/industrial/outline/grey,
/obj/random/dirt_75,
/obj/random/dirt_75,
/obj/random/dirt_75,
/turf/simulated/floor/plating,
/area/cryo_outpost/inside/warehouse)
"RG" = (
/obj/structure/table/steel,
/obj/random/pottedplant_small{
	pixel_x = -5;
	pixel_y = 6
	},
/turf/simulated/floor/tiled,
/area/space)
"RY" = (
/obj/effect/map_effect/marker/mapmanip/submap/extract/cryo_outpost/crew_quarters_room,
/obj/structure/closet,
/obj/random/junk,
/turf/simulated/floor/tiled,
/area/space)
"SN" = (
/obj/random/dirt_75,
/obj/random/dirt_75,
/obj/random/dirt_75,
/obj/random/dirt_75,
/turf/simulated/floor/plating,
/area/cryo_outpost/inside/warehouse)
"Tp" = (
/turf/simulated/floor/wood/bamboo,
/area/space)
"TN" = (
/obj/effect/floor_decal/industrial/outline/grey,
/obj/effect/map_effect/marker/mapmanip/submap/extract/cryo_outpost/warehouse,
/obj/random/dirt_75,
/turf/simulated/floor/plating,
/area/cryo_outpost/inside/warehouse)
"VB" = (
/obj/structure/bed/stool/chair/plastic,
/obj/random/dirt_75,
/turf/simulated/floor/tiled,
/area/space)
"WC" = (
/obj/structure/table/steel,
/obj/machinery/light/colored/decayed{
	dir = 1
	},
/turf/simulated/floor/tiled,
/area/space)
"WD" = (
/obj/effect/floor_decal/industrial/outline/grey,
/obj/random/dirt_75,
/turf/simulated/floor/plating,
/area/cryo_outpost/inside/warehouse)
"Xj" = (
/obj/effect/floor_decal/industrial/outline/grey,
/obj/structure/closet/crate/drop,
/obj/random/civgun/rifle,
/obj/random/dirt_75,
/turf/simulated/floor/plating,
/area/cryo_outpost/inside/warehouse)
"XQ" = (
/obj/effect/floor_decal/industrial/outline/grey,
/obj/item/stack/material/graphite/full,
/obj/random/dirt_75,
/turf/simulated/floor/plating,
/area/cryo_outpost/inside/warehouse)
"YG" = (
/obj/random/dirt_75,
/obj/random/dirt_75,
/obj/random/dirt_75,
/obj/random/dirt_75,
/turf/simulated/floor/tiled,
/area/space)
"YO" = (
/obj/structure/table/steel,
/turf/simulated/floor/wood/bamboo,
/area/space)
"Za" = (
/obj/effect/floor_decal/industrial/outline/grey,
/obj/structure/closet/crate,
/obj/effect/map_effect/marker/mapmanip/submap/extract/cryo_outpost/warehouse,
/turf/simulated/floor/plating,
/area/cryo_outpost/inside/warehouse)
"Zp" = (
/obj/random/dirt_75,
/obj/random/dirt_75,
/obj/random/dirt_75,
/turf/simulated/floor/tiled,
/area/space)
"ZV" = (
/obj/structure/bed/padded,
/obj/item/bedsheet/random,
/obj/random/dirt_75,
/obj/random/dirt_75,
/obj/machinery/light/colored/decayed{
	dir = 1
	},
/turf/simulated/floor/tiled,
/area/space)
"ZX" = (
/obj/structure/closet,
/obj/machinery/light/colored/decayed{
	dir = 1
	},
/turf/simulated/floor/lino/diamond,
/area/space)

(1,1,1) = {"
QJ
QJ
QJ
QJ
QJ
QJ
QJ
QJ
QJ
QJ
QJ
QJ
QJ
QJ
QJ
QJ
QJ
QJ
QJ
QJ
QJ
QJ
QJ
QJ
QJ
QJ
QJ
QJ
QJ
QJ
QJ
QJ
QJ
QJ
QJ
QJ
QJ
QJ
QJ
QJ
QJ
QJ
QJ
QJ
QJ
QJ
QJ
QJ
QJ
QJ
"}
(2,1,1) = {"
QJ
QJ
QJ
QJ
QJ
QJ
QJ
QJ
QJ
QJ
QJ
QJ
QJ
QJ
QJ
QJ
QJ
QJ
QJ
QJ
QJ
QJ
QJ
QJ
QJ
QJ
QJ
QJ
QJ
QJ
QJ
QJ
QJ
QJ
QJ
QJ
QJ
QJ
QJ
QJ
QJ
QJ
QJ
QJ
QJ
QJ
QJ
QJ
QJ
QJ
"}
(3,1,1) = {"
QJ
QJ
QJ
QJ
QJ
QJ
QJ
QJ
QJ
QJ
QJ
QJ
QJ
WD
ox
WD
TN
QJ
QJ
WD
BC
BC
TN
QJ
QJ
nq
rW
WD
TN
QJ
QJ
QJ
QJ
QJ
QJ
aC
AO
Ac
QJ
QJ
OT
ab
Ko
QJ
QJ
tH
ab
qi
QJ
QJ
"}
(4,1,1) = {"
QJ
QJ
QJ
QJ
QJ
QJ
QJ
QJ
QJ
QJ
QJ
QJ
QJ
ox
WD
ox
WD
QJ
QJ
WD
BC
WD
WD
QJ
QJ
QG
QG
xe
QG
QJ
QJ
QJ
QJ
QJ
QJ
qK
dJ
AK
QJ
QJ
Ds
zG
Ds
QJ
QJ
dl
Zp
Es
QJ
QJ
"}
(5,1,1) = {"
QJ
QJ
QJ
QJ
QJ
QJ
QJ
QJ
QJ
QJ
QJ
QJ
QJ
ph
ph
ph
ph
QJ
QJ
ph
ph
ph
ph
QJ
QJ
dK
xC
xC
dK
QJ
QJ
QJ
QJ
QJ
QJ
qK
dJ
na
QJ
QJ
ZX
sP
dN
QJ
QJ
AR
pa
JE
QJ
QJ
"}
(6,1,1) = {"
QJ
QJ
QJ
QJ
QJ
QJ
QJ
QJ
QJ
QJ
QJ
QJ
QJ
ph
ph
ph
ph
QJ
QJ
ph
ph
ph
ph
QJ
QJ
dK
xC
xC
dK
QJ
QJ
QJ
QJ
QJ
QJ
aC
AO
JS
QJ
QJ
ne
mt
Ko
QJ
QJ
MR
mt
tH
QJ
QJ
"}
(7,1,1) = {"
QJ
QJ
QJ
QJ
QJ
QJ
QJ
QJ
QJ
QJ
QJ
QJ
QJ
WD
ox
ox
WD
QJ
QJ
BC
WD
WD
WD
QJ
QJ
QG
Rn
Rn
QG
QJ
QJ
QJ
QJ
QJ
QJ
QJ
QJ
QJ
QJ
QJ
QJ
QJ
QJ
QJ
QJ
QJ
QJ
QJ
QJ
QJ
"}
(8,1,1) = {"
QJ
QJ
QJ
QJ
QJ
QJ
QJ
QJ
QJ
QJ
QJ
QJ
QJ
Pm
WD
WD
WD
QJ
QJ
WD
BC
BC
WD
QJ
QJ
rW
nq
WD
nq
QJ
QJ
QJ
QJ
QJ
QJ
QJ
QJ
QJ
QJ
QJ
QJ
QJ
QJ
QJ
QJ
QJ
QJ
QJ
QJ
QJ
"}
(9,1,1) = {"
QJ
QJ
QJ
QJ
QJ
QJ
QJ
QJ
QJ
QJ
QJ
QJ
QJ
QJ
QJ
QJ
QJ
QJ
QJ
QJ
QJ
QJ
QJ
QJ
QJ
QJ
QJ
QJ
QJ
QJ
QJ
QJ
QJ
QJ
QJ
xX
mt
Gz
QJ
QJ
vn
pa
kJ
QJ
QJ
Ko
ab
pY
QJ
QJ
"}
(10,1,1) = {"
QJ
QJ
QJ
QJ
QJ
QJ
QJ
QJ
QJ
QJ
QJ
QJ
QJ
QJ
QJ
QJ
QJ
QJ
QJ
QJ
QJ
QJ
QJ
QJ
QJ
QJ
QJ
QJ
QJ
QJ
QJ
QJ
QJ
QJ
QJ
ZV
YG
mt
QJ
QJ
xT
pa
wC
QJ
QJ
KF
mt
nc
QJ
QJ
"}
(11,1,1) = {"
QJ
QJ
QJ
QJ
QJ
QJ
QJ
QJ
QJ
QJ
QJ
QJ
QJ
nq
nq
nq
CA
QJ
QJ
xE
xE
Py
Za
QJ
QJ
XQ
OV
ff
Ge
QJ
QJ
QJ
QJ
QJ
QJ
WC
pa
MR
QJ
QJ
zn
ab
Ko
QJ
QJ
MR
pa
Ko
QJ
QJ
"}
(12,1,1) = {"
QJ
QJ
QJ
QJ
QJ
QJ
QJ
QJ
QJ
QJ
QJ
QJ
QJ
WD
QG
QG
QG
QJ
QJ
WD
Py
xE
Py
QJ
QJ
WD
OV
ff
WD
QJ
QJ
QJ
QJ
QJ
QJ
ve
pa
dl
QJ
QJ
ne
ab
tH
QJ
QJ
tH
mt
tH
QJ
QJ
"}
(13,1,1) = {"
QJ
QJ
QJ
QJ
QJ
QJ
QJ
QJ
QJ
QJ
QJ
QJ
QJ
ph
dK
dK
dK
QJ
QJ
ph
ph
bM
bM
QJ
QJ
dK
ph
ph
ph
QJ
QJ
QJ
QJ
QJ
QJ
QJ
QJ
QJ
QJ
QJ
QJ
QJ
QJ
QJ
QJ
QJ
QJ
QJ
QJ
QJ
"}
(14,1,1) = {"
QJ
QJ
QJ
QJ
QJ
QJ
QJ
QJ
QJ
QJ
QJ
QJ
QJ
ph
dK
dK
dK
QJ
QJ
ph
dK
ph
bM
QJ
QJ
ph
dK
dK
ph
QJ
QJ
QJ
QJ
QJ
QJ
QJ
QJ
QJ
QJ
QJ
QJ
QJ
QJ
QJ
QJ
QJ
QJ
QJ
QJ
QJ
"}
(15,1,1) = {"
QJ
QJ
QJ
QJ
QJ
QJ
QJ
QJ
QJ
QJ
QJ
QJ
QJ
WD
WD
rW
WD
QJ
QJ
WD
WD
rW
Py
QJ
QJ
WD
sM
fm
sn
QJ
QJ
QJ
QJ
QJ
QJ
WC
zG
RY
QJ
QJ
VB
mt
NE
QJ
QJ
Ay
IB
jh
QJ
QJ
"}
(16,1,1) = {"
QJ
QJ
QJ
QJ
QJ
QJ
QJ
QJ
QJ
QJ
QJ
QJ
QJ
rW
rW
rW
rW
QJ
QJ
WD
rW
WD
xE
QJ
QJ
jq
sM
sn
sn
QJ
QJ
QJ
QJ
QJ
QJ
CZ
sP
ne
QJ
QJ
xT
pa
xO
QJ
QJ
df
IB
iD
QJ
QJ
"}
(17,1,1) = {"
QJ
QJ
QJ
QJ
QJ
QJ
QJ
QJ
QJ
QJ
QJ
QJ
QJ
QJ
QJ
QJ
QJ
QJ
QJ
QJ
QJ
QJ
QJ
QJ
QJ
QJ
QJ
QJ
QJ
QJ
QJ
QJ
QJ
QJ
QJ
RG
sP
OT
QJ
QJ
ai
mt
tn
QJ
QJ
df
Tp
YO
QJ
QJ
"}
(18,1,1) = {"
QJ
QJ
QJ
QJ
QJ
QJ
QJ
QJ
QJ
QJ
QJ
QJ
QJ
QJ
QJ
QJ
QJ
QJ
QJ
QJ
QJ
QJ
QJ
QJ
QJ
QJ
QJ
QJ
QJ
QJ
QJ
QJ
QJ
QJ
QJ
bx
sP
bb
QJ
QJ
Jt
mt
tH
QJ
QJ
JN
up
jg
QJ
QJ
"}
(19,1,1) = {"
QJ
QJ
QJ
QJ
QJ
QJ
QJ
QJ
QJ
QJ
QJ
QJ
QJ
AC
WD
WD
JJ
QJ
QJ
uA
WD
uA
TN
QJ
QJ
WD
nq
WD
Im
QJ
QJ
QJ
QJ
QJ
QJ
QJ
QJ
QJ
QJ
QJ
QJ
QJ
QJ
QJ
QJ
QJ
QJ
QJ
QJ
QJ
"}
(20,1,1) = {"
QJ
QJ
QJ
QJ
QJ
QJ
QJ
QJ
QJ
QJ
QJ
QJ
QJ
WD
WD
WD
AC
QJ
QJ
WD
WD
WD
uA
QJ
QJ
xe
QG
QG
WD
QJ
QJ
QJ
QJ
QJ
QJ
QJ
QJ
QJ
QJ
QJ
QJ
QJ
QJ
QJ
QJ
QJ
QJ
QJ
QJ
QJ
"}
(21,1,1) = {"
QJ
QJ
QJ
QJ
QJ
QJ
QJ
QJ
QJ
QJ
QJ
QJ
QJ
ph
ph
ph
ph
QJ
QJ
xC
xC
dK
ph
QJ
QJ
dK
dK
dK
ph
QJ
QJ
QJ
QJ
QJ
QJ
QJ
QJ
QJ
QJ
QJ
QJ
QJ
QJ
QJ
QJ
QJ
QJ
QJ
QJ
QJ
"}
(22,1,1) = {"
QJ
QJ
QJ
QJ
QJ
QJ
QJ
QJ
QJ
QJ
QJ
QJ
QJ
ph
ph
ph
ph
QJ
QJ
xC
SN
xC
ph
QJ
QJ
ph
ph
ph
ph
QJ
QJ
QJ
QJ
QJ
QJ
QJ
QJ
QJ
QJ
QJ
QJ
QJ
QJ
QJ
QJ
QJ
QJ
QJ
QJ
QJ
"}
(23,1,1) = {"
QJ
QJ
QJ
QJ
QJ
QJ
QJ
QJ
QJ
QJ
QJ
QJ
QJ
AC
WD
AC
AC
QJ
QJ
QG
Rn
QG
WD
QJ
QJ
WD
WD
nq
WD
QJ
QJ
QJ
QJ
QJ
QJ
QJ
QJ
QJ
QJ
QJ
QJ
QJ
QJ
QJ
QJ
QJ
QJ
QJ
QJ
QJ
"}
(24,1,1) = {"
QJ
QJ
QJ
QJ
QJ
QJ
QJ
QJ
QJ
QJ
QJ
QJ
QJ
WD
AC
WD
AC
QJ
QJ
MF
Xj
WD
MF
QJ
QJ
nq
WD
nq
WD
QJ
QJ
QJ
QJ
QJ
QJ
QJ
QJ
QJ
QJ
QJ
QJ
QJ
QJ
QJ
QJ
QJ
QJ
QJ
QJ
QJ
"}
(25,1,1) = {"
QJ
QJ
QJ
QJ
QJ
QJ
QJ
QJ
QJ
QJ
QJ
QJ
QJ
QJ
QJ
QJ
QJ
QJ
QJ
QJ
QJ
QJ
QJ
QJ
QJ
QJ
QJ
QJ
QJ
QJ
QJ
QJ
QJ
QJ
QJ
QJ
QJ
QJ
QJ
QJ
QJ
QJ
QJ
QJ
QJ
QJ
QJ
QJ
QJ
QJ
"}
(26,1,1) = {"
QJ
QJ
QJ
QJ
QJ
QJ
QJ
QJ
QJ
QJ
QJ
QJ
QJ
QJ
QJ
QJ
QJ
QJ
QJ
QJ
QJ
QJ
QJ
QJ
QJ
QJ
QJ
QJ
QJ
QJ
QJ
QJ
QJ
QJ
QJ
QJ
QJ
QJ
QJ
QJ
QJ
QJ
QJ
QJ
QJ
QJ
QJ
QJ
QJ
QJ
"}
(27,1,1) = {"
QJ
QJ
QJ
QJ
QJ
QJ
QJ
QJ
QJ
QJ
QJ
QJ
QJ
WD
WD
aU
TN
QJ
QJ
WD
aU
WD
TN
QJ
QJ
WD
WD
WD
uL
QJ
QJ
QJ
QJ
QJ
QJ
QJ
QJ
QJ
QJ
QJ
QJ
QJ
QJ
QJ
QJ
QJ
QJ
QJ
QJ
QJ
"}
(28,1,1) = {"
QJ
QJ
QJ
QJ
QJ
QJ
QJ
QJ
QJ
QJ
QJ
QJ
QJ
QG
WD
WD
aU
QJ
QJ
QG
QG
QG
WD
QJ
QJ
QG
Qt
QG
WD
QJ
QJ
QJ
QJ
QJ
QJ
QJ
QJ
QJ
QJ
QJ
QJ
QJ
QJ
QJ
QJ
QJ
QJ
QJ
QJ
QJ
"}
(29,1,1) = {"
QJ
QJ
QJ
QJ
QJ
QJ
QJ
QJ
QJ
QJ
QJ
QJ
QJ
dK
ph
ph
ph
QJ
QJ
dK
ph
ph
ph
QJ
QJ
dK
dK
dK
ph
QJ
QJ
QJ
QJ
QJ
QJ
QJ
QJ
QJ
QJ
QJ
QJ
QJ
QJ
QJ
QJ
QJ
QJ
QJ
QJ
QJ
"}
(30,1,1) = {"
QJ
QJ
QJ
QJ
QJ
QJ
QJ
QJ
QJ
QJ
QJ
QJ
QJ
ph
dK
dK
ph
QJ
QJ
ph
ph
ph
ph
QJ
QJ
ph
ph
ph
ph
QJ
QJ
QJ
QJ
QJ
QJ
QJ
QJ
QJ
QJ
QJ
QJ
QJ
QJ
QJ
QJ
QJ
QJ
QJ
QJ
QJ
"}
(31,1,1) = {"
QJ
QJ
QJ
QJ
QJ
QJ
QJ
QJ
QJ
QJ
QJ
QJ
QJ
WD
ua
QG
WD
QJ
QJ
WD
WD
aU
QG
QJ
QJ
aU
WD
WD
WD
QJ
QJ
QJ
QJ
QJ
QJ
QJ
QJ
QJ
QJ
QJ
QJ
QJ
QJ
QJ
QJ
QJ
QJ
QJ
QJ
QJ
"}
(32,1,1) = {"
QJ
QJ
QJ
QJ
QJ
QJ
QJ
QJ
QJ
QJ
QJ
QJ
QJ
ua
WD
WD
WD
QJ
QJ
aU
WD
WD
QG
QJ
QJ
aU
WD
aU
WD
QJ
QJ
QJ
QJ
QJ
QJ
QJ
QJ
QJ
QJ
QJ
QJ
QJ
QJ
QJ
QJ
QJ
QJ
QJ
QJ
QJ
"}
(33,1,1) = {"
QJ
QJ
QJ
QJ
QJ
QJ
QJ
QJ
QJ
QJ
QJ
QJ
QJ
QJ
QJ
QJ
QJ
QJ
QJ
QJ
QJ
QJ
QJ
QJ
QJ
QJ
QJ
QJ
QJ
QJ
QJ
QJ
QJ
QJ
QJ
QJ
QJ
QJ
QJ
QJ
QJ
QJ
QJ
QJ
QJ
QJ
QJ
QJ
QJ
QJ
"}
(34,1,1) = {"
QJ
QJ
QJ
QJ
QJ
QJ
QJ
QJ
QJ
QJ
QJ
QJ
QJ
QJ
QJ
QJ
QJ
QJ
QJ
QJ
QJ
QJ
QJ
QJ
QJ
QJ
QJ
QJ
QJ
QJ
QJ
QJ
QJ
QJ
QJ
QJ
QJ
QJ
QJ
QJ
QJ
QJ
QJ
QJ
QJ
QJ
QJ
QJ
QJ
QJ
"}
(35,1,1) = {"
QJ
QJ
QJ
QJ
QJ
QJ
QJ
QJ
QJ
QJ
QJ
QJ
QJ
QJ
QJ
QJ
QJ
QJ
QJ
QJ
QJ
QJ
QJ
QJ
QJ
QJ
QJ
QJ
QJ
QJ
QJ
QJ
QJ
QJ
QJ
QJ
QJ
QJ
QJ
QJ
QJ
QJ
QJ
QJ
QJ
QJ
QJ
QJ
QJ
QJ
"}
(36,1,1) = {"
QJ
QJ
QJ
QJ
QJ
QJ
QJ
QJ
QJ
QJ
QJ
QJ
QJ
QJ
QJ
QJ
QJ
QJ
QJ
QJ
QJ
QJ
QJ
QJ
QJ
QJ
QJ
QJ
QJ
QJ
QJ
QJ
QJ
QJ
QJ
QJ
QJ
QJ
QJ
QJ
QJ
QJ
QJ
QJ
QJ
QJ
QJ
QJ
QJ
QJ
"}
(37,1,1) = {"
QJ
QJ
QJ
QJ
QJ
QJ
QJ
QJ
QJ
QJ
QJ
QJ
QJ
QJ
QJ
QJ
QJ
QJ
QJ
QJ
QJ
QJ
QJ
QJ
QJ
QJ
QJ
QJ
QJ
QJ
QJ
QJ
QJ
QJ
QJ
QJ
QJ
QJ
QJ
QJ
QJ
QJ
QJ
QJ
QJ
QJ
QJ
QJ
QJ
QJ
"}
(38,1,1) = {"
QJ
QJ
QJ
QJ
QJ
QJ
QJ
QJ
QJ
QJ
QJ
QJ
QJ
QJ
QJ
QJ
QJ
QJ
QJ
QJ
QJ
QJ
QJ
QJ
QJ
QJ
QJ
QJ
QJ
QJ
QJ
QJ
QJ
QJ
QJ
QJ
QJ
QJ
QJ
QJ
QJ
QJ
QJ
QJ
QJ
QJ
QJ
QJ
QJ
QJ
"}
(39,1,1) = {"
QJ
QJ
QJ
QJ
QJ
QJ
QJ
QJ
QJ
QJ
QJ
QJ
QJ
QJ
QJ
QJ
QJ
QJ
QJ
QJ
QJ
QJ
QJ
QJ
QJ
QJ
QJ
QJ
QJ
QJ
QJ
QJ
QJ
QJ
QJ
QJ
QJ
QJ
QJ
QJ
QJ
QJ
QJ
QJ
QJ
QJ
QJ
QJ
QJ
QJ
"}
(40,1,1) = {"
QJ
QJ
QJ
QJ
QJ
QJ
QJ
QJ
QJ
QJ
QJ
QJ
QJ
QJ
QJ
QJ
QJ
QJ
QJ
QJ
QJ
QJ
QJ
QJ
QJ
QJ
QJ
QJ
QJ
QJ
QJ
QJ
QJ
QJ
QJ
QJ
QJ
QJ
QJ
QJ
QJ
QJ
QJ
QJ
QJ
QJ
QJ
QJ
QJ
QJ
"}
(41,1,1) = {"
QJ
QJ
QJ
QJ
QJ
QJ
QJ
QJ
QJ
QJ
QJ
QJ
QJ
QJ
QJ
QJ
QJ
QJ
QJ
QJ
QJ
QJ
QJ
QJ
QJ
QJ
QJ
QJ
QJ
QJ
QJ
QJ
QJ
QJ
QJ
QJ
QJ
QJ
QJ
QJ
QJ
QJ
QJ
QJ
QJ
QJ
QJ
QJ
QJ
QJ
"}
(42,1,1) = {"
QJ
QJ
QJ
QJ
QJ
QJ
QJ
QJ
QJ
QJ
QJ
QJ
QJ
QJ
QJ
QJ
QJ
QJ
QJ
QJ
QJ
QJ
QJ
QJ
QJ
QJ
QJ
QJ
QJ
QJ
QJ
QJ
QJ
QJ
QJ
QJ
QJ
QJ
QJ
QJ
QJ
QJ
QJ
QJ
QJ
QJ
QJ
QJ
QJ
QJ
"}
(43,1,1) = {"
QJ
QJ
QJ
QJ
QJ
QJ
QJ
QJ
QJ
QJ
QJ
QJ
QJ
QJ
QJ
QJ
QJ
QJ
QJ
QJ
QJ
QJ
QJ
QJ
QJ
QJ
QJ
QJ
QJ
QJ
QJ
QJ
QJ
QJ
QJ
QJ
QJ
QJ
QJ
QJ
QJ
QJ
QJ
QJ
QJ
QJ
QJ
QJ
QJ
QJ
"}
(44,1,1) = {"
QJ
QJ
QJ
QJ
QJ
QJ
QJ
QJ
QJ
QJ
QJ
QJ
QJ
QJ
QJ
QJ
QJ
QJ
QJ
QJ
QJ
QJ
QJ
QJ
QJ
QJ
QJ
QJ
QJ
QJ
QJ
QJ
QJ
QJ
QJ
QJ
QJ
QJ
QJ
QJ
QJ
QJ
QJ
QJ
QJ
QJ
QJ
QJ
QJ
QJ
"}
(45,1,1) = {"
QJ
QJ
QJ
QJ
QJ
QJ
QJ
QJ
QJ
QJ
QJ
QJ
QJ
QJ
QJ
QJ
QJ
QJ
QJ
QJ
QJ
QJ
QJ
QJ
QJ
QJ
QJ
QJ
QJ
QJ
QJ
QJ
QJ
QJ
QJ
QJ
QJ
QJ
QJ
QJ
QJ
QJ
QJ
QJ
QJ
QJ
QJ
QJ
QJ
QJ
"}
(46,1,1) = {"
QJ
QJ
QJ
QJ
QJ
QJ
QJ
QJ
QJ
QJ
QJ
QJ
QJ
QJ
QJ
QJ
QJ
QJ
QJ
QJ
QJ
QJ
QJ
QJ
QJ
QJ
QJ
QJ
QJ
QJ
QJ
QJ
QJ
QJ
QJ
QJ
QJ
QJ
QJ
QJ
QJ
QJ
QJ
QJ
QJ
QJ
QJ
QJ
QJ
QJ
"}
(47,1,1) = {"
QJ
QJ
QJ
QJ
QJ
QJ
QJ
QJ
QJ
QJ
QJ
QJ
QJ
QJ
QJ
QJ
QJ
QJ
QJ
QJ
QJ
QJ
QJ
QJ
QJ
QJ
QJ
QJ
QJ
QJ
QJ
QJ
QJ
QJ
QJ
QJ
QJ
QJ
QJ
QJ
QJ
QJ
QJ
QJ
QJ
QJ
QJ
QJ
QJ
QJ
"}
(48,1,1) = {"
QJ
QJ
QJ
QJ
QJ
QJ
QJ
QJ
QJ
QJ
QJ
QJ
QJ
QJ
QJ
QJ
QJ
QJ
QJ
QJ
QJ
QJ
QJ
QJ
QJ
QJ
QJ
QJ
QJ
QJ
QJ
QJ
QJ
QJ
QJ
QJ
QJ
QJ
QJ
QJ
QJ
QJ
QJ
QJ
QJ
QJ
QJ
QJ
QJ
QJ
"}
(49,1,1) = {"
QJ
QJ
QJ
QJ
QJ
QJ
QJ
QJ
QJ
QJ
QJ
QJ
QJ
QJ
QJ
QJ
QJ
QJ
QJ
QJ
QJ
QJ
QJ
QJ
QJ
QJ
QJ
QJ
QJ
QJ
QJ
QJ
QJ
QJ
QJ
QJ
QJ
QJ
QJ
QJ
QJ
QJ
QJ
QJ
QJ
QJ
QJ
QJ
QJ
QJ
"}
(50,1,1) = {"
QJ
QJ
QJ
QJ
QJ
QJ
QJ
QJ
QJ
QJ
QJ
QJ
QJ
QJ
QJ
QJ
QJ
QJ
QJ
QJ
QJ
QJ
QJ
QJ
QJ
QJ
QJ
QJ
QJ
QJ
QJ
QJ
QJ
QJ
QJ
QJ
QJ
QJ
QJ
QJ
QJ
QJ
QJ
QJ
QJ
QJ
QJ
QJ
QJ
QJ
"}
