//MAP CONVERTED BY dmm2tgm.py THIS HEADER COMMENT PREVENTS RECONVERSION, DO NOT REMOVE
"a" = (
/turf/template_noop,
/area/space)
"b" = (
/obj/structure/bed/padded,
/obj/item/bedsheet/random,
/turf/simulated/floor/tiled,
/area/space)
"c" = (
/turf/simulated/floor/plating,
/area/cryo_outpost/inside/warehouse)
"e" = (
/obj/random/dirt_75,
/turf/simulated/floor/plating,
/area/cryo_outpost/inside/warehouse)
"f" = (
/obj/effect/floor_decal/industrial/outline/grey,
/obj/random/dirt_75,
/turf/simulated/floor/plating,
/area/cryo_outpost/inside/warehouse)
"g" = (
/obj/effect/floor_decal/industrial/outline/grey,
/obj/structure/closet/crate/loot,
/obj/random/dirt_75,
/obj/random/dirt_75,
/turf/simulated/floor/plating,
/area/cryo_outpost/inside/warehouse)
"h" = (
/obj/effect/floor_decal/industrial/outline/grey,
/obj/structure/closet/crate/drop,
/obj/random/civgun/rifle,
/obj/random/dirt_75,
/turf/simulated/floor/plating,
/area/cryo_outpost/inside/warehouse)
"j" = (
/obj/effect/floor_decal/industrial/outline/grey,
/obj/structure/closet/crate/freezer/rations,
/obj/random/dirt_75,
/turf/simulated/floor/plating,
/area/cryo_outpost/inside/warehouse)
"k" = (
/turf/simulated/floor/tiled,
/area/space)
"l" = (
/obj/effect/floor_decal/industrial/outline/grey,
/obj/effect/map_effect/marker/mapmanip/submap/extract/cryo_outpost/warehouse,
/obj/structure/closet/crate,
/obj/random/loot,
/obj/random/loot,
/obj/random/dirt_75,
/turf/simulated/floor/plating,
/area/cryo_outpost/inside/warehouse)
"m" = (
/obj/structure/table/steel,
/obj/random/medical{
	pixel_y = 6
	},
/turf/simulated/floor/tiled,
/area/space)
"n" = (
/obj/effect/floor_decal/industrial/outline/grey,
/obj/structure/closet/crate/freezer/kois/rations,
/obj/random/dirt_75,
/turf/simulated/floor/plating,
/area/cryo_outpost/inside/warehouse)
"p" = (
/obj/effect/floor_decal/industrial/outline/grey,
/obj/item/stack/material/iron/full,
/obj/random/dirt_75,
/turf/simulated/floor/plating,
/area/cryo_outpost/inside/warehouse)
"q" = (
/obj/structure/closet/cabinet,
/turf/simulated/floor/tiled,
/area/space)
"r" = (
/obj/effect/floor_decal/industrial/outline/grey,
/obj/effect/map_effect/marker/mapmanip/submap/extract/cryo_outpost/warehouse,
/obj/structure/closet/crate/loot,
/obj/random/dirt_75,
/turf/simulated/floor/plating,
/area/cryo_outpost/inside/warehouse)
"s" = (
/obj/structure/bed/padded,
/obj/item/bedsheet/dorms,
/turf/simulated/floor/tiled,
/area/space)
"t" = (
/obj/structure/table/steel,
/turf/simulated/floor/tiled,
/area/space)
"u" = (
/obj/effect/floor_decal/industrial/outline/grey,
/obj/item/stack/material/steel/full,
/obj/random/dirt_75,
/obj/random/dirt_75,
/turf/simulated/floor/plating,
/area/cryo_outpost/inside/warehouse)
"v" = (
/obj/structure/closet/cabinet,
/obj/effect/map_effect/marker/mapmanip/submap/extract/cryo_outpost/crew_quarters_room,
/turf/simulated/floor/tiled,
/area/space)
"w" = (
/obj/structure/closet,
/obj/effect/map_effect/marker/mapmanip/submap/extract/cryo_outpost/crew_quarters_room,
/turf/simulated/floor/tiled,
/area/space)
"y" = (
/obj/random/dirt_75,
/obj/random/dirt_75,
/turf/simulated/floor/plating,
/area/cryo_outpost/inside/warehouse)
"z" = (
/obj/effect/map_effect/marker/mapmanip/submap/extract/cryo_outpost/crew_quarters_room,
/turf/simulated/floor/tiled,
/area/space)
"A" = (
/obj/effect/floor_decal/industrial/outline/grey,
/obj/item/stack/material/steel/full,
/obj/random/dirt_75,
/turf/simulated/floor/plating,
/area/cryo_outpost/inside/warehouse)
"B" = (
/obj/random/dirt_75,
/obj/random/dirt_75,
/obj/random/dirt_75,
/turf/simulated/floor/plating,
/area/cryo_outpost/inside/warehouse)
"C" = (
/obj/effect/floor_decal/industrial/outline/grey,
/obj/item/stack/material/plastic/full,
/obj/effect/map_effect/marker/mapmanip/submap/extract/cryo_outpost/warehouse,
/obj/random/dirt_75,
/turf/simulated/floor/plating,
/area/cryo_outpost/inside/warehouse)
"D" = (
/obj/effect/floor_decal/industrial/outline/grey,
/obj/structure/closet/crate/drop,
/obj/random/civgun,
/obj/random/civgun,
/obj/random/dirt_75,
/turf/simulated/floor/plating,
/area/cryo_outpost/inside/warehouse)
"E" = (
/obj/effect/floor_decal/industrial/outline/grey,
/obj/structure/closet/crate,
/obj/random/dirt_75,
/turf/simulated/floor/plating,
/area/cryo_outpost/inside/warehouse)
"F" = (
/obj/effect/floor_decal/industrial/outline/grey,
/obj/random/dirt_75,
/obj/random/dirt_75,
/obj/random/dirt_75,
/turf/simulated/floor/plating,
/area/cryo_outpost/inside/warehouse)
"G" = (
/obj/random/dirt_75,
/obj/random/dirt_75,
/obj/random/dirt_75,
/obj/random/dirt_75,
/turf/simulated/floor/plating,
/area/cryo_outpost/inside/warehouse)
"I" = (
/obj/effect/floor_decal/industrial/outline/grey,
/obj/effect/map_effect/marker/mapmanip/submap/extract/cryo_outpost/warehouse,
/obj/random/dirt_75,
/turf/simulated/floor/plating,
/area/cryo_outpost/inside/warehouse)
"J" = (
/obj/effect/floor_decal/industrial/outline/grey,
/obj/structure/closet/crate/loot,
/obj/effect/map_effect/marker/mapmanip/submap/extract/cryo_outpost/warehouse,
/obj/random/dirt_75,
/turf/simulated/floor/plating,
/area/cryo_outpost/inside/warehouse)
"K" = (
/obj/effect/floor_decal/industrial/outline/grey,
/obj/item/stack/material/glass/full,
/obj/random/dirt_75,
/turf/simulated/floor/plating,
/area/cryo_outpost/inside/warehouse)
"L" = (
/obj/structure/table/standard,
/turf/simulated/floor/tiled,
/area/space)
"M" = (
/obj/effect/floor_decal/industrial/outline/grey,
/turf/simulated/floor/plating,
/area/cryo_outpost/inside/warehouse)
"N" = (
/obj/effect/floor_decal/industrial/outline/grey,
/obj/random/dirt_75,
/obj/random/dirt_75,
/turf/simulated/floor/plating,
/area/cryo_outpost/inside/warehouse)
"O" = (
/obj/effect/floor_decal/industrial/outline/grey,
/obj/structure/closet/crate,
/obj/random/loot,
/obj/random/loot,
/obj/random/dirt_75,
/turf/simulated/floor/plating,
/area/cryo_outpost/inside/warehouse)
"P" = (
/obj/effect/floor_decal/industrial/outline/grey,
/obj/structure/closet/crate/loot,
/obj/random/dirt_75,
/turf/simulated/floor/plating,
/area/cryo_outpost/inside/warehouse)
"Q" = (
/obj/effect/floor_decal/industrial/outline/grey,
/obj/item/stack/material/plastic/full,
/obj/random/dirt_75,
/turf/simulated/floor/plating,
/area/cryo_outpost/inside/warehouse)
"R" = (
/obj/effect/floor_decal/industrial/outline/grey,
/obj/structure/largecrate,
/obj/random/dirt_75,
/turf/simulated/floor/plating,
/area/cryo_outpost/inside/warehouse)
"S" = (
/obj/effect/floor_decal/industrial/outline/grey,
/obj/item/stack/material/graphite/full,
/obj/random/dirt_75,
/turf/simulated/floor/plating,
/area/cryo_outpost/inside/warehouse)
"T" = (
/obj/effect/floor_decal/industrial/outline/grey,
/obj/item/stack/material/gold/full,
/obj/random/dirt_75,
/turf/simulated/floor/plating,
/area/cryo_outpost/inside/warehouse)
"U" = (
/obj/effect/floor_decal/industrial/outline/grey,
/obj/structure/closet/crate,
/obj/effect/map_effect/marker/mapmanip/submap/extract/cryo_outpost/warehouse,
/turf/simulated/floor/plating,
/area/cryo_outpost/inside/warehouse)
"V" = (
/obj/effect/floor_decal/industrial/outline/grey,
/obj/structure/closet/crate/drop,
/obj/item/clothing/suit/armor/carrier/generic,
/obj/item/clothing/suit/armor/carrier/generic,
/obj/item/clothing/head/helmet/security/generic,
/obj/item/clothing/head/helmet/security/generic,
/obj/random/dirt_75,
/turf/simulated/floor/plating,
/area/cryo_outpost/inside/warehouse)
"W" = (
/obj/structure/table/steel,
/obj/item/device/flashlight/lamp/off{
	pixel_y = 4
	},
/turf/simulated/floor/tiled,
/area/space)
"X" = (
/obj/structure/closet,
/turf/simulated/floor/tiled,
/area/space)
"Y" = (
/obj/effect/floor_decal/industrial/outline/grey,
/obj/structure/closet/crate,
/turf/simulated/floor/plating,
/area/cryo_outpost/inside/warehouse)

(1,1,1) = {"
a
a
a
a
a
a
a
a
a
a
a
a
a
a
a
a
a
a
a
a
a
a
a
a
a
a
a
a
a
a
a
a
a
a
a
a
a
a
a
a
a
a
a
a
a
a
a
a
a
a
"}
(2,1,1) = {"
a
a
a
a
a
a
a
a
a
a
a
a
a
a
a
a
a
a
a
a
a
a
a
a
a
a
a
a
a
a
a
a
a
a
a
a
a
a
a
a
a
a
a
a
a
a
a
a
a
a
"}
(3,1,1) = {"
a
a
a
a
a
a
a
a
a
a
a
a
a
f
j
f
I
a
a
f
R
R
I
a
a
P
E
f
I
a
a
a
a
a
a
s
k
w
a
a
W
k
z
a
a
X
k
z
a
a
"}
(4,1,1) = {"
a
a
a
a
a
a
a
a
a
a
a
a
a
j
f
j
f
a
a
f
R
f
f
a
a
N
N
g
N
a
a
a
a
a
a
q
k
k
a
a
q
k
k
a
a
k
k
b
a
a
"}
(5,1,1) = {"
a
a
a
a
a
a
a
a
a
a
a
a
a
e
e
e
e
a
a
e
e
e
e
a
a
y
B
B
y
a
a
a
a
a
a
q
k
L
a
a
X
k
k
a
a
k
k
t
a
a
"}
(6,1,1) = {"
a
a
a
a
a
a
a
a
a
a
a
a
a
e
e
e
e
a
a
e
e
e
e
a
a
y
B
B
y
a
a
a
a
a
a
s
k
L
a
a
b
k
s
a
a
k
k
X
a
a
"}
(7,1,1) = {"
a
a
a
a
a
a
a
a
a
a
a
a
a
f
j
j
f
a
a
R
f
f
f
a
a
N
F
F
N
a
a
a
a
a
a
a
a
a
a
a
a
a
a
a
a
a
a
a
a
a
"}
(8,1,1) = {"
a
a
a
a
a
a
a
a
a
a
a
a
a
n
f
f
f
a
a
f
R
R
f
a
a
E
P
f
P
a
a
a
a
a
a
a
a
a
a
a
a
a
a
a
a
a
a
a
a
a
"}
(9,1,1) = {"
a
a
a
a
a
a
a
a
a
a
a
a
a
a
a
a
a
a
a
a
a
a
a
a
a
a
a
a
a
a
a
a
a
a
a
k
k
v
a
a
t
k
w
a
a
k
k
z
a
a
"}
(10,1,1) = {"
a
a
a
a
a
a
a
a
a
a
a
a
a
a
a
a
a
a
a
a
a
a
a
a
a
a
a
a
a
a
a
a
a
a
a
b
k
k
a
a
s
k
k
a
a
m
k
k
a
a
"}
(11,1,1) = {"
a
a
a
a
a
a
a
a
a
a
a
a
a
P
P
P
r
a
a
Y
Y
M
U
a
a
S
K
Q
C
a
a
a
a
a
a
t
k
k
a
a
t
k
k
a
a
s
k
s
a
a
"}
(12,1,1) = {"
a
a
a
a
a
a
a
a
a
a
a
a
a
f
N
N
N
a
a
f
M
Y
M
a
a
f
K
Q
f
a
a
a
a
a
a
q
k
t
a
a
b
k
X
a
a
X
k
X
a
a
"}
(13,1,1) = {"
a
a
a
a
a
a
a
a
a
a
a
a
a
e
y
y
y
a
a
e
e
c
c
a
a
y
e
e
e
a
a
a
a
a
a
a
a
a
a
a
a
a
a
a
a
a
a
a
a
a
"}
(14,1,1) = {"
a
a
a
a
a
a
a
a
a
a
a
a
a
e
y
y
y
a
a
e
y
e
c
a
a
e
y
y
e
a
a
a
a
a
a
a
a
a
a
a
a
a
a
a
a
a
a
a
a
a
"}
(15,1,1) = {"
a
a
a
a
a
a
a
a
a
a
a
a
a
f
f
E
f
a
a
f
f
E
M
a
a
f
p
u
A
a
a
a
a
a
a
t
k
z
a
a
k
k
z
a
a
t
k
z
a
a
"}
(16,1,1) = {"
a
a
a
a
a
a
a
a
a
a
a
a
a
E
E
E
E
a
a
f
E
f
Y
a
a
T
p
A
A
a
a
a
a
a
a
m
k
b
a
a
s
k
s
a
a
q
k
k
a
a
"}
(17,1,1) = {"
a
a
a
a
a
a
a
a
a
a
a
a
a
a
a
a
a
a
a
a
a
a
a
a
a
a
a
a
a
a
a
a
a
a
a
t
k
W
a
a
L
k
L
a
a
k
k
t
a
a
"}
(18,1,1) = {"
a
a
a
a
a
a
a
a
a
a
a
a
a
a
a
a
a
a
a
a
a
a
a
a
a
a
a
a
a
a
a
a
a
a
a
t
k
X
a
a
X
k
X
a
a
b
k
k
a
a
"}
(19,1,1) = {"
a
a
a
a
a
a
a
a
a
a
a
a
a
O
f
f
l
a
a
V
f
V
I
a
a
f
P
f
J
a
a
a
a
a
a
a
a
a
a
a
a
a
a
a
a
a
a
a
a
a
"}
(20,1,1) = {"
a
a
a
a
a
a
a
a
a
a
a
a
a
f
f
f
O
a
a
f
f
f
V
a
a
g
N
N
f
a
a
a
a
a
a
a
a
a
a
a
a
a
a
a
a
a
a
a
a
a
"}
(21,1,1) = {"
a
a
a
a
a
a
a
a
a
a
a
a
a
e
e
e
e
a
a
B
B
y
e
a
a
y
y
y
e
a
a
a
a
a
a
a
a
a
a
a
a
a
a
a
a
a
a
a
a
a
"}
(22,1,1) = {"
a
a
a
a
a
a
a
a
a
a
a
a
a
e
e
e
e
a
a
B
G
B
e
a
a
e
e
e
e
a
a
a
a
a
a
a
a
a
a
a
a
a
a
a
a
a
a
a
a
a
"}
(23,1,1) = {"
a
a
a
a
a
a
a
a
a
a
a
a
a
O
f
O
O
a
a
N
F
N
f
a
a
f
f
P
f
a
a
a
a
a
a
a
a
a
a
a
a
a
a
a
a
a
a
a
a
a
"}
(24,1,1) = {"
a
a
a
a
a
a
a
a
a
a
a
a
a
f
O
f
O
a
a
D
h
f
D
a
a
P
f
P
f
a
a
a
a
a
a
a
a
a
a
a
a
a
a
a
a
a
a
a
a
a
"}
(25,1,1) = {"
a
a
a
a
a
a
a
a
a
a
a
a
a
a
a
a
a
a
a
a
a
a
a
a
a
a
a
a
a
a
a
a
a
a
a
a
a
a
a
a
a
a
a
a
a
a
a
a
a
a
"}
(26,1,1) = {"
a
a
a
a
a
a
a
a
a
a
a
a
a
a
a
a
a
a
a
a
a
a
a
a
a
a
a
a
a
a
a
a
a
a
a
a
a
a
a
a
a
a
a
a
a
a
a
a
a
a
"}
(27,1,1) = {"
a
a
a
a
a
a
a
a
a
a
a
a
a
a
a
a
a
a
a
a
a
a
a
a
a
a
a
a
a
a
a
a
a
a
a
a
a
a
a
a
a
a
a
a
a
a
a
a
a
a
"}
(28,1,1) = {"
a
a
a
a
a
a
a
a
a
a
a
a
a
a
a
a
a
a
a
a
a
a
a
a
a
a
a
a
a
a
a
a
a
a
a
a
a
a
a
a
a
a
a
a
a
a
a
a
a
a
"}
(29,1,1) = {"
a
a
a
a
a
a
a
a
a
a
a
a
a
a
a
a
a
a
a
a
a
a
a
a
a
a
a
a
a
a
a
a
a
a
a
a
a
a
a
a
a
a
a
a
a
a
a
a
a
a
"}
(30,1,1) = {"
a
a
a
a
a
a
a
a
a
a
a
a
a
a
a
a
a
a
a
a
a
a
a
a
a
a
a
a
a
a
a
a
a
a
a
a
a
a
a
a
a
a
a
a
a
a
a
a
a
a
"}
(31,1,1) = {"
a
a
a
a
a
a
a
a
a
a
a
a
a
a
a
a
a
a
a
a
a
a
a
a
a
a
a
a
a
a
a
a
a
a
a
a
a
a
a
a
a
a
a
a
a
a
a
a
a
a
"}
(32,1,1) = {"
a
a
a
a
a
a
a
a
a
a
a
a
a
a
a
a
a
a
a
a
a
a
a
a
a
a
a
a
a
a
a
a
a
a
a
a
a
a
a
a
a
a
a
a
a
a
a
a
a
a
"}
(33,1,1) = {"
a
a
a
a
a
a
a
a
a
a
a
a
a
a
a
a
a
a
a
a
a
a
a
a
a
a
a
a
a
a
a
a
a
a
a
a
a
a
a
a
a
a
a
a
a
a
a
a
a
a
"}
(34,1,1) = {"
a
a
a
a
a
a
a
a
a
a
a
a
a
a
a
a
a
a
a
a
a
a
a
a
a
a
a
a
a
a
a
a
a
a
a
a
a
a
a
a
a
a
a
a
a
a
a
a
a
a
"}
(35,1,1) = {"
a
a
a
a
a
a
a
a
a
a
a
a
a
a
a
a
a
a
a
a
a
a
a
a
a
a
a
a
a
a
a
a
a
a
a
a
a
a
a
a
a
a
a
a
a
a
a
a
a
a
"}
(36,1,1) = {"
a
a
a
a
a
a
a
a
a
a
a
a
a
a
a
a
a
a
a
a
a
a
a
a
a
a
a
a
a
a
a
a
a
a
a
a
a
a
a
a
a
a
a
a
a
a
a
a
a
a
"}
(37,1,1) = {"
a
a
a
a
a
a
a
a
a
a
a
a
a
a
a
a
a
a
a
a
a
a
a
a
a
a
a
a
a
a
a
a
a
a
a
a
a
a
a
a
a
a
a
a
a
a
a
a
a
a
"}
(38,1,1) = {"
a
a
a
a
a
a
a
a
a
a
a
a
a
a
a
a
a
a
a
a
a
a
a
a
a
a
a
a
a
a
a
a
a
a
a
a
a
a
a
a
a
a
a
a
a
a
a
a
a
a
"}
(39,1,1) = {"
a
a
a
a
a
a
a
a
a
a
a
a
a
a
a
a
a
a
a
a
a
a
a
a
a
a
a
a
a
a
a
a
a
a
a
a
a
a
a
a
a
a
a
a
a
a
a
a
a
a
"}
(40,1,1) = {"
a
a
a
a
a
a
a
a
a
a
a
a
a
a
a
a
a
a
a
a
a
a
a
a
a
a
a
a
a
a
a
a
a
a
a
a
a
a
a
a
a
a
a
a
a
a
a
a
a
a
"}
(41,1,1) = {"
a
a
a
a
a
a
a
a
a
a
a
a
a
a
a
a
a
a
a
a
a
a
a
a
a
a
a
a
a
a
a
a
a
a
a
a
a
a
a
a
a
a
a
a
a
a
a
a
a
a
"}
(42,1,1) = {"
a
a
a
a
a
a
a
a
a
a
a
a
a
a
a
a
a
a
a
a
a
a
a
a
a
a
a
a
a
a
a
a
a
a
a
a
a
a
a
a
a
a
a
a
a
a
a
a
a
a
"}
(43,1,1) = {"
a
a
a
a
a
a
a
a
a
a
a
a
a
a
a
a
a
a
a
a
a
a
a
a
a
a
a
a
a
a
a
a
a
a
a
a
a
a
a
a
a
a
a
a
a
a
a
a
a
a
"}
(44,1,1) = {"
a
a
a
a
a
a
a
a
a
a
a
a
a
a
a
a
a
a
a
a
a
a
a
a
a
a
a
a
a
a
a
a
a
a
a
a
a
a
a
a
a
a
a
a
a
a
a
a
a
a
"}
(45,1,1) = {"
a
a
a
a
a
a
a
a
a
a
a
a
a
a
a
a
a
a
a
a
a
a
a
a
a
a
a
a
a
a
a
a
a
a
a
a
a
a
a
a
a
a
a
a
a
a
a
a
a
a
"}
(46,1,1) = {"
a
a
a
a
a
a
a
a
a
a
a
a
a
a
a
a
a
a
a
a
a
a
a
a
a
a
a
a
a
a
a
a
a
a
a
a
a
a
a
a
a
a
a
a
a
a
a
a
a
a
"}
(47,1,1) = {"
a
a
a
a
a
a
a
a
a
a
a
a
a
a
a
a
a
a
a
a
a
a
a
a
a
a
a
a
a
a
a
a
a
a
a
a
a
a
a
a
a
a
a
a
a
a
a
a
a
a
"}
(48,1,1) = {"
a
a
a
a
a
a
a
a
a
a
a
a
a
a
a
a
a
a
a
a
a
a
a
a
a
a
a
a
a
a
a
a
a
a
a
a
a
a
a
a
a
a
a
a
a
a
a
a
a
a
"}
(49,1,1) = {"
a
a
a
a
a
a
a
a
a
a
a
a
a
a
a
a
a
a
a
a
a
a
a
a
a
a
a
a
a
a
a
a
a
a
a
a
a
a
a
a
a
a
a
a
a
a
a
a
a
a
"}
(50,1,1) = {"
a
a
a
a
a
a
a
a
a
a
a
a
a
a
a
a
a
a
a
a
a
a
a
a
a
a
a
a
a
a
a
a
a
a
a
a
a
a
a
a
a
a
a
a
a
a
a
a
a
a
"}
