//MAP CONVERTED BY dmm2tgm.py THIS HEADER COMMENT PREVENTS RECONVERSION, DO NOT REMOVE
"a" = (
/turf/simulated/wall/wood,
/area/away_mission/iceland/iceland_inside)
"b" = (
/obj/structure/bookcase,
/turf/simulated/floor/wood,
/area/away_mission/iceland/iceland_inside)
"c" = (
/obj/structure/bed/chair/wood,
/turf/simulated/floor/wood,
/area/away_mission/iceland/iceland_inside)
"d" = (
/obj/structure/table/woodentable,
/obj/item/weapon/flame/candle,
/turf/simulated/floor/wood,
/area/away_mission/iceland/iceland_inside)
"e" = (
/obj/structure/coatrack,
/turf/simulated/floor/wood,
/area/away_mission/iceland/iceland_inside)
"f" = (
/turf/simulated/floor/wood,
/area/away_mission/iceland/iceland_inside)
"g" = (
/obj/structure/bed,
/turf/simulated/floor/wood,
/area/away_mission/iceland/iceland_inside)
"h" = (
/obj/structure/simple_door/wood,
/turf/simulated/floor/wood,
/area/away_mission/iceland/iceland_inside)

(1,1,1) = {"
a
a
a
a
a
a
"}
(2,1,1) = {"
a
b
f
f
g
a
"}
(3,1,1) = {"
a
c
f
f
f
a
"}
(4,1,1) = {"
a
d
f
f
f
a
"}
(5,1,1) = {"
a
e
f
f
f
h
"}
(6,1,1) = {"
a
a
a
a
a
a
"}
