//MAP CONVERTED BY dmm2tgm.py THIS HEADER COMMENT PREVENTS RECONVERSION, DO NOT REMOVE
"as" = (
/obj/effect/floor_decal/corner/orange{
	dir = 9
	},
/obj/machinery/light{
	dir = 8
	},
/turf/simulated/floor/exoplanet/tiled,
/area/ouerea_autakh)
"aR" = (
/obj/machinery/button/remote/blast_door{
	name = "Compound Gates";
	pixel_y = 25;
	id = "autakh_base_entry";
	req_access = list(228)
	},
/obj/machinery/light{
	dir = 8
	},
/obj/structure/bed/stool/chair/office/dark{
	dir = 4
	},
/turf/simulated/floor/exoplanet/wood{
	temperature = 298.15
	},
/area/ouerea_autakh)
"bb" = (
/obj/effect/floor_decal/corner/orange{
	dir = 9
	},
/obj/effect/floor_decal/corner/orange{
	dir = 10
	},
/obj/structure/table/rack,
/obj/item/storage/toolbox/electrical,
/obj/item/storage/toolbox/mechanical,
/obj/item/saddle,
/obj/item/saddle,
/turf/simulated/floor/exoplanet/tiled,
/area/ouerea_autakh)
"be" = (
/obj/structure/bed/stool/chair/sofa/pew/right,
/turf/simulated/floor/exoplanet/marble/dark,
/area/ouerea_autakh)
"bp" = (
/turf/simulated/floor/exoplanet/grass{
	temperature = 298.15
	},
/area/ouerea_autakh)
"bx" = (
/obj/structure/table/wood,
/obj/machinery/door/window/brigdoor{
	req_access = list(217);
	dir = 8
	},
/turf/simulated/floor/exoplanet/wood{
	temperature = 298.15
	},
/area/ouerea_autakh)
"ds" = (
/obj/machinery/optable,
/turf/simulated/floor/exoplanet/marble,
/area/ouerea_autakh)
"dP" = (
/obj/machinery/light,
/turf/simulated/floor/exoplanet/wood{
	temperature = 298.15
	},
/area/ouerea_autakh)
"eF" = (
/obj/structure/simple_door/wood,
/turf/simulated/floor/exoplanet/tiled,
/area/ouerea_autakh)
"eX" = (
/obj/structure/table/wood,
/obj/structure/window/reinforced{
	dir = 4
	},
/turf/simulated/floor/exoplanet/wood{
	temperature = 298.15
	},
/area/ouerea_autakh)
"fc" = (
/obj/effect/floor_decal/corner/orange{
	dir = 9
	},
/obj/structure/table/rack,
/obj/item/storage/belt/utility,
/obj/item/storage/belt/utility,
/obj/item/storage/belt/utility,
/obj/item/storage/belt/utility,
/turf/simulated/floor/exoplanet/tiled,
/area/ouerea_autakh)
"fF" = (
/obj/effect/floor_decal/corner/orange{
	dir = 6
	},
/turf/simulated/floor/exoplanet/tiled,
/area/ouerea_autakh)
"gY" = (
/obj/effect/floor_decal/corner/orange{
	dir = 6
	},
/obj/machinery/light{
	dir = 4;
	status = 2
	},
/turf/simulated/floor/exoplanet/tiled,
/area/ouerea_autakh)
"iy" = (
/turf/simulated/wall/wood,
/area/ouerea_autakh)
"iC" = (
/obj/machinery/vending/dinnerware,
/turf/simulated/floor/exoplanet/wood{
	temperature = 298.15
	},
/area/ouerea_autakh)
"iF" = (
/obj/structure/closet/secure_closet/guncabinet{
	req_access = list(228)
	},
/obj/item/storage/box/shotgunshells,
/obj/item/gun/projectile/shotgun/doublebarrel,
/turf/simulated/floor/exoplanet/wood{
	temperature = 298.15
	},
/area/ouerea_autakh)
"jc" = (
/obj/machinery/light,
/turf/simulated/floor/exoplanet/marble,
/area/ouerea_autakh)
"kd" = (
/turf/simulated/floor/exoplanet/wood{
	temperature = 298.15
	},
/area/ouerea_autakh)
"lh" = (
/obj/structure/bed,
/obj/item/bedsheet/brown,
/obj/structure/curtain/open/bed,
/turf/simulated/floor/exoplanet/wood{
	temperature = 298.15
	},
/area/ouerea_autakh)
"lZ" = (
/obj/machinery/light{
	dir = 8
	},
/turf/simulated/floor/exoplanet/marble/dark,
/area/ouerea_autakh)
"mv" = (
/turf/simulated/wall/marble,
/area/ouerea_autakh)
"nO" = (
/obj/machinery/appliance/cooker/stove,
/obj/machinery/light,
/turf/simulated/floor/exoplanet/wood{
	temperature = 298.15
	},
/area/ouerea_autakh)
"op" = (
/obj/machinery/light{
	dir = 8
	},
/turf/simulated/floor/exoplanet/wood{
	temperature = 298.15
	},
/area/ouerea_autakh)
"ox" = (
/obj/structure/table/stone/marble,
/obj/item/clothing/gloves/yellow/specialu,
/obj/item/clothing/gloves/yellow/specialu,
/obj/item/clothing/gloves/yellow/specialu,
/turf/simulated/floor/exoplanet/marble,
/area/ouerea_autakh)
"oK" = (
/obj/effect/floor_decal/corner/orange{
	dir = 5
	},
/obj/machinery/autolathe,
/turf/simulated/floor/exoplanet/tiled,
/area/ouerea_autakh)
"pC" = (
/obj/machinery/portable_atmospherics/hydroponics/soil,
/turf/simulated/floor/exoplanet/grass{
	temperature = 298.15
	},
/area/ouerea_autakh)
"pU" = (
/obj/structure/table/stone/marble,
/obj/item/storage/box/fancy/tray,
/turf/simulated/floor/exoplanet/marble,
/area/ouerea_autakh)
"qq" = (
/obj/structure/table/rack,
/obj/random/sword,
/turf/simulated/floor/exoplanet/wood{
	temperature = 298.15
	},
/area/ouerea_autakh)
"qE" = (
/obj/structure/closet/secure_closet/guncabinet{
	req_access = list(228)
	},
/obj/item/gun/projectile/shotgun/pump/rifle/scope,
/obj/item/ammo_casing/a762,
/obj/item/ammo_casing/a762,
/obj/item/ammo_casing/a762,
/obj/item/ammo_casing/a762,
/obj/item/ammo_casing/a762,
/obj/item/ammo_casing/a762,
/obj/item/ammo_casing/a762,
/obj/item/ammo_casing/a762,
/obj/item/ammo_casing/a762,
/obj/item/ammo_casing/a762,
/turf/simulated/floor/exoplanet/wood{
	temperature = 298.15
	},
/area/ouerea_autakh)
"ro" = (
/obj/structure/table/wood,
/obj/machinery/door/window/brigdoor{
	req_access = list(217);
	dir = 4
	},
/turf/simulated/floor/exoplanet/wood{
	temperature = 298.15
	},
/area/ouerea_autakh)
"rQ" = (
/obj/structure/bed/stool/chair/sofa/pew/left,
/turf/simulated/floor/exoplanet/marble/dark,
/area/ouerea_autakh)
"to" = (
/obj/structure/closet/secure_closet/guncabinet{
	req_access = list(228)
	},
/obj/random/civgun,
/obj/random/civgun,
/turf/simulated/floor/exoplanet/wood{
	temperature = 298.15
	},
/area/ouerea_autakh)
"tz" = (
/obj/structure/closet/secure_closet/guncabinet{
	req_access = list(228)
	},
/obj/item/melee/hammer/powered,
/obj/machinery/light{
	dir = 8
	},
/turf/simulated/floor/exoplanet/wood{
	temperature = 298.15
	},
/area/ouerea_autakh)
"tO" = (
/obj/structure/table/wood,
/obj/structure/window/reinforced{
	dir = 8
	},
/turf/simulated/floor/exoplanet/wood{
	temperature = 298.15
	},
/area/ouerea_autakh)
"ut" = (
/turf/simulated/floor/exoplanet/tiled,
/area/ouerea_autakh)
"uw" = (
/obj/structure/table/stone/marble,
/obj/item/flame/candle,
/obj/item/nullrod/shaman,
/turf/simulated/floor/exoplanet/marble,
/area/ouerea_autakh)
"xe" = (
/obj/effect/floor_decal/corner/orange{
	dir = 9
	},
/obj/effect/floor_decal/corner/orange{
	dir = 5
	},
/obj/structure/mech_wreckage,
/turf/simulated/floor/exoplanet/tiled,
/area/ouerea_autakh)
"xl" = (
/obj/structure/table/rack,
/obj/item/clothing/accessory/holster/armpit,
/obj/item/clothing/accessory/holster/armpit,
/obj/item/clothing/accessory/holster/armpit,
/turf/simulated/floor/exoplanet/wood{
	temperature = 298.15
	},
/area/ouerea_autakh)
"xL" = (
/obj/machinery/button/remote/blast_door{
	name = "Compound Gates";
	pixel_y = 25;
	id = "autakh_base_entry";
	req_access = list(228)
	},
/obj/machinery/light{
	dir = 4;
	status = 2
	},
/obj/structure/bed/stool/chair/office/dark{
	dir = 8
	},
/turf/simulated/floor/exoplanet/wood{
	temperature = 298.15
	},
/area/ouerea_autakh)
"yt" = (
/obj/structure/blocker/steel/fence{
	dir = 4
	},
/turf/simulated/floor/exoplanet/grass{
	temperature = 298.15
	},
/area/ouerea_autakh)
"zK" = (
/obj/machinery/light{
	dir = 4
	},
/turf/simulated/floor/exoplanet/marble/dark,
/area/ouerea_autakh)
"Ai" = (
/obj/structure/table/stone/marble,
/turf/simulated/floor/exoplanet/wood{
	temperature = 298.15
	},
/area/ouerea_autakh)
"Av" = (
/obj/effect/floor_decal/corner/orange{
	dir = 9
	},
/turf/simulated/floor/exoplanet/tiled,
/area/ouerea_autakh)
"AS" = (
/obj/structure/table/standard,
/obj/machinery/chemical_dispenser/bar_soft{
	dir = 1
	},
/obj/machinery/light,
/turf/simulated/floor/exoplanet/wood{
	temperature = 298.15
	},
/area/ouerea_autakh)
"Bd" = (
/obj/structure/bed,
/obj/item/bedsheet/brown,
/obj/structure/curtain/open/bed,
/obj/effect/ghostspawpoint{
	name = "igs - ouerea_autakh";
	identifier = "ouerea_autakh"
	},
/turf/simulated/floor/exoplanet/wood{
	temperature = 298.15
	},
/area/ouerea_autakh)
"Bt" = (
/obj/structure/table/wood,
/turf/simulated/floor/exoplanet/wood{
	temperature = 298.15
	},
/area/ouerea_autakh)
"CH" = (
/obj/machinery/light{
	dir = 1
	},
/turf/simulated/floor/exoplanet/wood{
	temperature = 298.15
	},
/area/ouerea_autakh)
"Dd" = (
/obj/effect/floor_decal/corner/orange{
	dir = 6
	},
/obj/effect/floor_decal/corner/orange{
	dir = 5
	},
/obj/machinery/mech_recharger,
/turf/simulated/floor/exoplanet/tiled,
/area/ouerea_autakh)
"DJ" = (
/obj/structure/closet/crate/autakh,
/obj/item/organ/internal/augment/farseer_eye,
/obj/item/organ/internal/augment/protein_valve,
/obj/item/organ/internal/augment/venomous_rest,
/obj/item/organ/internal/augment/calf_override,
/obj/item/organ/external/arm/autakh,
/obj/item/organ/external/arm/right/autakh,
/obj/item/organ/external/leg/autakh,
/obj/item/organ/external/leg/right/autakh,
/obj/item/organ/external/leg/right/autakh,
/obj/item/organ/external/leg/autakh,
/obj/item/organ/external/arm/autakh,
/obj/item/organ/external/arm/right/autakh,
/obj/item/organ/external/hand/right/autakh/medical,
/obj/item/organ/external/hand/right/autakh/security,
/obj/item/organ/external/hand/right/autakh/tool/mining,
/obj/item/organ/external/hand/right/autakh/tool,
/turf/simulated/floor/exoplanet/marble,
/area/ouerea_autakh)
"Fo" = (
/obj/structure/simple_door/wood,
/turf/simulated/floor/exoplanet/wood{
	temperature = 298.15
	},
/area/ouerea_autakh)
"Gq" = (
/obj/structure/blocker/steel/fence,
/turf/simulated/floor/exoplanet/grass{
	temperature = 298.15
	},
/area/ouerea_autakh)
"Hk" = (
/turf/simulated/wall,
/area/ouerea_autakh)
"Jc" = (
/obj/structure/closet/secure_closet/freezer/meat,
/obj/item/reagent_containers/food/snacks/meat,
/obj/item/reagent_containers/food/snacks/meat,
/obj/item/reagent_containers/food/snacks/meat,
/obj/item/reagent_containers/food/snacks/meat,
/obj/item/reagent_containers/food/snacks/meat,
/obj/item/reagent_containers/food/snacks/meat,
/obj/item/reagent_containers/food/snacks/meat,
/obj/item/reagent_containers/food/snacks/meat,
/obj/item/reagent_containers/food/snacks/meat,
/obj/item/reagent_containers/food/snacks/fish/fishfillet,
/obj/item/reagent_containers/food/snacks/fish/fishfillet,
/obj/item/reagent_containers/food/snacks/fish/fishfillet,
/obj/item/reagent_containers/food/snacks/fish/fishfillet,
/obj/item/reagent_containers/food/snacks/fish/fishfillet,
/obj/item/reagent_containers/food/snacks/fish/fishfillet,
/turf/simulated/floor/exoplanet/wood{
	temperature = 298.15
	},
/area/ouerea_autakh)
"Kq" = (
/turf/simulated/floor/exoplanet/water/shallow{
	temperature = 298.15
	},
/area/ouerea_autakh)
"KG" = (
/obj/structure/table/rack,
/obj/random/firstaid,
/obj/random/firstaid,
/turf/simulated/floor/exoplanet/wood{
	temperature = 298.15
	},
/area/ouerea_autakh)
"Lc" = (
/obj/effect/floor_decal/corner/orange{
	dir = 5
	},
/obj/structure/table/steel,
/obj/item/storage/bible{
	icon_state = "book10";
	item_state = "book10";
	name = "Rituals and Regiments of the Ancient Mador";
	desc = "Coming from radicalized and sidelined views of former warriors, the Aut'akh are a religious commune of cybernetically-augmented Unathi. They live in the relative safety \ of their communes scattered across various towns, planets, and systems, though have yet to truly attain their perfect leaderless society, as their own supposedly-defeated prejudice \ still runs in quiet circles within communes. Meanwhile, society often rebukes and ridicules these fanatical trans-speciests. Their lives are gently guided by the shamans or \"paradigms,\" \ which sometimes act as the biomechanical engineers of these groups. The Aut'akh believe that spirits inhabit all things, much like the Th'akh religion. However, they also believe the flesh's \ weakness hampers the soul, thus evil spirits can manipulate people's minds and souls to commit evil acts. These malicious spirits are given power within a being when the person succumbs to greed, \ anger, or other emotional vices. Aut'akh preach that the Contact War was the result of sinta being so misled by evil spirits that they brought the world to ruin, and all power, whether a government, \ religion, or corporation, is inherently corrupt due to the influence of evil spirits."
	},
/turf/simulated/floor/exoplanet/tiled,
/area/ouerea_autakh)
"LR" = (
/turf/simulated/floor/exoplanet/marble,
/area/ouerea_autakh)
"LV" = (
/obj/structure/closet/cabinet,
/obj/item/clothing/under/unathi,
/obj/item/clothing/under/unathi,
/obj/item/clothing/under/unathi/himation,
/obj/item/clothing/under/unathi/himation,
/obj/item/clothing/under/unathi/zozo{
	color = "4a5bcf"
	},
/obj/item/clothing/suit/unathi/robe/beige,
/obj/item/clothing/accessory/poncho/unathimantle{
	color = "2a2b2c"
	},
/obj/item/clothing/gloves/brown/tajara,
/obj/item/storage/bible{
	icon_state = "book10";
	item_state = "book10";
	name = "Rituals and Regiments of the Ancient Mador";
	desc = "Coming from radicalized and sidelined views of former warriors, the Aut'akh are a religious commune of cybernetically-augmented Unathi. They live in the relative safety \ of their communes scattered across various towns, planets, and systems, though have yet to truly attain their perfect leaderless society, as their own supposedly-defeated prejudice \ still runs in quiet circles within communes. Meanwhile, society often rebukes and ridicules these fanatical trans-speciests. Their lives are gently guided by the shamans or \"paradigms,\" \ which sometimes act as the biomechanical engineers of these groups. The Aut'akh believe that spirits inhabit all things, much like the Th'akh religion. However, they also believe the flesh's \ weakness hampers the soul, thus evil spirits can manipulate people's minds and souls to commit evil acts. These malicious spirits are given power within a being when the person succumbs to greed, \ anger, or other emotional vices. Aut'akh preach that the Contact War was the result of sinta being so misled by evil spirits that they brought the world to ruin, and all power, whether a government, \ religion, or corporation, is inherently corrupt due to the influence of evil spirits."
	},
/obj/item/clothing/shoes/sandals/caligae,
/obj/item/clothing/shoes/sandals/caligae,
/turf/simulated/floor/exoplanet/wood{
	temperature = 298.15
	},
/area/ouerea_autakh)
"Mj" = (
/obj/machinery/vending/boozeomat/merchant,
/turf/simulated/floor/exoplanet/wood{
	temperature = 298.15
	},
/area/ouerea_autakh)
"Nm" = (
/obj/effect/floor_decal/corner/orange{
	dir = 6
	},
/obj/effect/floor_decal/corner/orange{
	dir = 10
	},
/obj/structure/table/rack,
/obj/item/stack/nanopaste,
/turf/simulated/floor/exoplanet/tiled,
/area/ouerea_autakh)
"Nr" = (
/obj/structure/bed/stool/bar/padded/red,
/turf/simulated/floor/exoplanet/wood{
	temperature = 298.15
	},
/area/ouerea_autakh)
"OC" = (
/obj/machinery/light{
	dir = 4
	},
/turf/simulated/floor/exoplanet/wood{
	temperature = 298.15
	},
/area/ouerea_autakh)
"OY" = (
/mob/living/simple_animal/threshbeast,
/turf/simulated/floor/exoplanet/grass{
	temperature = 298.15
	},
/area/ouerea_autakh)
"Pa" = (
/obj/machinery/recharger/wallcharger{
	pixel_x = 32;
	pixel_y = 4
	},
/obj/machinery/recharger/wallcharger{
	pixel_x = 32;
	pixel_y = -8
	},
/turf/simulated/floor/exoplanet/wood{
	temperature = 298.15
	},
/area/ouerea_autakh)
"Pn" = (
/obj/structure/closet/cabinet,
/obj/item/clothing/under/unathi/huytai,
/obj/item/clothing/under/unathi/zozo{
	color = "4a5bcf"
	},
/obj/item/clothing/suit/unathi/robe/beige,
/obj/item/clothing/accessory/poncho/unathimantle{
	color = "2a2b2c"
	},
/obj/item/clothing/accessory/poncho/unathimantle{
	color = "2a2b2c"
	},
/obj/item/clothing/gloves/brown/tajara,
/obj/item/storage/bible{
	icon_state = "book10";
	item_state = "book10";
	name = "Rituals and Regiments of the Ancient Mador";
	desc = "Coming from radicalized and sidelined views of former warriors, the Aut'akh are a religious commune of cybernetically-augmented Unathi. They live in the relative safety \ of their communes scattered across various towns, planets, and systems, though have yet to truly attain their perfect leaderless society, as their own supposedly-defeated prejudice \ still runs in quiet circles within communes. Meanwhile, society often rebukes and ridicules these fanatical trans-speciests. Their lives are gently guided by the shamans or \"paradigms,\" \ which sometimes act as the biomechanical engineers of these groups. The Aut'akh believe that spirits inhabit all things, much like the Th'akh religion. However, they also believe the flesh's \ weakness hampers the soul, thus evil spirits can manipulate people's minds and souls to commit evil acts. These malicious spirits are given power within a being when the person succumbs to greed, \ anger, or other emotional vices. Aut'akh preach that the Contact War was the result of sinta being so misled by evil spirits that they brought the world to ruin, and all power, whether a government, \ religion, or corporation, is inherently corrupt due to the influence of evil spirits."
	},
/obj/item/clothing/shoes/sandals/caligae,
/obj/item/clothing/shoes/sandals/caligae,
/turf/simulated/floor/exoplanet/wood{
	temperature = 298.15
	},
/area/ouerea_autakh)
"Qy" = (
/obj/structure/table/rack,
/obj/random/custom_ka,
/turf/simulated/floor/exoplanet/wood{
	temperature = 298.15
	},
/area/ouerea_autakh)
"QJ" = (
/obj/structure/table/stone/marble,
/obj/item/flame/candle,
/obj/item/device/versebook/autakh,
/obj/item/device/versebook/autakh,
/obj/item/device/versebook/autakh,
/obj/item/device/versebook/autakh,
/obj/item/device/versebook/autakh,
/obj/item/device/versebook/autakh,
/turf/simulated/floor/exoplanet/marble,
/area/ouerea_autakh)
"SL" = (
/obj/machinery/appliance/cooker/oven,
/turf/simulated/floor/exoplanet/wood{
	temperature = 298.15
	},
/area/ouerea_autakh)
"Th" = (
/obj/structure/table/stone/marble,
/obj/item/storage/toolbox/mechanical,
/turf/simulated/floor/exoplanet/marble,
/area/ouerea_autakh)
"UL" = (
/turf/simulated/floor/exoplanet/barren{
	temperature = 298.15
	},
/area/ouerea_autakh)
"Vb" = (
/turf/simulated/floor/exoplanet/marble/dark,
/area/ouerea_autakh)
"Wz" = (
/obj/effect/floor_decal/corner/orange{
	dir = 6
	},
/obj/structure/table/rack,
/obj/item/stack/material/steel/full,
/obj/item/stack/material/glass/full,
/obj/item/stack/material/wood/full,
/turf/simulated/floor/exoplanet/tiled,
/area/ouerea_autakh)
"Xg" = (
/obj/machinery/door/blast/shutters{
	id = "autakh_base_entry"
	},
/turf/simulated/floor/exoplanet/barren{
	temperature = 298.15
	},
/area/ouerea_autakh)
"Zc" = (
/obj/structure/simple_door/wood,
/turf/simulated/floor/exoplanet/marble/dark,
/area/ouerea_autakh)
"Zd" = (
/obj/structure/table/stone/marble,
/obj/item/clothing/gloves/latex/nitrile/unathi,
/obj/item/clothing/gloves/latex/nitrile/unathi,
/obj/item/clothing/gloves/latex/nitrile/unathi,
/turf/simulated/floor/exoplanet/marble,
/area/ouerea_autakh)

(1,1,1) = {"
bp
bp
bp
bp
bp
bp
bp
bp
bp
bp
bp
bp
bp
bp
bp
bp
bp
bp
bp
bp
bp
bp
bp
bp
bp
bp
bp
bp
bp
bp
bp
bp
"}
(2,1,1) = {"
bp
bp
bp
bp
bp
bp
bp
bp
bp
bp
bp
bp
bp
bp
bp
bp
bp
bp
bp
bp
bp
bp
bp
bp
bp
bp
bp
bp
bp
bp
bp
bp
"}
(3,1,1) = {"
bp
bp
Hk
Gq
Gq
Gq
Gq
Gq
Gq
Gq
Gq
Gq
Gq
Gq
Gq
Gq
Gq
Gq
Gq
Gq
Gq
Gq
Gq
Gq
Gq
Gq
Gq
Gq
Gq
Hk
bp
bp
"}
(4,1,1) = {"
bp
bp
yt
bp
bp
bp
bp
bp
bp
bp
bp
bp
bp
bp
bp
bp
bp
bp
bp
bp
bp
bp
bp
bp
bp
bp
bp
bp
bp
yt
bp
bp
"}
(5,1,1) = {"
bp
bp
yt
bp
iy
iy
iy
iy
iy
iy
iy
bp
bp
bp
bp
bp
bp
bp
bp
iy
iy
iy
iy
iy
iy
iy
iy
iy
bp
yt
bp
bp
"}
(6,1,1) = {"
bp
bp
yt
bp
iy
xe
Av
as
fc
bb
iy
bp
bp
bp
bp
bp
bp
bp
bp
iy
kd
op
qq
xl
Qy
tz
qE
iy
bp
yt
bp
bp
"}
(7,1,1) = {"
bp
bp
yt
bp
iy
oK
ut
ut
ut
ut
eF
UL
UL
UL
UL
UL
UL
UL
UL
Fo
kd
kd
kd
kd
kd
kd
kd
iy
bp
yt
bp
bp
"}
(8,1,1) = {"
bp
bp
yt
bp
iy
Lc
ut
ut
ut
ut
eF
UL
UL
bp
bp
bp
bp
bp
bp
iy
kd
Pa
qq
KG
KG
to
iF
iy
bp
yt
bp
bp
"}
(9,1,1) = {"
bp
bp
yt
bp
iy
Dd
fF
gY
Wz
Nm
iy
bp
UL
bp
bp
bp
bp
bp
bp
iy
iy
iy
iy
iy
iy
iy
iy
iy
bp
yt
bp
bp
"}
(10,1,1) = {"
bp
bp
yt
bp
iy
iy
iy
iy
iy
iy
iy
bp
UL
bp
pC
bp
pC
bp
bp
bp
bp
bp
bp
bp
bp
bp
bp
bp
bp
yt
bp
bp
"}
(11,1,1) = {"
bp
bp
yt
bp
bp
bp
bp
bp
bp
bp
bp
bp
UL
bp
pC
bp
pC
bp
bp
mv
mv
mv
mv
mv
mv
mv
mv
mv
bp
yt
bp
bp
"}
(12,1,1) = {"
bp
bp
yt
Hk
Hk
Hk
Hk
bp
bp
bp
bp
bp
UL
bp
pC
bp
pC
bp
mv
mv
lZ
Vb
Vb
Vb
lZ
DJ
Zd
mv
bp
yt
bp
bp
"}
(13,1,1) = {"
bp
bp
yt
Hk
aR
kd
Fo
bp
bp
bp
bp
bp
UL
bp
pC
bp
pC
bp
mv
Vb
rQ
Vb
rQ
Vb
LR
LR
LR
mv
bp
yt
bp
bp
"}
(14,1,1) = {"
bp
bp
yt
Hk
ro
eX
Hk
bp
bp
bp
bp
bp
UL
bp
bp
bp
bp
bp
mv
Vb
be
Vb
be
Vb
LR
QJ
LR
mv
bp
yt
bp
bp
"}
(15,1,1) = {"
bp
bp
Xg
UL
UL
UL
Xg
bp
bp
bp
bp
bp
UL
bp
bp
bp
bp
bp
mv
Vb
Vb
Vb
Vb
LR
LR
pU
LR
mv
bp
yt
bp
bp
"}
(16,1,1) = {"
bp
bp
Xg
UL
UL
UL
Xg
UL
UL
UL
UL
UL
UL
UL
UL
UL
UL
UL
Zc
Vb
Vb
Vb
Vb
LR
LR
ds
jc
mv
bp
yt
bp
bp
"}
(17,1,1) = {"
bp
bp
Xg
UL
UL
UL
Xg
bp
bp
bp
bp
bp
UL
bp
bp
bp
bp
UL
mv
Vb
Vb
Vb
Vb
LR
LR
Th
LR
mv
bp
yt
bp
bp
"}
(18,1,1) = {"
bp
bp
yt
Hk
bx
tO
Hk
bp
bp
bp
bp
bp
UL
bp
bp
bp
bp
UL
mv
Vb
rQ
Vb
rQ
Vb
LR
uw
LR
mv
bp
yt
bp
bp
"}
(19,1,1) = {"
bp
bp
yt
Hk
xL
kd
Fo
bp
bp
iy
iy
iy
Fo
iy
iy
iy
bp
UL
mv
Vb
be
Vb
be
Vb
LR
LR
LR
mv
bp
yt
bp
bp
"}
(20,1,1) = {"
bp
bp
yt
Hk
Hk
Hk
Hk
bp
bp
iy
lh
kd
kd
kd
lh
iy
bp
UL
mv
mv
zK
Vb
Vb
Vb
zK
LR
ox
mv
bp
yt
bp
bp
"}
(21,1,1) = {"
bp
bp
yt
bp
bp
bp
bp
bp
bp
iy
iy
kd
kd
kd
iy
iy
bp
UL
bp
mv
mv
mv
mv
mv
mv
mv
mv
mv
bp
yt
bp
bp
"}
(22,1,1) = {"
bp
bp
yt
Kq
bp
OY
bp
bp
bp
iy
Bd
kd
kd
kd
Bd
iy
bp
UL
bp
bp
bp
bp
bp
bp
bp
bp
bp
bp
bp
yt
bp
bp
"}
(23,1,1) = {"
bp
bp
yt
bp
Kq
bp
Kq
bp
bp
iy
iy
CH
kd
dP
iy
iy
bp
UL
bp
iy
iy
iy
iy
iy
iy
iy
iy
iy
bp
yt
bp
bp
"}
(24,1,1) = {"
bp
bp
yt
bp
Kq
Kq
Kq
Kq
bp
iy
Bd
kd
kd
kd
Bd
iy
bp
UL
bp
iy
kd
kd
kd
kd
Ai
kd
SL
iy
bp
yt
bp
bp
"}
(25,1,1) = {"
bp
bp
yt
Kq
Kq
Kq
Kq
bp
bp
iy
iy
kd
kd
kd
iy
iy
bp
UL
bp
iy
CH
Nr
Bt
Nr
Ai
kd
nO
iy
bp
yt
bp
bp
"}
(26,1,1) = {"
bp
bp
yt
bp
Kq
Kq
Kq
OY
bp
iy
LV
kd
OC
kd
Pn
iy
bp
UL
UL
Fo
kd
Nr
Bt
Nr
Ai
kd
Mj
iy
bp
yt
bp
bp
"}
(27,1,1) = {"
bp
bp
yt
bp
Kq
Kq
Kq
bp
bp
iy
iy
iy
iy
iy
iy
iy
bp
bp
bp
iy
CH
Nr
Bt
Nr
Ai
kd
AS
iy
bp
yt
bp
bp
"}
(28,1,1) = {"
bp
bp
yt
bp
Kq
Kq
Kq
Kq
bp
bp
bp
bp
bp
bp
bp
bp
bp
bp
bp
iy
iC
kd
kd
kd
kd
kd
Jc
iy
bp
yt
bp
bp
"}
(29,1,1) = {"
bp
bp
yt
bp
bp
bp
bp
bp
Kq
bp
bp
bp
bp
bp
bp
bp
bp
bp
bp
iy
iy
iy
iy
iy
iy
iy
iy
iy
bp
yt
bp
bp
"}
(30,1,1) = {"
bp
bp
Hk
Gq
Gq
Gq
Gq
Gq
Gq
Gq
Gq
Gq
Gq
Gq
Gq
Gq
Gq
Gq
Gq
Gq
Gq
Gq
Gq
Gq
Gq
Gq
Gq
Gq
Gq
Hk
bp
bp
"}
(31,1,1) = {"
bp
bp
bp
bp
bp
bp
bp
bp
bp
bp
bp
bp
bp
bp
bp
bp
bp
bp
bp
bp
bp
bp
bp
bp
bp
bp
bp
bp
bp
bp
bp
bp
"}
(32,1,1) = {"
bp
bp
bp
bp
bp
bp
bp
bp
bp
bp
bp
bp
bp
bp
bp
bp
bp
bp
bp
bp
bp
bp
bp
bp
bp
bp
bp
bp
bp
bp
bp
bp
"}
