//MAP CONVERTED BY dmm2tgm.py THIS HEADER COMMENT PREVENTS RECONVERSION, DO NOT REMOVE
"a" = (
/turf/simulated/floor/exoplanet/grass{
	temperature = 298.15
	},
/area/exoplanet/ouerea)
"p" = (
/mob/living/simple_animal/otzek,
/turf/simulated/floor/exoplanet/grass{
	temperature = 298.15
	},
/area/exoplanet/ouerea)
"s" = (
/turf/template_noop,
/area/exoplanet/ouerea)
"A" = (
/obj/structure/flora/tree/jungle/small/random,
/turf/simulated/floor/exoplanet/grass{
	temperature = 298.15
	},
/area/exoplanet/ouerea)
"T" = (
/obj/structure/flora/grass/junglegrass/random,
/mob/living/simple_animal/otzek,
/turf/simulated/floor/exoplanet/grass{
	temperature = 298.15
	},
/area/exoplanet/ouerea)
"U" = (
/obj/structure/flora/grass/junglegrass/random,
/turf/simulated/floor/exoplanet/grass{
	temperature = 298.15
	},
/area/exoplanet/ouerea)

(1,1,1) = {"
s
s
s
a
a
a
a
a
s
s
s
s
s
s
s
s
"}
(2,1,1) = {"
s
s
a
a
a
a
a
a
a
a
a
s
s
s
s
s
"}
(3,1,1) = {"
s
s
a
a
a
a
A
a
U
a
a
a
a
s
s
s
"}
(4,1,1) = {"
s
a
a
a
U
U
a
a
p
a
a
a
a
a
a
s
"}
(5,1,1) = {"
s
a
a
p
a
U
U
a
a
a
a
a
A
a
a
s
"}
(6,1,1) = {"
s
a
U
a
a
a
a
U
T
a
a
a
a
a
a
s
"}
(7,1,1) = {"
s
a
a
p
a
a
a
a
U
U
U
a
a
a
a
s
"}
(8,1,1) = {"
s
s
a
a
a
a
a
a
a
a
a
a
a
a
s
s
"}
(9,1,1) = {"
s
s
a
a
a
p
a
a
a
p
a
a
a
a
s
s
"}
(10,1,1) = {"
s
s
a
a
U
a
a
a
a
a
a
T
U
a
s
s
"}
(11,1,1) = {"
s
a
A
a
a
a
a
a
a
U
T
a
a
a
s
s
"}
(12,1,1) = {"
s
a
a
a
p
a
a
U
U
U
a
a
a
a
a
s
"}
(13,1,1) = {"
s
a
a
a
a
a
a
T
a
a
a
a
a
a
a
s
"}
(14,1,1) = {"
s
a
a
a
a
a
a
a
a
a
a
a
a
a
s
s
"}
(15,1,1) = {"
s
s
a
a
a
a
a
a
a
A
a
a
a
s
s
s
"}
(16,1,1) = {"
s
s
s
s
s
a
a
a
a
a
a
a
s
s
s
s
"}
