//MAP CONVERTED BY dmm2tgm.py THIS HEADER COMMENT PREVENTS RECONVERSION, DO NOT REMOVE
"aH" = (
/obj/effect/decal/cleanable/dirt,
/obj/effect/decal/cleanable/dirt,
/obj/structure/bed/stool/chair/shuttle,
/obj/effect/decal/cleanable/dirt,
/obj/effect/decal/cleanable/dirt,
/turf/simulated/floor/airless/ceiling,
/area/template_noop)
"aL" = (
/obj/effect/decal/cleanable/dirt,
/obj/effect/decal/cleanable/dirt,
/obj/effect/decal/cleanable/dirt,
/obj/item/weldingtool/hugetank,
/turf/template_noop,
/area/template_noop)
"ck" = (
/obj/effect/decal/cleanable/dirt,
/obj/machinery/atmospherics/pipe/manifold/visible{
	dir = 1;
	pixel_x = 8;
	pixel_y = 2
	},
/obj/effect/decal/cleanable/dirt,
/turf/simulated/floor/tiled/white/airless,
/area/template_noop)
"co" = (
/obj/item/pipe{
	dir = 10
	},
/obj/effect/decal/cleanable/dirt,
/obj/effect/decal/cleanable/dirt,
/obj/random/plushie,
/turf/simulated/floor/airless,
/area/template_noop)
"dh" = (
/obj/effect/decal/cleanable/dirt,
/obj/effect/map_effect/window_spawner/full/shuttle{
	color = "#6C7364";
	frame_color = "#6C7364";
	spawn_firedoor = 1;
	spawn_grille = 1
	},
/turf/simulated/floor/airless,
/area/template_noop)
"dF" = (
/obj/effect/decal/cleanable/dirt,
/obj/effect/decal/cleanable/dirt,
/obj/item/material/shard{
	pixel_x = 10;
	pixel_y = -10
	},
/obj/item/material/shard{
	icon_state = "small"
	},
/turf/template_noop,
/area/template_noop)
"dQ" = (
/obj/item/material/shard,
/obj/effect/decal/cleanable/dirt,
/turf/template_noop,
/area/template_noop)
"fE" = (
/obj/effect/decal/cleanable/dirt,
/obj/effect/decal/cleanable/dirt,
/turf/template_noop,
/area/template_noop)
"gb" = (
/obj/effect/decal/cleanable/dirt,
/obj/effect/decal/cleanable/dirt,
/obj/structure/bed/stool/chair/shuttle{
	dir = 1
	},
/obj/effect/decal/cleanable/dirt,
/obj/effect/decal/cleanable/dirt,
/turf/simulated/floor/tiled/white/airless,
/area/template_noop)
"gj" = (
/obj/item/spacecash/c10,
/turf/template_noop,
/area/template_noop)
"gu" = (
/obj/structure/railing/mapped{
	dir = 4
	},
/obj/effect/decal/cleanable/dirt,
/obj/effect/decal/cleanable/dirt,
/turf/template_noop,
/area/template_noop)
"hw" = (
/obj/effect/decal/cleanable/dirt,
/obj/effect/decal/cleanable/dirt,
/obj/effect/decal/cleanable/dirt,
/obj/structure/grille/broken,
/obj/structure/grille/diagonal,
/obj/item/material/shard{
	pixel_x = 9;
	pixel_y = -7
	},
/obj/item/material/shard{
	icon_state = "small"
	},
/obj/effect/decal/cleanable/dirt,
/obj/effect/decal/cleanable/dirt,
/obj/effect/decal/cleanable/dirt,
/turf/simulated/floor/airless,
/area/template_noop)
"kU" = (
/obj/machinery/atmospherics/unary/engine{
	dir = 4
	},
/turf/simulated/floor/airless,
/area/template_noop)
"la" = (
/obj/effect/decal/cleanable/dirt,
/obj/effect/decal/cleanable/dirt,
/obj/effect/decal/cleanable/dirt,
/obj/structure/bed/stool/chair/shuttle,
/obj/effect/decal/cleanable/dirt,
/obj/random/junk,
/turf/simulated/floor/tiled/white/airless,
/area/template_noop)
"lv" = (
/obj/effect/decal/cleanable/dirt,
/obj/effect/decal/cleanable/dirt,
/obj/effect/map_effect/window_spawner/full/shuttle{
	color = "#6C7364";
	frame_color = "#6C7364";
	spawn_firedoor = 1;
	spawn_grille = 1
	},
/turf/simulated/floor/airless,
/area/template_noop)
"lA" = (
/obj/item/material/shard{
	icon_state = "small"
	},
/obj/effect/decal/cleanable/dirt,
/turf/template_noop,
/area/template_noop)
"lR" = (
/obj/effect/decal/cleanable/dirt,
/obj/structure/railing/mapped{
	dir = 1
	},
/obj/effect/decal/cleanable/dirt,
/obj/effect/decal/cleanable/dirt,
/turf/template_noop,
/area/template_noop)
"nM" = (
/turf/simulated/wall/shuttle/raider,
/area/template_noop)
"pA" = (
/obj/effect/decal/cleanable/dirt,
/obj/effect/decal/cleanable/dirt,
/obj/random/gift,
/turf/simulated/floor/tiled/white/airless,
/area/template_noop)
"qI" = (
/obj/effect/decal/cleanable/dirt,
/obj/effect/decal/cleanable/dirt,
/obj/effect/decal/cleanable/dirt,
/obj/machinery/floodlight{
	dir = 1
	},
/obj/random/powercell,
/turf/simulated/floor/tiled/white/airless,
/area/template_noop)
"rE" = (
/turf/unsimulated/mineral/asteroid,
/area/template_noop)
"rK" = (
/obj/item/clothing/wrists/watch/pocketwatch,
/turf/template_noop,
/area/template_noop)
"rY" = (
/obj/effect/decal/cleanable/dirt,
/obj/random/junk,
/turf/template_noop,
/area/template_noop)
"sW" = (
/turf/simulated/mineral/random/high_chance,
/area/template_noop)
"uW" = (
/obj/effect/decal/cleanable/dirt,
/obj/effect/decal/cleanable/dirt,
/obj/random/coin,
/turf/simulated/floor/airless,
/area/template_noop)
"vo" = (
/obj/effect/decal/cleanable/dirt,
/obj/effect/decal/cleanable/dirt,
/obj/effect/decal/cleanable/dirt,
/obj/item/modular_computer/console{
	dir = 8
	},
/obj/effect/decal/cleanable/dirt,
/obj/effect/decal/cleanable/dirt,
/obj/effect/decal/cleanable/dirt,
/obj/effect/decal/cleanable/dirt,
/obj/item/spacecash/c100,
/turf/simulated/floor/airless,
/area/template_noop)
"vS" = (
/mob/living/simple_animal/hostile/gnat,
/turf/template_noop,
/area/template_noop)
"xK" = (
/obj/effect/decal/cleanable/dirt,
/obj/effect/decal/cleanable/dirt,
/obj/effect/decal/cleanable/dirt,
/obj/machinery/atmospherics/pipe/manifold/visible{
	pixel_x = 8;
	pixel_y = 3
	},
/obj/item/ammo_magazine/c45m{
	pixel_x = -9;
	pixel_y = 6
	},
/obj/item/ammo_magazine/c45m,
/turf/simulated/floor/tiled/white/airless,
/area/template_noop)
"xS" = (
/obj/effect/decal/cleanable/dirt,
/obj/effect/decal/cleanable/dirt,
/obj/item/material/shard{
	pixel_x = 18;
	pixel_y = 4
	},
/turf/template_noop,
/area/template_noop)
"xX" = (
/obj/effect/decal/cleanable/dirt,
/obj/effect/decal/cleanable/dirt,
/obj/effect/decal/cleanable/dirt,
/obj/effect/decal/cleanable/dirt,
/obj/random/gift,
/turf/simulated/floor/tiled/white/airless,
/area/template_noop)
"AN" = (
/obj/effect/decal/cleanable/dirt,
/obj/effect/decal/cleanable/dirt,
/obj/machinery/portable_atmospherics/canister/carbon_dioxide{
	start_pressure = 1298.5
	},
/obj/effect/decal/cleanable/dirt,
/turf/simulated/floor/tiled/white/airless,
/area/template_noop)
"Bu" = (
/obj/effect/decal/cleanable/dirt,
/obj/machinery/shipsensors/weak,
/obj/effect/decal/cleanable/dirt,
/obj/structure/railing/mapped,
/obj/effect/decal/cleanable/dirt,
/turf/template_noop,
/area/template_noop)
"Du" = (
/obj/effect/decal/cleanable/dirt,
/obj/item/modular_computer/console{
	dir = 1
	},
/obj/effect/decal/cleanable/dirt,
/obj/effect/decal/cleanable/dirt,
/obj/effect/decal/cleanable/dirt,
/turf/simulated/floor/tiled/white/airless,
/area/template_noop)
"Dx" = (
/obj/effect/decal/cleanable/dirt,
/obj/structure/bed/stool/chair/office/bridge/pilot{
	dir = 4
	},
/obj/effect/decal/cleanable/dirt,
/obj/effect/decal/cleanable/dirt,
/obj/effect/decal/cleanable/dirt,
/obj/effect/decal/cleanable/dirt,
/obj/item/spacecash/c10,
/turf/simulated/floor/tiled/white/airless,
/area/template_noop)
"Dz" = (
/obj/item/material/shard,
/turf/template_noop,
/area/template_noop)
"DH" = (
/obj/effect/decal/cleanable/dirt,
/obj/effect/decal/cleanable/dirt,
/obj/item/modular_computer/console,
/obj/effect/decal/cleanable/dirt,
/obj/effect/decal/cleanable/dirt,
/turf/simulated/floor/tiled/white/airless,
/area/template_noop)
"FF" = (
/obj/effect/decal/cleanable/dirt,
/obj/effect/decal/cleanable/dirt,
/obj/structure/bed/stool/chair/office/bridge/pilot{
	dir = 4
	},
/obj/effect/decal/cleanable/dirt,
/obj/effect/decal/cleanable/dirt,
/obj/effect/decal/cleanable/dirt,
/obj/effect/decal/cleanable/dirt,
/obj/item/spacecash/c100,
/turf/simulated/floor/airless,
/area/template_noop)
"Hr" = (
/obj/effect/decal/cleanable/dirt,
/obj/effect/decal/cleanable/dirt,
/obj/effect/decal/cleanable/dirt,
/obj/machinery/atmospherics/portables_connector{
	dir = 8;
	pixel_x = 16;
	pixel_y = -4
	},
/obj/item/storage/field_ration,
/turf/simulated/floor/tiled/white/airless,
/area/template_noop)
"HN" = (
/obj/machinery/door/airlock/external{
	dir = 1
	},
/turf/simulated/floor/airless,
/area/template_noop)
"Ik" = (
/obj/item/pipe{
	dir = 9
	},
/obj/effect/decal/cleanable/dirt,
/obj/effect/decal/cleanable/dirt,
/obj/effect/decal/cleanable/dirt,
/obj/item/gun/energy/plasmacutter,
/turf/simulated/floor/tiled/white/airless,
/area/template_noop)
"Io" = (
/obj/effect/decal/cleanable/dirt,
/obj/effect/decal/cleanable/dirt,
/obj/effect/decal/cleanable/dirt,
/obj/effect/decal/cleanable/dirt,
/obj/item/shovel/gadpathur,
/obj/item/spacecash/c10,
/turf/simulated/floor/tiled/white/airless,
/area/template_noop)
"Is" = (
/obj/effect/decal/cleanable/dirt,
/obj/effect/decal/cleanable/dirt,
/obj/effect/decal/cleanable/dirt,
/obj/effect/decal/cleanable/dirt,
/obj/structure/grille/broken{
	pixel_y = 23
	},
/obj/structure/grille/diagonal{
	dir = 4;
	pixel_y = 9
	},
/obj/structure/grille/broken,
/obj/item/material/shard{
	pixel_x = 16;
	pixel_y = -3
	},
/obj/item/material/shard{
	icon_state = "small";
	pixel_x = -14;
	pixel_y = -10
	},
/obj/item/material/shard{
	icon_state = "small";
	pixel_x = -2;
	pixel_y = 9
	},
/obj/effect/decal/cleanable/dirt,
/obj/effect/decal/cleanable/dirt,
/obj/effect/decal/cleanable/dirt,
/turf/simulated/floor/airless,
/area/template_noop)
"KH" = (
/obj/effect/decal/cleanable/dirt,
/obj/effect/decal/cleanable/dirt,
/obj/structure/bed/stool/chair/shuttle{
	dir = 1
	},
/obj/effect/decal/cleanable/dirt,
/turf/simulated/floor/tiled/white/airless,
/area/template_noop)
"Lr" = (
/obj/effect/decal/cleanable/dirt,
/obj/structure/bed/stool/chair/shuttle{
	dir = 1
	},
/obj/random/junk,
/turf/simulated/floor/tiled/white/airless,
/area/template_noop)
"LE" = (
/obj/effect/decal/cleanable/dirt,
/obj/effect/decal/cleanable/dirt,
/obj/item/wrench,
/turf/template_noop,
/area/template_noop)
"MT" = (
/turf/template_noop,
/area/template_noop)
"MX" = (
/obj/effect/decal/cleanable/dirt,
/obj/effect/decal/cleanable/dirt,
/obj/item/storage/field_ration,
/turf/simulated/floor/tiled/white/airless,
/area/template_noop)
"OW" = (
/obj/item/spacecash/c1,
/turf/template_noop,
/area/template_noop)
"Qr" = (
/obj/effect/decal/cleanable/dirt,
/obj/effect/decal/cleanable/dirt,
/obj/structure/bed/stool/chair/shuttle{
	dir = 1
	},
/obj/effect/decal/cleanable/dirt,
/turf/simulated/floor/airless,
/area/template_noop)
"QR" = (
/obj/item/pipe{
	dir = 8
	},
/turf/simulated/wall/shuttle/raider,
/area/template_noop)
"RA" = (
/obj/effect/decal/cleanable/dirt,
/obj/effect/decal/cleanable/dirt,
/mob/living/simple_animal/hostile/gnat,
/obj/effect/decal/cleanable/dirt,
/turf/simulated/floor/tiled/white/airless,
/area/template_noop)
"RS" = (
/obj/effect/decal/cleanable/dirt,
/obj/machinery/portable_atmospherics/canister/carbon_dioxide{
	start_pressure = 2965.7
	},
/turf/simulated/floor/tiled/white/airless,
/area/template_noop)
"So" = (
/obj/effect/decal/cleanable/dirt,
/obj/effect/decal/cleanable/dirt,
/obj/effect/decal/cleanable/dirt,
/obj/random/coin,
/turf/simulated/floor/tiled/white/airless,
/area/template_noop)
"SG" = (
/obj/effect/decal/cleanable/dirt,
/obj/effect/decal/cleanable/dirt,
/obj/effect/decal/cleanable/dirt,
/turf/simulated/floor/tiled/white/airless,
/area/template_noop)
"SP" = (
/obj/item/clothing/head/helmet/space/santahat,
/turf/template_noop,
/area/template_noop)
"Tr" = (
/obj/machinery/atmospherics/portables_connector{
	dir = 8;
	pixel_x = 16;
	pixel_y = -4
	},
/obj/effect/decal/cleanable/dirt,
/obj/effect/decal/cleanable/dirt,
/obj/item/ammo_magazine/c45,
/turf/simulated/floor/airless,
/area/template_noop)
"TG" = (
/obj/effect/decal/cleanable/dirt,
/turf/template_noop,
/area/template_noop)
"VD" = (
/obj/effect/decal/cleanable/dirt,
/obj/effect/decal/cleanable/dirt,
/obj/item/modular_computer/console{
	dir = 8
	},
/obj/effect/decal/cleanable/dirt,
/obj/effect/decal/cleanable/dirt,
/obj/effect/decal/cleanable/dirt,
/obj/effect/decal/cleanable/dirt,
/turf/simulated/floor/airless,
/area/template_noop)
"VE" = (
/obj/effect/decal/cleanable/dirt,
/obj/effect/decal/cleanable/dirt,
/obj/effect/decal/cleanable/dirt,
/obj/effect/decal/cleanable/dirt,
/obj/effect/decal/cleanable/dirt,
/obj/random/coin,
/obj/item/spacecash/c10,
/turf/simulated/floor/airless,
/area/template_noop)
"YL" = (
/obj/effect/decal/cleanable/dirt,
/obj/effect/decal/cleanable/dirt,
/obj/effect/decal/cleanable/dirt,
/turf/template_noop,
/area/template_noop)

(1,1,1) = {"
MT
MT
MT
MT
MT
MT
MT
MT
MT
MT
MT
MT
fE
TG
TG
TG
TG
TG
TG
TG
MT
MT
MT
MT
MT
MT
MT
MT
MT
MT
MT
MT
"}
(2,1,1) = {"
MT
MT
MT
MT
MT
MT
MT
sW
rE
rE
rE
rE
TG
YL
YL
YL
YL
YL
YL
TG
sW
rE
rE
rE
rE
MT
MT
MT
MT
MT
MT
MT
"}
(3,1,1) = {"
MT
MT
MT
MT
MT
MT
MT
rE
sW
sW
rE
rE
TG
YL
YL
YL
YL
YL
fE
TG
MT
rE
rE
rE
rE
rE
rE
sW
MT
MT
MT
MT
"}
(4,1,1) = {"
MT
MT
MT
MT
MT
MT
rE
rE
sW
sW
rE
MT
fE
fE
fE
fE
fE
fE
fE
MT
MT
MT
MT
rE
rE
rE
rE
rE
MT
MT
MT
MT
"}
(5,1,1) = {"
MT
MT
MT
MT
MT
rE
rE
rE
sW
rE
MT
TG
TG
TG
TG
TG
TG
TG
TG
TG
TG
MT
MT
MT
rE
rE
rE
rE
rE
MT
MT
MT
"}
(6,1,1) = {"
MT
MT
MT
MT
MT
rE
rE
rE
rE
rE
MT
TG
TG
nM
kU
kU
kU
kU
nM
TG
TG
MT
MT
MT
rE
sW
sW
rE
rE
MT
MT
MT
"}
(7,1,1) = {"
MT
MT
MT
MT
rE
rE
rE
rE
rE
MT
MT
TG
TG
nM
QR
QR
QR
QR
nM
TG
TG
MT
MT
MT
rE
sW
sW
sW
rE
MT
MT
MT
"}
(8,1,1) = {"
MT
MT
MT
rE
rE
rE
rE
rE
rE
MT
MT
TG
TG
nM
co
xK
ck
Ik
nM
TG
TG
MT
MT
MT
rE
rE
rE
rE
rE
MT
MT
MT
"}
(9,1,1) = {"
MT
MT
sW
rE
rE
rE
rE
rE
MT
MT
MT
TG
TG
nM
AN
Hr
Tr
RS
nM
TG
TG
MT
MT
MT
rE
rE
rE
rE
rE
rE
MT
MT
"}
(10,1,1) = {"
MT
MT
rE
rE
rE
rE
rE
sW
MT
MT
MT
TG
TG
HN
MX
xX
pA
Lr
nM
fE
TG
TG
MT
MT
rE
rE
rE
sW
sW
rE
sW
MT
"}
(11,1,1) = {"
MT
rE
rE
rE
rE
rE
rE
MT
MT
MT
MT
TG
TG
HN
qI
uW
SG
Qr
nM
TG
TG
TG
MT
sW
rE
rE
sW
sW
sW
rE
sW
MT
"}
(12,1,1) = {"
MT
rE
rE
rE
rE
rE
MT
MT
MT
MT
MT
TG
TG
nM
la
RA
So
KH
nM
TG
rY
TG
MT
MT
rE
rE
rE
rE
rE
rE
MT
MT
"}
(13,1,1) = {"
MT
rE
rE
rE
rE
rE
rE
MT
MT
MT
MT
TG
TG
nM
aH
Io
VE
gb
nM
TG
TG
TG
MT
MT
MT
rE
rE
MT
MT
MT
MT
MT
"}
(14,1,1) = {"
MT
sW
rE
rE
rE
sW
sW
rE
MT
MT
MT
TG
TG
nM
DH
Dx
FF
Du
nM
TG
TG
TG
MT
MT
MT
MT
MT
MT
MT
MT
MT
MT
"}
(15,1,1) = {"
MT
SP
rE
rE
rE
sW
sW
rE
MT
MT
MT
TG
TG
nM
dh
vo
VD
lv
nM
TG
TG
TG
MT
MT
MT
MT
MT
MT
rE
sW
sW
MT
"}
(16,1,1) = {"
MT
MT
MT
rE
rE
rE
MT
MT
MT
MT
MT
TG
fE
TG
dh
Is
hw
lv
lR
fE
TG
TG
MT
MT
MT
MT
MT
rE
rE
rE
sW
MT
"}
(17,1,1) = {"
MT
rE
MT
MT
MT
MT
MT
MT
MT
MT
MT
MT
TG
rY
TG
xS
dF
fE
aL
fE
MT
MT
MT
MT
MT
MT
sW
sW
rE
rE
rE
MT
"}
(18,1,1) = {"
MT
rE
rE
MT
MT
MT
MT
rE
MT
MT
MT
MT
vS
MT
TG
TG
TG
LE
Bu
fE
TG
MT
MT
MT
MT
MT
sW
sW
rE
rE
rE
MT
"}
(19,1,1) = {"
MT
rE
rE
rE
rE
rE
rE
rE
MT
MT
MT
MT
MT
MT
gj
MT
MT
dQ
gu
TG
MT
MT
MT
MT
MT
rE
sW
rE
rE
rE
rE
MT
"}
(20,1,1) = {"
MT
rE
rE
rE
rE
rE
rE
rE
MT
MT
MT
MT
MT
MT
MT
Dz
MT
lA
TG
TG
MT
MT
MT
MT
rE
rE
rE
rE
rE
rE
MT
MT
"}
(21,1,1) = {"
MT
sW
sW
rE
rE
rE
rE
rE
MT
MT
MT
MT
MT
MT
MT
MT
MT
OW
MT
MT
MT
MT
MT
rE
rE
rE
rE
rE
rE
sW
MT
MT
"}
(22,1,1) = {"
MT
sW
MT
MT
rE
sW
rE
MT
MT
MT
MT
MT
MT
MT
Dz
MT
MT
MT
MT
Dz
MT
MT
rE
rE
rE
rE
rE
rE
rE
sW
MT
MT
"}
(23,1,1) = {"
MT
MT
MT
MT
MT
rE
rE
MT
MT
MT
sW
MT
MT
OW
MT
MT
MT
MT
MT
MT
MT
rE
rE
rE
rE
rE
rE
sW
rE
rE
MT
MT
"}
(24,1,1) = {"
MT
MT
MT
MT
rE
rE
rE
MT
MT
MT
rE
MT
MT
MT
MT
MT
MT
MT
MT
MT
rE
rE
rE
rE
rE
rE
rE
rE
rE
MT
MT
MT
"}
(25,1,1) = {"
MT
MT
rE
MT
rE
rE
rE
MT
MT
rE
rE
MT
MT
MT
MT
MT
MT
MT
MT
rE
rE
rE
rE
sW
rE
rE
rE
rE
rE
MT
MT
MT
"}
(26,1,1) = {"
MT
MT
rE
rE
rE
rE
rE
MT
rE
rE
rE
MT
MT
MT
MT
MT
rE
rE
rE
rE
rE
rE
rE
sW
rE
rE
rE
rE
rE
MT
MT
MT
"}
(27,1,1) = {"
MT
MT
rE
rE
rE
rE
rE
MT
rE
rE
rE
MT
MT
MT
rE
rE
rE
rE
rE
sW
sW
rE
rE
sW
sW
rE
rE
rE
rE
MT
MT
MT
"}
(28,1,1) = {"
MT
MT
MT
rE
rE
rE
rE
rE
rE
rE
rE
MT
rE
rE
rE
rE
rE
rE
rE
sW
sW
rE
rE
rE
rE
rE
rE
rE
rE
sW
MT
MT
"}
(29,1,1) = {"
MT
MT
rE
rE
sW
sW
rE
rE
MT
rE
MT
MT
rE
rE
sW
sW
rE
rE
rE
rE
rE
rE
rE
rE
rE
rE
rE
rE
MT
MT
MT
MT
"}
(30,1,1) = {"
MT
MT
rE
rE
rK
MT
MT
MT
MT
rE
sW
MT
rE
rE
sW
sW
rE
rE
rE
rE
rE
rE
rE
sW
MT
MT
MT
MT
MT
MT
MT
MT
"}
(31,1,1) = {"
MT
rE
rE
MT
MT
rE
rE
rE
rE
rE
MT
MT
rE
MT
MT
MT
MT
MT
MT
MT
MT
MT
MT
MT
MT
MT
MT
MT
MT
MT
MT
MT
"}
(32,1,1) = {"
MT
MT
MT
MT
MT
MT
MT
MT
sW
rE
rE
rE
MT
MT
MT
MT
MT
MT
MT
MT
MT
MT
MT
MT
MT
MT
MT
MT
MT
MT
MT
MT
"}
