//MAP CONVERTED BY dmm2tgm.py THIS HEADER COMMENT PREVENTS RECONVERSION, DO NOT REMOVE
"c" = (
/turf/simulated/floor/exoplanet/snow/cold,
/area/exoplanet/adhomai)
"k" = (
/obj/effect/decal/cleanable/acid_remnants,
/turf/simulated/floor/exoplanet/mineral/adhomai,
/area/exoplanet/adhomai)
"m" = (
/turf/simulated/floor/exoplanet/mineral/adhomai,
/area/exoplanet/adhomai)
"u" = (
/obj/structure/reagent_dispensers/acid_barrel,
/turf/simulated/floor/exoplanet/snow/cold,
/area/exoplanet/adhomai)
"x" = (
/obj/structure/flora/bush/adhomai,
/turf/simulated/floor/exoplanet/snow/cold,
/area/exoplanet/adhomai)
"A" = (
/obj/effect/decal/cleanable/acid_remnants,
/turf/simulated/floor/exoplanet/snow/cold,
/area/exoplanet/adhomai)
"M" = (
/obj/structure/flora/grass/adhomai,
/turf/simulated/floor/exoplanet/snow/cold,
/area/exoplanet/adhomai)
"X" = (
/obj/structure/flora/tree/adhomai,
/turf/simulated/floor/exoplanet/snow/cold,
/area/exoplanet/adhomai)

(1,1,1) = {"
c
c
c
c
c
c
c
c
c
c
c
c
c
c
c
c
c
c
c
c
c
c
c
c
c
c
c
c
c
X
c
c
"}
(2,1,1) = {"
c
c
X
c
c
c
c
c
c
X
c
c
c
c
c
c
c
c
c
c
c
M
c
c
c
c
c
c
c
c
c
c
"}
(3,1,1) = {"
c
c
c
c
c
X
c
c
c
c
c
c
X
c
c
c
c
c
X
c
c
c
c
c
c
c
c
c
c
c
c
c
"}
(4,1,1) = {"
c
c
c
c
c
c
c
c
c
c
c
c
c
c
c
c
c
c
c
c
c
x
c
c
c
c
X
c
c
c
c
c
"}
(5,1,1) = {"
c
X
c
c
c
c
c
c
c
c
c
c
c
c
c
c
c
c
c
u
c
c
c
c
c
c
c
c
c
c
c
c
"}
(6,1,1) = {"
c
c
c
c
c
c
c
c
c
c
c
u
c
c
c
c
c
A
c
c
c
c
c
c
c
c
c
c
c
c
c
c
"}
(7,1,1) = {"
c
c
c
c
X
c
c
c
c
c
c
c
c
c
c
c
c
c
c
c
c
c
c
c
c
c
c
c
c
c
c
X
"}
(8,1,1) = {"
c
c
c
c
c
c
c
c
c
c
c
c
c
M
c
c
c
c
c
c
c
c
c
x
c
c
c
c
c
c
c
c
"}
(9,1,1) = {"
c
c
c
c
c
c
c
c
c
c
c
c
x
c
c
c
c
c
c
c
X
c
c
c
c
c
c
c
X
c
c
c
"}
(10,1,1) = {"
c
c
c
c
c
c
c
c
A
c
c
c
c
c
c
c
A
c
c
c
c
c
c
c
u
c
c
c
c
c
c
c
"}
(11,1,1) = {"
c
c
c
u
c
c
c
c
c
c
c
c
c
c
c
c
c
c
c
c
c
c
c
c
c
c
c
c
c
c
c
c
"}
(12,1,1) = {"
c
c
c
c
c
c
c
c
c
c
c
c
c
c
c
m
c
c
c
c
c
c
c
c
c
c
X
c
c
c
c
c
"}
(13,1,1) = {"
c
c
c
c
c
c
c
c
M
c
c
c
m
m
m
m
m
m
c
c
c
c
c
c
c
c
c
c
c
c
c
c
"}
(14,1,1) = {"
c
X
c
c
c
c
A
c
c
c
c
m
m
k
m
m
m
k
c
c
c
X
c
c
c
c
c
c
c
c
c
c
"}
(15,1,1) = {"
c
c
c
c
c
c
c
c
c
c
m
m
m
m
m
m
m
m
m
m
c
c
c
c
c
c
c
c
c
x
c
c
"}
(16,1,1) = {"
c
c
c
c
X
c
c
c
c
c
c
m
m
m
m
m
m
m
m
m
c
c
c
c
c
c
c
c
c
c
c
c
"}
(17,1,1) = {"
c
c
c
c
c
c
c
c
x
c
c
m
m
m
m
m
m
A
c
c
c
c
c
c
c
c
c
c
c
c
c
c
"}
(18,1,1) = {"
c
c
c
c
c
c
c
c
c
c
c
c
c
m
m
m
c
c
c
c
c
c
c
c
c
X
c
c
c
c
c
c
"}
(19,1,1) = {"
c
c
c
c
c
c
c
c
c
c
A
c
c
m
m
m
c
c
c
c
c
c
c
c
c
c
c
c
c
c
c
c
"}
(20,1,1) = {"
c
c
c
c
c
M
c
c
c
c
c
c
c
c
m
m
c
x
c
c
c
c
c
c
c
c
c
c
c
c
c
c
"}
(21,1,1) = {"
c
c
c
X
c
c
c
c
c
c
c
c
c
m
m
c
c
c
c
c
c
A
c
c
c
c
c
c
c
c
x
c
"}
(22,1,1) = {"
c
c
c
c
c
c
c
A
c
c
c
c
c
c
c
c
c
c
c
c
c
c
c
c
c
c
c
c
c
c
c
c
"}
(23,1,1) = {"
c
c
c
c
c
c
c
c
c
c
c
c
c
c
c
c
c
c
c
c
c
c
x
c
c
c
c
c
c
c
c
c
"}
(24,1,1) = {"
c
c
c
c
c
c
c
c
c
c
c
c
c
c
c
c
c
c
c
c
c
c
c
c
c
c
X
c
c
c
X
c
"}
(25,1,1) = {"
c
c
c
c
M
c
c
x
c
c
c
A
c
c
c
c
c
X
c
c
c
c
c
c
c
c
c
c
c
c
c
c
"}
(26,1,1) = {"
c
c
c
c
c
c
c
c
c
c
c
c
c
c
c
c
c
c
c
c
c
c
c
c
c
c
c
c
c
c
c
c
"}
(27,1,1) = {"
c
c
c
c
c
c
c
c
u
c
c
c
c
c
c
c
c
c
c
c
c
c
c
c
c
c
c
c
c
c
c
c
"}
(28,1,1) = {"
c
c
c
c
c
X
c
c
c
c
c
c
X
c
c
c
M
c
c
c
c
A
c
c
c
c
c
c
c
c
c
c
"}
(29,1,1) = {"
c
c
c
c
c
c
c
c
c
c
c
c
c
c
u
c
c
c
c
c
c
c
c
c
c
c
c
c
c
X
c
c
"}
(30,1,1) = {"
c
c
c
c
c
c
c
c
c
c
c
c
c
c
c
c
c
c
c
c
c
c
c
c
c
c
c
c
c
c
c
c
"}
(31,1,1) = {"
c
c
c
c
c
c
c
c
c
x
c
c
c
c
c
c
c
c
c
c
x
c
c
c
c
u
c
c
c
c
c
c
"}
(32,1,1) = {"
c
c
c
c
c
c
c
c
c
c
c
c
c
c
c
c
c
c
c
c
c
c
c
c
c
c
c
c
c
c
c
c
"}
