//MAP CONVERTED BY dmm2tgm.py THIS HEADER COMMENT PREVENTS RECONVERSION, DO NOT REMOVE
"c" = (
/turf/simulated/floor/exoplanet/snow/cold,
/area/exoplanet/adhomai)
"j" = (
/mob/living/simple_animal/ice_tunneler/baby,
/turf/simulated/floor/exoplanet/snow/cold,
/area/exoplanet/adhomai)
"k" = (
/mob/living/simple_animal/ice_tunneler,
/turf/simulated/floor/exoplanet/snow/cold,
/area/exoplanet/adhomai)
"q" = (
/obj/structure/ice_tunneler_nest,
/turf/simulated/floor/exoplanet/snow/cold,
/area/exoplanet/adhomai)
"s" = (
/obj/structure/flora/grass/adhomai,
/turf/simulated/floor/exoplanet/snow/cold,
/area/exoplanet/adhomai)
"C" = (
/obj/structure/flora/rock/ice,
/turf/simulated/floor/exoplanet/snow/cold,
/area/exoplanet/adhomai)
"H" = (
/obj/structure/flora/bush/adhomai,
/turf/simulated/floor/exoplanet/snow/cold,
/area/exoplanet/adhomai)
"S" = (
/mob/living/simple_animal/ice_tunneler/male,
/turf/simulated/floor/exoplanet/snow/cold,
/area/exoplanet/adhomai)
"X" = (
/obj/structure/flora/tree/adhomai,
/turf/simulated/floor/exoplanet/snow/cold,
/area/exoplanet/adhomai)

(1,1,1) = {"
c
c
c
c
c
c
c
c
c
c
c
c
c
c
c
"}
(2,1,1) = {"
c
c
c
c
X
c
c
c
H
c
c
c
c
c
c
"}
(3,1,1) = {"
c
c
c
c
c
c
S
c
c
c
c
c
c
H
c
"}
(4,1,1) = {"
c
c
c
c
c
q
c
k
c
c
c
c
c
c
c
"}
(5,1,1) = {"
c
c
c
C
c
c
c
c
c
q
s
S
c
c
c
"}
(6,1,1) = {"
c
c
c
c
c
c
s
c
j
k
c
c
c
c
c
"}
(7,1,1) = {"
c
c
c
c
c
c
c
c
c
c
c
c
c
c
c
"}
(8,1,1) = {"
c
c
c
c
k
c
j
c
c
c
c
q
c
c
s
"}
(9,1,1) = {"
c
c
H
c
c
c
c
c
c
X
c
k
c
c
c
"}
(10,1,1) = {"
c
c
c
c
S
c
q
c
c
c
c
c
S
c
c
"}
(11,1,1) = {"
c
c
c
c
c
c
c
s
c
c
c
c
c
c
c
"}
(12,1,1) = {"
c
c
c
c
c
c
c
c
c
q
c
c
c
c
c
"}
(13,1,1) = {"
c
H
c
c
c
c
H
c
k
c
S
c
c
c
c
"}
(14,1,1) = {"
c
c
c
c
c
c
c
c
c
c
c
c
H
c
c
"}
(15,1,1) = {"
c
c
c
c
c
c
c
c
c
c
c
c
c
s
c
"}
