//MAP CONVERTED BY dmm2tgm.py THIS HEADER COMMENT PREVENTS RECONVERSION, DO NOT REMOVE
"aa" = (
/obj/machinery/door/airlock/security{
	name = "Checkpoint";
	req_access = list(209);
	dir = 4
	},
/turf/simulated/floor/concrete/square{
	temperature = 268.15
	},
/area/exoplanet/adhomai)
"am" = (
/obj/structure/closet/cabinet,
/obj/item/shovel,
/turf/simulated/floor/concrete/square{
	temperature = 268.15
	},
/area/exoplanet/adhomai)
"ds" = (
/obj/machinery/light,
/turf/simulated/floor/exoplanet/snow/cold,
/area/exoplanet/adhomai)
"ef" = (
/obj/item/reagent_containers/glass/bucket/wood{
	pixel_x = -3
	},
/obj/item/reagent_containers/glass/rag{
	pixel_x = 9
	},
/obj/structure/sign/flag/pra{
	pixel_y = 32;
	stand_icon = null
	},
/turf/simulated/floor/concrete/square{
	temperature = 268.15
	},
/area/exoplanet/adhomai)
"ev" = (
/obj/structure/sign/flag/pra{
	pixel_x = -32;
	stand_icon = null
	},
/turf/simulated/floor/exoplanet/snow/cold,
/area/exoplanet/adhomai)
"ew" = (
/obj/machinery/shower{
	dir = 1
	},
/obj/structure/curtain/open/shower,
/turf/simulated/floor/tiled/freezer{
	temperature = 268.15
	},
/area/exoplanet/adhomai)
"eS" = (
/obj/effect/decal/cleanable/dirt,
/obj/item/trash/cigbutt,
/turf/simulated/floor/concrete/square{
	temperature = 268.15
	},
/area/exoplanet/adhomai)
"eU" = (
/obj/structure/table/steel,
/obj/item/trash/can/adhomian_can,
/turf/simulated/floor/concrete{
	temperature = 268.15
	},
/area/exoplanet/adhomai)
"fq" = (
/obj/structure/table/steel,
/turf/simulated/floor/concrete{
	temperature = 268.15
	},
/area/exoplanet/adhomai)
"fZ" = (
/obj/structure/closet/cabinet,
/obj/item/clothing/under/color/orange,
/obj/item/clothing/under/color/orange,
/obj/item/clothing/under/color/orange,
/obj/item/clothing/under/color/orange,
/turf/simulated/floor/tiled/freezer{
	temperature = 268.15
	},
/area/exoplanet/adhomai)
"gm" = (
/obj/machinery/light/small{
	dir = 8
	},
/turf/simulated/floor/exoplanet/snow/cold,
/area/exoplanet/adhomai)
"gz" = (
/obj/machinery/vending/cigarette,
/obj/structure/sign/flag/pra/large/west{
	pixel_x = -32
	},
/turf/simulated/floor/concrete/square{
	temperature = 268.15
	},
/area/exoplanet/adhomai)
"hm" = (
/obj/effect/floor_decal/concrete,
/turf/simulated/floor/concrete{
	temperature = 268.15
	},
/area/exoplanet/adhomai)
"jg" = (
/turf/simulated/wall/concrete,
/area/exoplanet/adhomai)
"jr" = (
/obj/structure/bed/stool/chair/office/dark{
	dir = 4
	},
/turf/simulated/floor/concrete/square{
	temperature = 268.15
	},
/area/exoplanet/adhomai)
"ko" = (
/obj/machinery/door/window/brigdoor/northright{
	dir = 4;
	req_access = list(209)
	},
/obj/structure/table/steel,
/obj/item/paper_bin,
/obj/item/pen/black,
/obj/item/reagent_containers/food/drinks/drinkingglass/newglass/coffeecup/pra{
	pixel_y = 10;
	pixel_x = -5
	},
/turf/simulated/floor/concrete/square{
	temperature = 268.15
	},
/area/exoplanet/adhomai)
"kB" = (
/obj/structure/blocker/steel/fence{
	dir = 8
	},
/turf/simulated/floor/exoplanet/snow/cold,
/area/exoplanet/adhomai)
"kI" = (
/obj/effect/floor_decal/concrete{
	dir = 9
	},
/obj/effect/floor_decal/concrete{
	dir = 4
	},
/turf/simulated/floor/concrete{
	temperature = 268.15
	},
/area/exoplanet/adhomai)
"kJ" = (
/obj/structure/closet/cabinet,
/turf/simulated/floor/concrete/square{
	temperature = 268.15
	},
/area/exoplanet/adhomai)
"kO" = (
/obj/structure/window/reinforced{
	dir = 4;
	icon_state = "rwindow"
	},
/obj/structure/table/steel,
/obj/item/material/ashtray/bronze,
/obj/structure/sign/painting_frame/hadii{
	pixel_y = 32
	},
/obj/item/handcuffs,
/turf/simulated/floor/concrete/square{
	temperature = 268.15
	},
/area/exoplanet/adhomai)
"mf" = (
/obj/structure/bed/padded,
/obj/structure/curtain/open/bed,
/obj/structure/sign/painting_frame/hadii{
	pixel_y = 32
	},
/obj/effect/decal/cleanable/cobweb,
/turf/simulated/floor/concrete/square{
	temperature = 268.15
	},
/area/exoplanet/adhomai)
"mC" = (
/turf/simulated/floor/exoplanet/snow/cold,
/area/exoplanet/adhomai)
"mF" = (
/obj/effect/decal/cleanable/dirt,
/obj/structure/closet/secure_closet/guncabinet{
	req_access = list(209)
	},
/obj/effect/floor_decal/industrial/outline/security,
/obj/item/handcuffs,
/turf/simulated/floor/concrete/square{
	temperature = 268.15
	},
/area/exoplanet/adhomai)
"mR" = (
/obj/structure/sign/painting_frame/hadii{
	pixel_y = -32
	},
/obj/effect/floor_decal/concrete{
	dir = 10
	},
/turf/simulated/floor/concrete{
	temperature = 268.15
	},
/area/exoplanet/adhomai)
"ot" = (
/obj/machinery/light{
	dir = 1
	},
/turf/simulated/floor/exoplanet/snow/cold,
/area/exoplanet/adhomai)
"ov" = (
/obj/structure/hadii_statue/stone{
	outside = 1
	},
/obj/effect/floor_decal/concrete/large/full,
/turf/simulated/floor/concrete{
	temperature = 268.15
	},
/area/exoplanet/adhomai)
"pU" = (
/obj/effect/floor_decal/concrete{
	dir = 6
	},
/turf/simulated/floor/concrete{
	temperature = 268.15
	},
/area/exoplanet/adhomai)
"qm" = (
/obj/machinery/door/airlock/security{
	name = "Checkpoint";
	req_access = list(209);
	dir = 1
	},
/turf/simulated/floor/concrete/square{
	temperature = 268.15
	},
/area/exoplanet/adhomai)
"qI" = (
/obj/structure/sign/flag/pra/large/north{
	pixel_y = 32
	},
/turf/simulated/floor/exoplanet/snow/cold,
/area/exoplanet/adhomai)
"qW" = (
/obj/structure/blocker/steel/fence,
/turf/simulated/floor/exoplanet/snow/cold,
/area/exoplanet/adhomai)
"rf" = (
/obj/structure/closet/crate/freezer,
/obj/item/reagent_containers/food/snacks/liquidfood,
/obj/item/reagent_containers/food/snacks/liquidfood,
/obj/item/reagent_containers/food/snacks/liquidfood,
/obj/effect/floor_decal/concrete/large{
	dir = 8
	},
/turf/simulated/floor/concrete{
	temperature = 268.15
	},
/area/exoplanet/adhomai)
"rM" = (
/obj/machinery/light/small,
/turf/simulated/floor/concrete/square{
	temperature = 268.15
	},
/area/exoplanet/adhomai)
"sQ" = (
/obj/effect/floor_decal/concrete{
	dir = 8
	},
/turf/simulated/floor/concrete{
	temperature = 268.15
	},
/area/exoplanet/adhomai)
"sS" = (
/obj/effect/floor_decal/concrete{
	dir = 9
	},
/turf/simulated/floor/concrete{
	temperature = 268.15
	},
/area/exoplanet/adhomai)
"uc" = (
/obj/machinery/vending/coffee,
/obj/effect/decal/cleanable/dirt,
/turf/simulated/floor/concrete/square{
	temperature = 268.15
	},
/area/exoplanet/adhomai)
"uU" = (
/obj/effect/floor_decal/concrete{
	dir = 1
	},
/turf/simulated/floor/concrete{
	temperature = 268.15
	},
/area/exoplanet/adhomai)
"vw" = (
/obj/structure/closet/outhouse,
/turf/simulated/floor/exoplanet/snow/cold,
/area/exoplanet/adhomai)
"vB" = (
/obj/effect/floor_decal/concrete,
/obj/effect/floor_decal/concrete{
	dir = 8
	},
/turf/simulated/floor/concrete{
	temperature = 268.15
	},
/area/exoplanet/adhomai)
"wj" = (
/obj/structure/closet/cabinet,
/obj/machinery/light/small{
	dir = 4
	},
/obj/item/storage/bag/ore,
/turf/simulated/floor/concrete/square{
	temperature = 268.15
	},
/area/exoplanet/adhomai)
"wx" = (
/obj/effect/decal/cleanable/blood/splatter,
/obj/structure/sign/flag/pra{
	pixel_y = 32;
	stand_icon = null
	},
/turf/simulated/floor/concrete/square{
	temperature = 268.15
	},
/area/exoplanet/adhomai)
"wU" = (
/obj/item/clothing/suit/storage/tajaran/pra_jacket/armored,
/turf/simulated/floor/concrete/square{
	temperature = 268.15
	},
/area/exoplanet/adhomai)
"xc" = (
/obj/structure/railing/mapped{
	dir = 1
	},
/obj/effect/floor_decal/concrete/large{
	dir = 8
	},
/obj/effect/floor_decal/industrial/loading/yellow{
	dir = 4
	},
/turf/simulated/floor/concrete{
	temperature = 268.15
	},
/area/exoplanet/adhomai)
"xn" = (
/obj/structure/closet/cabinet,
/obj/item/clothing/under/color/orange,
/turf/simulated/floor/concrete/square{
	temperature = 268.15
	},
/area/exoplanet/adhomai)
"yd" = (
/obj/structure/sign/flag/pra{
	pixel_y = -32;
	stand_icon = null
	},
/turf/simulated/floor/exoplanet/snow/cold,
/area/exoplanet/adhomai)
"yA" = (
/obj/effect/floor_decal/concrete/large/cee{
	dir = 8
	},
/turf/simulated/floor/concrete{
	temperature = 268.15
	},
/area/exoplanet/adhomai)
"yV" = (
/obj/effect/floor_decal/concrete/large/cee{
	dir = 1
	},
/turf/simulated/floor/concrete{
	temperature = 268.15
	},
/area/exoplanet/adhomai)
"zf" = (
/turf/simulated/floor/concrete/square{
	temperature = 268.15
	},
/area/exoplanet/adhomai)
"zh" = (
/obj/structure/bed/padded,
/obj/structure/curtain/open/bed,
/obj/structure/sign/painting_frame/hadii{
	pixel_y = 32
	},
/obj/effect/decal/cleanable/cobweb2,
/turf/simulated/floor/concrete/square{
	temperature = 268.15
	},
/area/exoplanet/adhomai)
"zA" = (
/obj/machinery/button/remote/blast_door{
	id = "labor_entry";
	name = "Entry";
	req_access = list(209);
	pixel_y = 32
	},
/obj/effect/decal/cleanable/dirt,
/turf/simulated/floor/concrete/square{
	temperature = 268.15
	},
/area/exoplanet/adhomai)
"Aq" = (
/turf/simulated/floor/tiled/freezer{
	temperature = 268.15
	},
/area/exoplanet/adhomai)
"BP" = (
/obj/effect/floor_decal/concrete/large{
	dir = 8
	},
/turf/simulated/floor/concrete{
	temperature = 268.15
	},
/area/exoplanet/adhomai)
"BZ" = (
/obj/structure/table/steel,
/obj/item/trash/liquidfood,
/turf/simulated/floor/concrete{
	temperature = 268.15
	},
/area/exoplanet/adhomai)
"Cc" = (
/obj/structure/closet/secure_closet/guncabinet{
	req_access = list(209)
	},
/obj/effect/floor_decal/industrial/outline/security,
/obj/item/gun/projectile/shotgun/pump/rifle,
/obj/structure/sign/flag/pra{
	pixel_y = -32;
	stand_icon = null
	},
/turf/simulated/floor/concrete/square{
	temperature = 268.15
	},
/area/exoplanet/adhomai)
"Ci" = (
/obj/effect/floor_decal/concrete/large{
	dir = 1
	},
/turf/simulated/floor/concrete{
	temperature = 268.15
	},
/area/exoplanet/adhomai)
"Cw" = (
/obj/structure/closet/secure_closet/guncabinet{
	req_access = list(209)
	},
/obj/machinery/light/small{
	dir = 8
	},
/obj/effect/floor_decal/industrial/outline/security,
/obj/item/melee/baton/stunrod,
/turf/simulated/floor/concrete/square{
	temperature = 268.15
	},
/area/exoplanet/adhomai)
"DP" = (
/obj/structure/sign/painting_frame/hadii{
	pixel_y = 32
	},
/turf/simulated/floor/concrete/square{
	temperature = 268.15
	},
/area/exoplanet/adhomai)
"Fz" = (
/obj/structure/sign/painting_frame/hadii{
	pixel_y = 32
	},
/obj/effect/floor_decal/concrete{
	dir = 5
	},
/turf/simulated/floor/concrete{
	temperature = 268.15
	},
/area/exoplanet/adhomai)
"FM" = (
/obj/structure/flora/grass/brown,
/turf/simulated/floor/exoplanet/snow/cold,
/area/exoplanet/adhomai)
"Gu" = (
/turf/simulated/wall/wood,
/area/exoplanet/adhomai)
"GB" = (
/obj/structure/sign/flag/pra/large/west{
	pixel_x = -32
	},
/obj/effect/floor_decal/concrete{
	dir = 9
	},
/turf/simulated/floor/concrete{
	temperature = 268.15
	},
/area/exoplanet/adhomai)
"GR" = (
/obj/structure/table/rack,
/obj/machinery/light/small,
/obj/item/device/flashlight/lantern,
/turf/simulated/floor/concrete/square{
	temperature = 268.15
	},
/area/exoplanet/adhomai)
"Ht" = (
/obj/structure/table/rack,
/obj/item/storage/bag/ore,
/obj/item/storage/bag/ore,
/obj/item/storage/bag/ore,
/turf/simulated/floor/concrete/square{
	temperature = 268.15
	},
/area/exoplanet/adhomai)
"HM" = (
/turf/simulated/floor/concrete{
	temperature = 268.15
	},
/area/exoplanet/adhomai)
"HX" = (
/obj/structure/closet/cabinet,
/obj/item/pickaxe,
/turf/simulated/floor/concrete/square{
	temperature = 268.15
	},
/area/exoplanet/adhomai)
"Ic" = (
/obj/machinery/light/small{
	dir = 4
	},
/turf/simulated/floor/tiled/freezer{
	temperature = 268.15
	},
/area/exoplanet/adhomai)
"Iv" = (
/obj/structure/railing/mapped,
/obj/effect/floor_decal/concrete/large,
/obj/effect/floor_decal/industrial/loading/yellow{
	dir = 4
	},
/turf/simulated/floor/concrete{
	temperature = 268.15
	},
/area/exoplanet/adhomai)
"IM" = (
/obj/item/trash/can/adhomian_can,
/turf/simulated/floor/concrete/square{
	temperature = 268.15
	},
/area/exoplanet/adhomai)
"IO" = (
/obj/machinery/light{
	dir = 8
	},
/turf/simulated/floor/exoplanet/snow/cold,
/area/exoplanet/adhomai)
"Jb" = (
/obj/effect/decal/cleanable/dirt,
/turf/simulated/floor/tiled/freezer{
	temperature = 268.15
	},
/area/exoplanet/adhomai)
"KV" = (
/obj/structure/sign/flag/pra{
	pixel_y = 32;
	stand_icon = null
	},
/turf/simulated/floor/concrete/square{
	temperature = 268.15
	},
/area/exoplanet/adhomai)
"LT" = (
/obj/effect/floor_decal/concrete/large,
/turf/simulated/floor/concrete{
	temperature = 268.15
	},
/area/exoplanet/adhomai)
"Oa" = (
/obj/structure/closet/cabinet,
/obj/machinery/light/small{
	dir = 8
	},
/obj/effect/decal/cleanable/cobweb,
/turf/simulated/floor/concrete/square{
	temperature = 268.15
	},
/area/exoplanet/adhomai)
"Oc" = (
/obj/structure/bed/padded,
/obj/structure/curtain/open/bed,
/obj/structure/sign/painting_frame/hadii{
	pixel_y = 32
	},
/turf/simulated/floor/concrete/square{
	temperature = 268.15
	},
/area/exoplanet/adhomai)
"OA" = (
/obj/machinery/door/blast/shutters{
	id = "labor_entry"
	},
/obj/effect/floor_decal/concrete{
	dir = 6
	},
/turf/simulated/floor/concrete{
	temperature = 268.15
	},
/area/exoplanet/adhomai)
"Pa" = (
/obj/structure/table/rack,
/obj/item/pickaxe,
/obj/item/pickaxe,
/obj/effect/decal/cleanable/dirt,
/turf/simulated/floor/concrete/square{
	temperature = 268.15
	},
/area/exoplanet/adhomai)
"Pw" = (
/obj/structure/blocker/steel/fence{
	dir = 1
	},
/turf/simulated/floor/exoplanet/snow/cold,
/area/exoplanet/adhomai)
"Qe" = (
/obj/machinery/door/urban,
/turf/simulated/floor/concrete{
	temperature = 268.15
	},
/area/exoplanet/adhomai)
"Rh" = (
/obj/effect/floor_decal/concrete{
	dir = 5
	},
/turf/simulated/floor/concrete{
	temperature = 268.15
	},
/area/exoplanet/adhomai)
"Rw" = (
/obj/machinery/shower{
	pixel_y = 18
	},
/obj/structure/curtain/open/shower,
/turf/simulated/floor/tiled/freezer{
	temperature = 268.15
	},
/area/exoplanet/adhomai)
"Sg" = (
/obj/structure/bed/stool/bar/padded/brown,
/turf/simulated/floor/concrete{
	temperature = 268.15
	},
/area/exoplanet/adhomai)
"SK" = (
/obj/effect/floor_decal/concrete{
	dir = 1
	},
/obj/effect/floor_decal/concrete{
	dir = 8
	},
/turf/simulated/floor/concrete{
	temperature = 268.15
	},
/area/exoplanet/adhomai)
"Tp" = (
/obj/effect/decal/cleanable/dirt,
/obj/structure/sign/flag/pra{
	pixel_y = 32;
	stand_icon = null
	},
/obj/item/handcuffs,
/turf/simulated/floor/concrete/square{
	temperature = 268.15
	},
/area/exoplanet/adhomai)
"TD" = (
/obj/machinery/light/small{
	dir = 8
	},
/turf/simulated/floor/tiled/freezer{
	temperature = 268.15
	},
/area/exoplanet/adhomai)
"TQ" = (
/obj/structure/bed/padded,
/obj/structure/curtain/open/bed,
/obj/structure/sign/painting_frame/hadii{
	pixel_y = -32
	},
/turf/simulated/floor/concrete/square{
	temperature = 268.15
	},
/area/exoplanet/adhomai)
"Wa" = (
/obj/effect/decal/cleanable/dirt,
/turf/simulated/floor/concrete/square{
	temperature = 268.15
	},
/area/exoplanet/adhomai)
"WK" = (
/obj/effect/floor_decal/concrete{
	dir = 10
	},
/turf/simulated/floor/concrete{
	temperature = 268.15
	},
/area/exoplanet/adhomai)
"Xk" = (
/obj/machinery/light{
	dir = 4;
	status = 2
	},
/turf/simulated/floor/exoplanet/snow/cold,
/area/exoplanet/adhomai)
"Xv" = (
/obj/structure/sign/flag/pra{
	pixel_y = 32;
	stand_icon = null
	},
/turf/simulated/floor/exoplanet/snow/cold,
/area/exoplanet/adhomai)
"XT" = (
/obj/machinery/door/blast/shutters{
	id = "labor_entry"
	},
/turf/simulated/floor/concrete{
	temperature = 268.15
	},
/area/exoplanet/adhomai)
"Yc" = (
/obj/effect/floor_decal/concrete{
	dir = 8
	},
/obj/effect/floor_decal/concrete,
/turf/simulated/floor/concrete{
	temperature = 268.15
	},
/area/exoplanet/adhomai)
"Yn" = (
/obj/machinery/door/urban,
/turf/simulated/floor/concrete/square{
	temperature = 268.15
	},
/area/exoplanet/adhomai)
"YQ" = (
/obj/machinery/photocopier,
/turf/simulated/floor/concrete/square{
	temperature = 268.15
	},
/area/exoplanet/adhomai)
"YV" = (
/obj/structure/filingcabinet/chestdrawer,
/turf/simulated/floor/concrete/square{
	temperature = 268.15
	},
/area/exoplanet/adhomai)
"Zf" = (
/obj/effect/floor_decal/concrete/large/cee,
/turf/simulated/floor/concrete{
	temperature = 268.15
	},
/area/exoplanet/adhomai)
"Zi" = (
/obj/structure/closet/secure_closet/guncabinet{
	req_access = list(209)
	},
/obj/effect/floor_decal/industrial/outline/security,
/turf/simulated/floor/concrete/square{
	temperature = 268.15
	},
/area/exoplanet/adhomai)
"ZL" = (
/obj/effect/floor_decal/concrete/large{
	dir = 4
	},
/turf/simulated/floor/concrete{
	temperature = 268.15
	},
/area/exoplanet/adhomai)

(1,1,1) = {"
yd
jg
qW
qW
qW
qW
qW
qW
qW
qW
qW
qW
qW
qW
qW
qW
qW
qW
qW
qW
qW
qW
qW
qW
qW
qW
qW
qW
qW
qW
jg
Xv
"}
(2,1,1) = {"
mC
kB
mC
mC
mC
mC
mC
mC
mC
mC
mC
mC
mC
mC
mC
mC
mC
mC
mC
mC
mC
mC
mC
mC
ds
jg
jg
ot
mC
mC
kB
mC
"}
(3,1,1) = {"
mC
kB
mC
mC
mC
mC
mC
mC
mC
mC
mC
mC
mC
mC
mC
mC
mC
mC
mC
mC
mC
mC
mC
rf
sS
sS
GB
sS
LT
mC
kB
mC
"}
(4,1,1) = {"
mC
kB
mC
mC
vw
mC
mC
mC
mC
mC
mC
mC
mC
mC
mC
mC
mC
mC
mC
mC
mC
mC
mC
Rh
Sg
eU
fq
Sg
WK
mC
kB
mC
"}
(5,1,1) = {"
mC
kB
mC
mC
mC
mC
mC
mC
mC
mC
mC
mC
mC
mC
mC
mC
mC
mC
mC
mC
mC
mC
mC
Rh
Sg
fq
fq
Sg
WK
mC
kB
mC
"}
(6,1,1) = {"
mC
kB
mC
mC
mC
mC
mC
mC
mC
mC
mC
mC
mC
mC
mC
mC
mC
mC
mC
mC
mC
mC
Xk
Rh
Sg
fq
fq
Sg
WK
Xk
kB
mC
"}
(7,1,1) = {"
mC
kB
mC
mC
Gu
Gu
Gu
Gu
Gu
Gu
Xv
mC
mC
mC
mC
Gu
Gu
Gu
Gu
mC
mC
mC
jg
Fz
Sg
fq
fq
Sg
mR
jg
kB
mC
"}
(8,1,1) = {"
mC
kB
mC
mC
Gu
Oc
zf
Wa
zf
Yn
yV
kI
LT
mC
Gu
Gu
HX
am
Gu
Gu
mC
mC
IO
Rh
Sg
fq
fq
Sg
WK
IO
kB
mC
"}
(9,1,1) = {"
mC
kB
mC
mC
Gu
Gu
zf
rM
Gu
Gu
Xv
Rh
WK
yd
Gu
Oa
Wa
zf
Pa
Gu
mC
mC
mC
Rh
Sg
fq
BZ
Sg
WK
mC
kB
mC
"}
(10,1,1) = {"
mC
kB
mC
mC
Gu
Oc
zf
zf
TQ
Gu
mC
Rh
vB
Zf
Yn
zf
zf
zf
GR
Gu
mC
BP
sS
uU
Sg
fq
fq
Sg
WK
mC
kB
mC
"}
(11,1,1) = {"
mC
kB
mC
mC
Gu
Gu
wx
zf
Gu
Gu
mC
Rh
WK
yd
Gu
wj
Wa
Wa
Ht
Gu
mC
Rh
hm
pU
pU
pU
pU
pU
ZL
mC
kB
mC
"}
(12,1,1) = {"
mC
kB
mC
mC
Gu
Oc
Wa
zf
TQ
Gu
mC
Rh
WK
mC
Gu
Gu
kJ
xn
Gu
Gu
mC
Rh
WK
mC
mC
mC
mC
mC
mC
mC
kB
mC
"}
(13,1,1) = {"
mC
kB
mC
mC
Gu
Gu
zf
rM
Gu
Gu
mC
Rh
WK
mC
mC
Gu
Gu
Gu
Gu
mC
mC
Rh
WK
mC
mC
mC
mC
mC
mC
mC
kB
mC
"}
(14,1,1) = {"
mC
kB
mC
mC
Gu
zh
zf
zf
TQ
Gu
mC
Rh
WK
mC
mC
mC
mC
mC
mC
mC
mC
Rh
WK
mC
mC
mC
mC
mC
mC
mC
kB
mC
"}
(15,1,1) = {"
mC
kB
mC
mC
Gu
Gu
KV
Wa
Gu
Gu
mC
Rh
WK
yd
Gu
Gu
Gu
Gu
Gu
mC
mC
Rh
WK
mC
mC
mC
mC
mC
mC
mC
kB
mC
"}
(16,1,1) = {"
mC
kB
mC
mC
Gu
Oc
IM
zf
TQ
Gu
mC
Rh
Yc
Zf
Qe
Jb
TD
fZ
Gu
mC
mC
Rh
WK
mC
mC
jg
jg
jg
jg
mC
kB
mC
"}
(17,1,1) = {"
mC
kB
mC
mC
Gu
Gu
zf
rM
Gu
Gu
mC
Rh
WK
yd
Gu
Gu
Jb
Gu
Gu
mC
mC
Rh
WK
mC
mC
jg
Cw
mF
jg
jg
kB
mC
"}
(18,1,1) = {"
mC
kB
mC
mC
Gu
Oc
zf
zf
TQ
Gu
mC
Rh
WK
mC
Gu
Rw
Aq
ew
Gu
mC
mC
Rh
WK
yd
jg
jg
DP
zf
Zi
jg
kB
FM
"}
(19,1,1) = {"
mC
kB
mC
mC
Gu
Gu
Tp
zf
Gu
Gu
mC
Rh
WK
mC
Gu
Gu
Aq
Gu
Gu
qI
mC
Rh
vB
Zf
qm
zf
zf
zf
Cc
jg
kB
mC
"}
(20,1,1) = {"
mC
kB
mC
mC
Gu
Oc
zf
Wa
TQ
Gu
mC
Rh
WK
mC
Gu
Rw
Aq
ew
Gu
mC
mC
Rh
WK
yd
jg
jg
wU
zf
Zi
jg
kB
mC
"}
(21,1,1) = {"
mC
kB
mC
mC
Gu
Gu
zf
rM
Gu
Gu
mC
Rh
WK
mC
Gu
Gu
Jb
Gu
Gu
mC
mC
Rh
WK
mC
mC
jg
jg
jg
jg
jg
kB
mC
"}
(22,1,1) = {"
mC
kB
mC
mC
Gu
mf
zf
zf
TQ
Gu
mC
Rh
WK
mC
Gu
Rw
Ic
ew
Gu
mC
mC
Rh
WK
mC
mC
mC
mC
mC
mC
mC
kB
mC
"}
(23,1,1) = {"
mC
kB
mC
mC
Gu
Gu
ef
zf
Gu
Gu
mC
Rh
WK
mC
Gu
Gu
Gu
Gu
Gu
mC
mC
Rh
WK
mC
jg
jg
jg
jg
jg
jg
kB
mC
"}
(24,1,1) = {"
mC
kB
mC
mC
Gu
Oc
zf
zf
TQ
Gu
mC
Rh
WK
mC
mC
mC
mC
mC
mC
mC
mC
Rh
WK
mC
jg
YV
YQ
gz
uc
jg
kB
mC
"}
(25,1,1) = {"
mC
kB
mC
mC
Gu
Gu
zf
rM
Gu
Gu
mC
Rh
WK
mC
mC
mC
mC
mC
mC
mC
mC
Rh
WK
mC
jg
zA
jr
eS
rM
jg
kB
mC
"}
(26,1,1) = {"
mC
kB
mC
mC
Gu
Oc
zf
zf
TQ
Gu
mC
Rh
WK
mC
mC
mC
ov
mC
mC
mC
mC
Rh
WK
mC
jg
kO
ko
jg
aa
jg
kB
mC
"}
(27,1,1) = {"
mC
kB
mC
mC
Gu
Gu
Gu
Gu
Gu
Gu
mC
Rh
WK
mC
mC
mC
mC
mC
mC
mC
mC
Rh
WK
mC
gm
xc
Iv
ev
yA
mC
jg
Xv
"}
(28,1,1) = {"
mC
kB
mC
mC
mC
mC
mC
mC
mC
mC
mC
Rh
sQ
sS
sS
sS
sS
sS
sS
sS
sS
uU
sQ
sS
sS
uU
sQ
sS
SK
sS
XT
HM
"}
(29,1,1) = {"
mC
kB
mC
mC
mC
mC
mC
mC
mC
mC
mC
Ci
pU
pU
pU
pU
pU
pU
pU
pU
pU
pU
pU
pU
pU
pU
pU
pU
pU
pU
OA
pU
"}
(30,1,1) = {"
mC
kB
mC
mC
mC
mC
mC
mC
mC
mC
mC
mC
mC
mC
mC
mC
mC
mC
mC
mC
mC
mC
mC
mC
mC
mC
mC
mC
mC
mC
jg
Xv
"}
(31,1,1) = {"
mC
kB
mC
mC
mC
mC
mC
mC
mC
mC
mC
mC
mC
mC
mC
mC
mC
mC
mC
mC
mC
mC
mC
mC
mC
mC
mC
mC
mC
mC
kB
mC
"}
(32,1,1) = {"
yd
jg
Pw
Pw
Pw
Pw
Pw
Pw
Pw
Pw
Pw
Pw
Pw
Pw
Pw
Pw
Pw
Pw
Pw
Pw
Pw
Pw
Pw
Pw
Pw
Pw
Pw
Pw
Pw
Pw
jg
Xv
"}
