//MAP CONVERTED BY dmm2tgm.py THIS HEADER COMMENT PREVENTS RECONVERSION, DO NOT REMOVE
"b" = (
/obj/structure/flora/grass/adhomai,
/turf/simulated/floor/exoplanet/snow/cold,
/area/exoplanet/adhomai)
"c" = (
/turf/simulated/floor/exoplanet/snow/cold,
/area/exoplanet/adhomai)
"k" = (
/turf/simulated/mineral/random/high_chance/adhomai,
/area/exoplanet/adhomai)
"m" = (
/turf/simulated/mineral/adhomai,
/area/exoplanet/adhomai)
"s" = (
/obj/structure/pit/landmine/hidden,
/turf/simulated/floor/exoplanet/snow/cold,
/area/exoplanet/adhomai)
"u" = (
/obj/structure/adhomai_minefield,
/turf/simulated/floor/exoplanet/snow/cold,
/area/exoplanet/adhomai)
"x" = (
/obj/structure/flora/bush/adhomai,
/turf/simulated/floor/exoplanet/snow/cold,
/area/exoplanet/adhomai)
"A" = (
/obj/structure/flora/tree/adhomai,
/turf/simulated/floor/exoplanet/snow/cold,
/area/exoplanet/adhomai)
"C" = (
/obj/structure/flora/rock/ice,
/turf/simulated/floor/exoplanet/snow/cold,
/area/exoplanet/adhomai)
"P" = (
/obj/structure/pit/landmine,
/turf/simulated/floor/exoplanet/snow/cold,
/area/exoplanet/adhomai)

(1,1,1) = {"
c
c
c
c
b
c
c
c
c
c
c
c
c
c
c
c
c
c
c
c
c
m
m
c
c
c
c
c
c
c
c
c
"}
(2,1,1) = {"
c
c
c
c
c
c
c
c
C
c
x
c
c
c
A
c
c
c
c
c
c
m
m
m
c
c
c
c
c
c
c
c
"}
(3,1,1) = {"
c
c
c
c
c
c
c
c
c
c
c
c
c
c
c
c
c
c
c
b
c
m
m
m
c
c
C
c
c
c
c
c
"}
(4,1,1) = {"
c
c
c
c
c
c
c
c
c
c
c
c
c
c
c
P
c
c
c
c
c
c
m
c
c
c
c
c
c
c
c
c
"}
(5,1,1) = {"
c
c
b
c
c
c
c
c
c
c
c
A
m
m
m
c
c
c
c
c
c
c
c
c
c
c
c
c
x
c
c
c
"}
(6,1,1) = {"
c
c
c
c
c
c
c
b
c
c
c
c
m
m
m
c
c
c
c
c
c
c
c
s
c
A
c
c
c
c
c
c
"}
(7,1,1) = {"
c
c
A
c
c
c
c
c
c
c
c
c
c
c
c
c
c
c
A
c
c
c
c
c
c
c
c
c
c
c
c
c
"}
(8,1,1) = {"
c
c
c
c
s
c
c
c
c
c
c
c
c
c
c
c
x
c
c
c
c
c
c
c
c
c
c
c
c
c
c
c
"}
(9,1,1) = {"
c
c
c
c
c
c
c
c
c
c
c
c
s
c
c
c
c
c
c
c
b
c
c
c
c
c
c
c
c
P
c
c
"}
(10,1,1) = {"
c
c
c
c
c
c
c
c
c
c
c
c
c
c
c
c
c
c
c
c
c
c
c
c
c
c
c
c
c
c
c
c
"}
(11,1,1) = {"
c
c
c
c
c
c
c
c
b
c
c
c
c
c
c
A
c
c
c
P
c
c
c
c
c
c
b
c
c
c
c
c
"}
(12,1,1) = {"
c
C
c
c
c
c
c
c
c
c
c
c
c
c
c
c
c
c
c
c
c
c
c
c
c
c
c
c
c
c
c
c
"}
(13,1,1) = {"
c
c
c
c
c
c
c
c
c
c
x
c
c
c
k
k
c
c
c
c
c
c
c
c
c
c
c
c
c
c
c
c
"}
(14,1,1) = {"
c
c
c
c
c
c
A
c
c
c
c
c
c
c
k
m
m
k
b
c
c
c
x
c
c
c
c
c
c
c
c
c
"}
(15,1,1) = {"
c
c
c
c
x
c
c
c
c
c
c
c
c
c
m
m
m
c
c
c
c
c
c
c
c
s
c
c
c
c
c
c
"}
(16,1,1) = {"
c
c
b
c
c
c
c
c
c
P
c
c
m
m
m
m
m
k
c
c
c
c
c
c
c
c
c
c
u
c
c
c
"}
(17,1,1) = {"
c
c
c
c
c
c
c
c
c
c
c
c
c
m
c
c
c
c
c
c
c
c
c
c
c
c
c
c
c
c
c
c
"}
(18,1,1) = {"
c
c
c
c
c
c
c
c
c
c
c
A
c
c
c
c
s
c
c
c
c
c
c
c
c
c
A
c
c
c
A
c
"}
(19,1,1) = {"
c
A
c
c
c
s
c
c
c
c
c
c
c
c
c
c
c
c
c
c
c
C
c
c
c
c
c
c
c
c
c
c
"}
(20,1,1) = {"
c
c
c
c
c
c
c
c
c
c
c
c
c
c
c
c
c
c
c
c
c
c
c
c
c
c
c
c
c
c
c
c
"}
(21,1,1) = {"
c
c
c
c
c
c
c
c
c
c
c
c
b
c
c
c
c
c
c
c
c
c
c
c
b
c
c
c
c
c
c
c
"}
(22,1,1) = {"
c
c
c
c
c
c
c
c
x
c
c
c
c
c
c
c
c
A
c
c
c
x
c
c
c
c
c
c
P
c
c
c
"}
(23,1,1) = {"
c
c
c
c
c
c
c
c
c
c
c
c
c
c
c
c
c
c
c
c
c
c
c
c
c
c
c
c
c
c
c
c
"}
(24,1,1) = {"
c
c
c
c
c
c
c
b
c
c
c
c
c
c
c
x
c
c
c
c
c
A
c
c
c
c
c
c
c
c
c
c
"}
(25,1,1) = {"
c
c
A
c
c
c
c
c
c
c
c
c
c
c
c
c
c
c
c
c
c
c
c
c
c
c
c
c
c
c
c
c
"}
(26,1,1) = {"
c
c
c
c
c
c
c
c
c
c
c
c
c
c
c
c
c
c
P
c
c
c
c
c
c
c
c
c
c
c
c
c
"}
(27,1,1) = {"
c
c
c
c
C
c
c
c
c
c
c
s
c
c
c
c
c
c
c
c
c
c
c
c
c
c
c
c
c
A
c
c
"}
(28,1,1) = {"
c
x
c
c
c
c
c
c
c
c
c
c
c
c
c
c
c
c
c
c
c
c
c
c
c
b
c
c
c
c
c
c
"}
(29,1,1) = {"
c
m
c
c
c
c
P
c
c
c
c
c
c
c
c
c
c
c
c
c
c
s
c
c
c
c
c
c
c
c
c
c
"}
(30,1,1) = {"
c
m
m
c
c
c
c
c
c
c
c
c
c
b
c
c
c
c
c
c
c
c
c
c
c
c
c
c
c
c
m
m
"}
(31,1,1) = {"
c
m
m
m
c
c
c
c
c
c
c
c
c
c
c
c
c
c
c
c
c
c
c
c
c
c
c
c
c
m
m
m
"}
(32,1,1) = {"
c
m
m
m
c
c
c
c
c
c
c
c
c
c
c
c
c
c
c
c
c
c
c
c
c
c
c
c
m
m
m
m
"}
