//MAP CONVERTED BY dmm2tgm.py THIS HEADER COMMENT PREVENTS RECONVERSION, DO NOT REMOVE
"b" = (
/obj/effect/decal/remains/xeno,
/obj/effect/decal/cleanable/blood/splatter,
/turf/simulated/floor/exoplanet/mineral/adhomai,
/area/exoplanet/adhomai)
"c" = (
/turf/simulated/floor/exoplanet/snow/cold,
/area/exoplanet/adhomai)
"k" = (
/obj/structure/flora/rock/ice,
/turf/simulated/floor/exoplanet/mineral/adhomai,
/area/exoplanet/adhomai)
"m" = (
/turf/simulated/mineral/adhomai,
/area/exoplanet/adhomai)
"s" = (
/obj/structure/flora/grass/adhomai,
/turf/simulated/floor/exoplanet/snow/cold,
/area/exoplanet/adhomai)
"x" = (
/obj/structure/flora/bush/adhomai,
/turf/simulated/floor/exoplanet/snow/cold,
/area/exoplanet/adhomai)
"A" = (
/obj/effect/decal/cleanable/blood/splatter,
/turf/simulated/floor/exoplanet/mineral/adhomai,
/area/exoplanet/adhomai)
"C" = (
/obj/effect/decal/cleanable/blood/splatter,
/turf/simulated/floor/exoplanet/snow/cold,
/area/exoplanet/adhomai)
"P" = (
/turf/simulated/floor/exoplanet/mineral/adhomai,
/area/exoplanet/adhomai)
"R" = (
/mob/living/simple_animal/hostile/harron,
/turf/simulated/floor/exoplanet/mineral/adhomai,
/area/exoplanet/adhomai)
"X" = (
/obj/structure/flora/tree/adhomai,
/turf/simulated/floor/exoplanet/snow/cold,
/area/exoplanet/adhomai)

(1,1,1) = {"
c
c
c
c
c
c
c
c
c
c
c
c
c
c
c
c
c
X
c
c
c
c
c
c
c
c
c
c
c
c
s
c
"}
(2,1,1) = {"
c
X
c
c
c
c
c
c
c
c
X
c
c
c
c
c
c
c
c
c
c
s
c
c
c
c
c
c
c
c
c
c
"}
(3,1,1) = {"
c
c
c
c
c
c
x
c
c
c
c
c
c
c
c
c
c
c
c
c
c
c
c
c
c
c
X
c
c
c
c
c
"}
(4,1,1) = {"
c
c
c
c
X
c
c
c
c
c
c
c
c
c
c
X
c
c
x
c
c
c
m
c
c
c
c
c
c
c
c
c
"}
(5,1,1) = {"
c
c
c
c
c
c
c
c
s
c
c
c
c
c
c
c
c
c
c
c
m
c
m
c
c
c
c
c
x
c
c
c
"}
(6,1,1) = {"
c
c
c
c
c
c
c
c
c
c
c
x
c
c
c
c
c
c
m
m
m
m
m
m
m
m
c
c
c
c
c
c
"}
(7,1,1) = {"
c
c
c
c
c
x
c
c
c
X
c
c
c
c
c
c
c
c
m
m
m
m
m
m
m
m
c
c
c
c
s
c
"}
(8,1,1) = {"
c
c
X
c
c
c
c
c
c
c
c
c
c
c
m
m
m
m
m
m
m
m
m
m
m
m
c
c
c
c
c
c
"}
(9,1,1) = {"
c
c
c
c
c
c
c
c
c
c
c
c
c
c
m
m
m
m
m
P
P
m
m
m
c
c
c
s
c
c
c
c
"}
(10,1,1) = {"
c
c
c
c
m
m
m
m
m
m
m
m
m
m
m
m
m
m
m
P
P
P
m
m
c
c
c
c
c
c
c
c
"}
(11,1,1) = {"
c
c
s
c
m
m
m
m
m
m
m
m
m
m
m
m
m
P
P
P
P
P
m
m
c
c
c
c
c
c
X
c
"}
(12,1,1) = {"
c
c
c
c
m
m
m
m
m
m
m
m
m
m
m
m
m
m
P
P
P
P
m
m
c
c
x
c
c
c
c
c
"}
(13,1,1) = {"
x
c
c
m
m
m
m
m
m
m
m
P
P
P
P
P
m
m
R
P
P
m
m
m
c
c
c
c
c
c
c
c
"}
(14,1,1) = {"
c
c
c
m
m
m
m
m
P
P
P
P
P
b
P
P
m
P
P
P
m
m
m
m
c
c
c
c
c
c
x
c
"}
(15,1,1) = {"
c
c
m
m
m
m
m
m
P
P
P
k
P
P
P
P
P
P
P
P
m
m
c
c
c
s
c
c
c
c
c
c
"}
(16,1,1) = {"
c
c
m
m
m
m
P
P
P
P
P
P
R
P
P
P
m
m
m
m
m
m
c
c
c
c
c
c
c
c
c
c
"}
(17,1,1) = {"
c
c
m
m
m
m
P
P
P
P
P
P
P
P
P
P
m
m
m
m
m
m
c
c
c
c
c
c
c
c
c
c
"}
(18,1,1) = {"
c
c
m
m
m
m
P
P
P
P
P
P
P
P
m
m
m
m
m
m
m
m
c
c
c
c
X
c
c
c
c
c
"}
(19,1,1) = {"
s
c
m
m
m
m
P
P
P
b
P
P
P
P
m
m
P
P
m
m
m
m
m
c
c
c
c
c
c
c
c
X
"}
(20,1,1) = {"
c
c
m
m
m
m
P
P
P
P
P
P
P
P
P
m
P
P
P
P
P
m
m
c
c
c
c
c
c
c
c
c
"}
(21,1,1) = {"
c
c
m
m
m
m
m
P
P
P
m
P
P
P
P
P
P
P
k
P
P
m
m
m
c
c
c
c
c
c
c
c
"}
(22,1,1) = {"
c
c
c
m
m
m
P
P
P
m
m
R
P
A
P
P
P
P
P
P
P
P
P
c
c
c
c
x
c
c
c
c
"}
(23,1,1) = {"
x
c
c
m
m
m
P
P
P
m
m
P
P
P
P
P
P
P
P
P
P
P
A
c
c
c
c
c
c
c
c
c
"}
(24,1,1) = {"
c
c
c
m
m
m
P
P
P
m
m
k
P
m
m
m
m
P
P
P
P
P
P
c
c
s
c
c
C
c
c
x
"}
(25,1,1) = {"
c
c
c
c
m
m
m
m
m
m
m
P
P
m
m
m
m
P
P
P
P
P
P
c
c
c
c
c
c
c
c
c
"}
(26,1,1) = {"
c
c
c
c
m
m
m
m
m
m
m
m
m
m
m
m
m
m
P
P
P
P
P
c
c
c
c
c
c
s
c
c
"}
(27,1,1) = {"
c
c
c
c
m
m
m
m
m
m
m
m
m
m
m
m
m
m
m
m
m
P
P
c
c
c
x
c
c
c
c
c
"}
(28,1,1) = {"
c
c
c
c
m
m
m
m
m
m
m
m
m
m
m
m
m
m
m
m
m
P
k
c
c
c
c
c
c
c
c
c
"}
(29,1,1) = {"
c
s
c
x
m
m
m
m
m
m
m
m
m
m
m
m
m
m
m
m
m
P
P
c
c
c
c
c
c
c
c
c
"}
(30,1,1) = {"
c
c
c
c
m
m
m
m
m
m
m
m
m
m
m
m
m
m
m
m
m
P
P
m
c
c
c
s
c
c
X
c
"}
(31,1,1) = {"
c
c
X
c
m
m
m
m
m
m
m
m
m
m
m
m
m
m
m
m
m
m
m
m
c
c
c
c
x
c
c
c
"}
(32,1,1) = {"
c
c
c
c
c
c
c
c
c
c
c
c
c
s
c
m
m
m
m
m
m
m
m
m
m
m
c
c
c
c
c
c
"}
