//MAP CONVERTED BY dmm2tgm.py THIS HEADER COMMENT PREVENTS RECONVERSION, DO NOT REMOVE
"ah" = (
/obj/machinery/appliance/cooker/oven/adhomai,
/obj/effect/floor_decal/corner/grey/diagonal,
/turf/simulated/floor/exoplanet/concrete,
/area/adhomai_raskariim_hideout)
"bk" = (
/obj/structure/railing/fence{
	dir = 1
	},
/obj/structure/closet/outhouse,
/obj/item/organ/internal/liver/tajara,
/turf/simulated/floor/exoplanet/snow/cold,
/area/exoplanet/adhomai)
"bE" = (
/obj/structure/closet/crate/bin,
/obj/item/clothing/accessory/tajaran/charm/steel,
/obj/item/trash/plate,
/obj/item/trash/plate,
/turf/simulated/floor/exoplanet/wood,
/area/adhomai_raskariim_hideout)
"ch" = (
/obj/structure/table/wood,
/obj/item/pocketwatch/adhomai,
/turf/simulated/floor/exoplanet/wood,
/area/adhomai_raskariim_hideout)
"cq" = (
/obj/item/melee/hammer,
/turf/simulated/floor/exoplanet/wood,
/area/adhomai_raskariim_hideout)
"cy" = (
/obj/structure/closet/cabinet,
/obj/item/clothing/suit/storage/toggle/tajaran/wool,
/obj/item/clothing/under/tajaran,
/obj/item/clothing/under/tajaran,
/obj/item/clothing/under/tajaran/nka_noble{
	name = "tattered noble adhomian clothes";
	desc = "Clothes frequently worn by the New Kingdom's nobles. Whilst most are hand-me-downs this one clearly is, dotted by large holes and torn fabric."
	},
/turf/simulated/floor/exoplanet/wood,
/area/adhomai_raskariim_hideout)
"cD" = (
/obj/structure/railing/fence{
	dir = 4
	},
/turf/simulated/floor/exoplanet/snow/cold,
/area/exoplanet/adhomai)
"cW" = (
/obj/effect/decal/fake_object{
	density = 1;
	desc = "An Adhomian television. Due to bad reception, there is nothing to watch.";
	icon = 'icons/obj/computer.dmi';
	icon_state = "television";
	name = "adhomian television"
	},
/turf/simulated/floor/exoplanet/wood,
/area/adhomai_raskariim_hideout)
"da" = (
/obj/machinery/door/urban{
	dir = 8
	},
/turf/simulated/floor/exoplanet/wood,
/area/adhomai_raskariim_hideout)
"de" = (
/obj/structure/railing/fence{
	dir = 8
	},
/turf/simulated/floor/exoplanet/snow/cold,
/area/exoplanet/adhomai)
"dg" = (
/obj/item/stack/material/wood/log,
/obj/item/stack/material/wood/log,
/obj/item/stack/material/wood/log,
/turf/simulated/floor/exoplanet/snow/cold,
/area/exoplanet/adhomai)
"ds" = (
/obj/structure/flora/bush/adhomai,
/turf/simulated/floor/exoplanet/snow/cold,
/area/exoplanet/adhomai)
"ez" = (
/obj/structure/table/wood,
/turf/simulated/floor/exoplanet/wood,
/area/adhomai_raskariim_hideout)
"fj" = (
/obj/structure/table/wood,
/obj/item/paper_bin,
/obj/item/pen/red,
/obj/machinery/light/small{
	dir = 1
	},
/turf/simulated/floor/exoplanet/wood,
/area/adhomai_raskariim_hideout)
"fs" = (
/obj/structure/barricade/wooden{
	dir = 8
	},
/turf/simulated/floor/exoplanet/wood,
/area/adhomai_raskariim_hideout)
"iJ" = (
/obj/item/reagent_containers/food/drinks/drinkingglass/newglass/mug{
	pixel_x = -8
	},
/turf/simulated/floor/exoplanet/wood,
/area/adhomai_raskariim_hideout)
"jX" = (
/obj/structure/bed/stool/chair/wood,
/turf/simulated/floor/exoplanet/wood,
/area/adhomai_raskariim_hideout)
"ka" = (
/obj/structure/bed/stool/chair/wood{
	dir = 1
	},
/turf/simulated/floor/exoplanet/wood,
/area/adhomai_raskariim_hideout)
"kt" = (
/obj/structure/bed/padded,
/obj/structure/curtain/open,
/turf/simulated/floor/exoplanet/carpet/art,
/area/adhomai_raskariim_hideout)
"kM" = (
/obj/structure/bookcase,
/turf/simulated/floor/exoplanet/wood,
/area/adhomai_raskariim_hideout)
"kX" = (
/obj/effect/floor_decal/corner/grey/diagonal,
/obj/structure/reagent_dispensers/keg/mead{
	reagents_to_add = list(/singleton/reagent/water=1000);
	name = "water barrel"
	},
/turf/simulated/floor/exoplanet/concrete,
/area/adhomai_raskariim_hideout)
"lj" = (
/obj/structure/mirror{
	pixel_y = 32
	},
/obj/effect/decal/cleanable/ash,
/turf/simulated/floor/exoplanet/wood,
/area/adhomai_raskariim_hideout)
"lr" = (
/obj/structure/bed/stool/chair/wood{
	dir = 8
	},
/turf/simulated/floor/exoplanet/wood,
/area/adhomai_raskariim_hideout)
"lI" = (
/obj/item/device/flashlight/lamp,
/obj/structure/table/wood,
/turf/simulated/floor/exoplanet/carpet/art,
/area/adhomai_raskariim_hideout)
"nm" = (
/obj/effect/floor_decal/corner/grey/diagonal,
/obj/machinery/light/small{
	brightness_color = "#FA8282";
	dir = 1
	},
/turf/simulated/floor/exoplanet/concrete,
/area/adhomai_raskariim_hideout)
"or" = (
/obj/item/reagent_containers/pill/happy{
	pixel_y = -5;
	pixel_x = 3
	},
/obj/item/reagent_containers/pill/zoom{
	pixel_y = 8;
	pixel_x = -4
	},
/turf/simulated/floor/exoplanet/wood,
/area/adhomai_raskariim_hideout)
"pR" = (
/obj/structure/table/stone/marble,
/obj/item/reagent_containers/food/condiment/shaker/peppermill{
	pixel_x = -4;
	pixel_y = 11
	},
/obj/item/reagent_containers/food/condiment/shaker/spacespice{
	pixel_x = 3;
	pixel_y = 7
	},
/obj/item/reagent_containers/food/condiment/shaker/salt{
	pixel_x = 8;
	pixel_y = 11
	},
/obj/item/reagent_containers/food/condiment/shaker/spacespice{
	pixel_x = 3;
	pixel_y = 1
	},
/obj/effect/floor_decal/corner/grey/diagonal,
/obj/item/reagent_containers/glass/rag{
	pixel_x = -7;
	pixel_y = 4
	},
/turf/simulated/floor/exoplanet/concrete,
/area/adhomai_raskariim_hideout)
"rg" = (
/obj/random/pottedplant,
/turf/simulated/floor/exoplanet/wood,
/area/adhomai_raskariim_hideout)
"ri" = (
/obj/machinery/door/urban,
/turf/simulated/floor/exoplanet/wood,
/area/adhomai_raskariim_hideout)
"rw" = (
/obj/structure/bed/stool/chair/sofa/left/black{
	dir = 1
	},
/turf/simulated/floor/exoplanet/wood,
/area/adhomai_raskariim_hideout)
"rA" = (
/obj/machinery/light/small{
	dir = 8
	},
/turf/simulated/floor/exoplanet/wood,
/area/adhomai_raskariim_hideout)
"rG" = (
/obj/machinery/door/urban{
	dir = 4
	},
/turf/simulated/floor/exoplanet/wood,
/area/adhomai_raskariim_hideout)
"rK" = (
/obj/structure/table/wood,
/obj/item/reagent_containers/food/drinks/drinkingglass,
/turf/simulated/floor/exoplanet/wood,
/area/adhomai_raskariim_hideout)
"sX" = (
/obj/structure/table/wood,
/obj/item/toy/plushie/farwa,
/turf/simulated/floor/exoplanet/wood,
/area/adhomai_raskariim_hideout)
"te" = (
/obj/structure/closet/cabinet,
/obj/item/clothing/suit/storage/tajaran/raskara,
/obj/item/clothing/head/tajaran/raskara,
/obj/item/melee/whip,
/turf/simulated/floor/exoplanet/wood,
/area/adhomai_raskariim_hideout)
"tv" = (
/obj/structure/table/wood,
/obj/item/material/kitchen/utensil/spoon,
/turf/simulated/floor/exoplanet/wood,
/area/adhomai_raskariim_hideout)
"tY" = (
/obj/machinery/light/small/red,
/turf/simulated/floor/exoplanet/wood,
/area/adhomai_raskariim_hideout)
"tZ" = (
/obj/structure/railing/fence{
	dir = 8
	},
/obj/structure/flora/grass/adhomai,
/turf/simulated/floor/exoplanet/snow/cold,
/area/exoplanet/adhomai)
"uQ" = (
/obj/machinery/light/small,
/turf/simulated/floor/exoplanet/wood,
/area/adhomai_raskariim_hideout)
"vc" = (
/obj/structure/railing/fence,
/obj/structure/railing/fence{
	dir = 4
	},
/turf/simulated/floor/exoplanet/snow/cold,
/area/exoplanet/adhomai)
"vA" = (
/obj/item/surgery/scalpel,
/obj/structure/table/wood,
/obj/item/reagent_containers/glass/bucket/wood{
	pixel_x = -4;
	pixel_y = 9
	},
/obj/machinery/light/small{
	dir = 1
	},
/turf/simulated/floor/exoplanet/wood,
/area/adhomai_raskariim_hideout)
"vD" = (
/obj/structure/bed/stool/chair/sofa/right/black{
	dir = 1
	},
/turf/simulated/floor/exoplanet/wood,
/area/adhomai_raskariim_hideout)
"vI" = (
/obj/item/clothing/shoes/tajara/footwraps{
	pixel_x = 9;
	pixel_y = 14
	},
/obj/item/clothing/shoes/tajara/footwraps{
	pixel_x = -5;
	pixel_y = 13
	},
/obj/item/clothing/shoes/winter/tajara{
	pixel_x = -11;
	pixel_y = -7
	},
/obj/item/clothing/shoes/winter/tajara{
	pixel_x = 7;
	pixel_y = -7
	},
/turf/simulated/floor/exoplanet/wood,
/area/adhomai_raskariim_hideout)
"wq" = (
/obj/structure/table/wood,
/obj/item/gun/projectile/revolver/adhomian{
	pixel_y = -2
	},
/obj/item/ammo_casing/c38{
	pixel_x = -6;
	pixel_y = 8
	},
/obj/item/ammo_casing/c38{
	pixel_x = 7;
	pixel_y = 5
	},
/obj/item/ammo_casing/c38{
	pixel_x = 1;
	pixel_y = 7
	},
/obj/item/ammo_casing/c38{
	pixel_x = 4;
	pixel_y = -4
	},
/obj/item/reagent_containers/food/drinks/drinkingglass{
	pixel_x = -5;
	pixel_y = 12
	},
/turf/simulated/floor/exoplanet/carpet/art,
/area/adhomai_raskariim_hideout)
"wx" = (
/obj/structure/bed/stool/chair/sofa/black{
	dir = 1
	},
/turf/simulated/floor/exoplanet/wood,
/area/adhomai_raskariim_hideout)
"xe" = (
/obj/effect/floor_decal/corner/grey/diagonal,
/obj/structure/table/stone/marble,
/obj/item/reagent_containers/cooking_container/pot{
	pixel_y = 11;
	pixel_x = 9
	},
/obj/item/reagent_containers/cooking_container/saucepan{
	pixel_y = -2;
	pixel_x = -11
	},
/obj/effect/decal/cleanable/blood/drip,
/obj/effect/decal/cleanable/blood/drip{
	pixel_y = 20;
	pixel_x = -15
	},
/obj/item/reagent_containers/glass/bucket/wood{
	pixel_x = 11
	},
/turf/simulated/floor/exoplanet/concrete,
/area/adhomai_raskariim_hideout)
"xo" = (
/obj/structure/table/wood,
/obj/item/flame/candle/waxcandles{
	pixel_x = -4;
	pixel_y = 16
	},
/turf/simulated/floor/exoplanet/wood,
/area/adhomai_raskariim_hideout)
"xs" = (
/obj/structure/bonfire/fireplace{
	density = 0
	},
/turf/simulated/floor/exoplanet/wood,
/area/adhomai_raskariim_hideout)
"xK" = (
/obj/effect/floor_decal/corner/grey/diagonal,
/obj/structure/table/stone/marble,
/obj/item/reagent_containers/food/condiment/sugar{
	pixel_x = 7;
	pixel_y = 8
	},
/obj/machinery/light/small{
	dir = 4
	},
/obj/item/reagent_containers/food/drinks/drinkingglass{
	pixel_y = 9;
	pixel_x = -7
	},
/obj/item/reagent_containers/food/drinks/drinkingglass{
	pixel_y = 3;
	pixel_x = -7
	},
/obj/item/material/kitchen/utensil/knife,
/turf/simulated/floor/exoplanet/concrete,
/area/adhomai_raskariim_hideout)
"yF" = (
/obj/structure/sign/flag/raskara,
/turf/simulated/floor/exoplanet/wood,
/area/adhomai_raskariim_hideout)
"zd" = (
/obj/structure/table/wood,
/obj/item/device/flashlight/lamp{
	pixel_y = 6;
	pixel_x = 5
	},
/turf/simulated/floor/exoplanet/wood,
/area/adhomai_raskariim_hideout)
"zn" = (
/turf/simulated/floor/exoplanet/carpet/art,
/area/adhomai_raskariim_hideout)
"zC" = (
/obj/machinery/light/small{
	dir = 1
	},
/turf/simulated/floor/exoplanet/wood,
/area/adhomai_raskariim_hideout)
"Ai" = (
/obj/structure/railing/fence{
	dir = 1
	},
/obj/structure/flora/grass/adhomai,
/turf/simulated/floor/exoplanet/snow/cold,
/area/exoplanet/adhomai)
"CS" = (
/obj/structure/railing/fence{
	dir = 1
	},
/turf/simulated/floor/exoplanet/snow/cold,
/area/exoplanet/adhomai)
"Dg" = (
/obj/structure/reagent_dispensers/keg/mead,
/turf/simulated/floor/exoplanet/wood,
/area/adhomai_raskariim_hideout)
"Dk" = (
/obj/structure/railing/fence{
	dir = 1
	},
/obj/structure/flora/bush/adhomai,
/turf/simulated/floor/exoplanet/snow/cold,
/area/exoplanet/adhomai)
"Dl" = (
/obj/item/tape_roll{
	pixel_y = 3
	},
/obj/item/storage/toolbox/mechanical{
	pixel_y = -5
	},
/obj/structure/table/wood,
/obj/item/storage/firstaid,
/obj/item/storage/box/fancy/candle_box,
/obj/item/storage/box/fancy/candle_box,
/obj/item/storage/box/fancy/candle_box,
/obj/item/storage/box/fancy/candle_box,
/obj/item/flame/lighter/adhomai,
/turf/simulated/floor/exoplanet/wood,
/area/adhomai_raskariim_hideout)
"DD" = (
/obj/structure/closet/cabinet,
/obj/item/clothing/suit/storage/tajaran/raskara,
/obj/item/clothing/head/tajaran/raskara,
/obj/machinery/light/small,
/obj/item/material/knife/raskariim,
/turf/simulated/floor/exoplanet/wood,
/area/adhomai_raskariim_hideout)
"DU" = (
/obj/item/storage/box/fancy/crayons/chalkbox{
	pixel_y = 7
	},
/obj/item/storage/box/fancy/crayons{
	pixel_y = -5
	},
/turf/simulated/floor/exoplanet/wood,
/area/adhomai_raskariim_hideout)
"Ew" = (
/obj/item/reagent_containers/syringe/drugs{
	pixel_y = 7;
	pixel_x = 5
	},
/turf/simulated/floor/exoplanet/wood,
/area/adhomai_raskariim_hideout)
"Hn" = (
/obj/effect/floor_decal/corner/grey/diagonal,
/turf/simulated/floor/exoplanet/concrete,
/area/adhomai_raskariim_hideout)
"HE" = (
/obj/item/handcuffs/cable/random,
/obj/item/handcuffs/cable/random,
/obj/machinery/light/small,
/turf/simulated/floor/exoplanet/wood,
/area/adhomai_raskariim_hideout)
"HG" = (
/obj/structure/table/wood,
/obj/item/material/ashtray/bronze,
/obj/item/trash/cigbutt,
/obj/item/storage/box/fancy/cigarettes/dpra{
	pixel_y = -2;
	pixel_x = -7
	},
/obj/machinery/light/small{
	dir = 8
	},
/turf/simulated/floor/exoplanet/wood,
/area/adhomai_raskariim_hideout)
"Ig" = (
/obj/structure/table/stone/marble,
/obj/effect/floor_decal/corner/grey/diagonal,
/obj/machinery/chemical_dispenser/coffee/full,
/turf/simulated/floor/exoplanet/concrete,
/area/adhomai_raskariim_hideout)
"Io" = (
/obj/structure/closet/crate/bin,
/obj/item/paper/crumpled/bloody,
/obj/item/paper/crumpled/bloody,
/obj/item/trash/candle,
/obj/item/trash/plate,
/obj/item/trash/plate,
/obj/item/trash/plate,
/turf/simulated/floor/exoplanet/wood,
/area/adhomai_raskariim_hideout)
"IW" = (
/obj/structure/closet/cabinet,
/obj/item/clothing/suit/storage/tajaran/raskara,
/obj/item/clothing/head/tajaran/raskara,
/turf/simulated/floor/exoplanet/wood,
/area/adhomai_raskariim_hideout)
"Ja" = (
/obj/structure/barricade/wooden{
	dir = 4
	},
/turf/simulated/floor/exoplanet/wood,
/area/adhomai_raskariim_hideout)
"Jk" = (
/obj/structure/curtain/black,
/obj/effect/map_effect/window_spawner/full/wood,
/turf/simulated/floor/exoplanet/wood,
/area/adhomai_raskariim_hideout)
"Jq" = (
/obj/item/stack/dice/tajara/alt{
	pixel_x = 5
	},
/obj/item/stack/dice/tajara{
	pixel_x = -5
	},
/turf/simulated/floor/exoplanet/wood,
/area/adhomai_raskariim_hideout)
"LC" = (
/obj/structure/table/wood,
/obj/item/material/kitchen/utensil/knife{
	pixel_x = 7
	},
/obj/item/material/kitchen/utensil/knife,
/obj/machinery/light/small{
	dir = 8
	},
/turf/simulated/floor/exoplanet/wood,
/area/adhomai_raskariim_hideout)
"Ml" = (
/obj/item/reagent_containers/food/drinks/bottle/treebark_firewater{
	pixel_y = 9;
	pixel_x = 5
	},
/obj/item/reagent_containers/food/drinks/bottle/treebark_firewater{
	pixel_x = -7
	},
/obj/item/reagent_containers/food/drinks/bottle/treebark_firewater{
	pixel_x = 8;
	pixel_y = -5
	},
/turf/simulated/floor/exoplanet/wood,
/area/adhomai_raskariim_hideout)
"Mo" = (
/obj/structure/flora/tree/adhomai,
/turf/simulated/floor/exoplanet/snow/cold,
/area/exoplanet/adhomai)
"MY" = (
/obj/structure/railing/fence{
	dir = 4
	},
/obj/structure/railing/fence{
	dir = 1
	},
/turf/simulated/floor/exoplanet/snow/cold,
/area/exoplanet/adhomai)
"MZ" = (
/obj/structure/railing/fence,
/turf/simulated/floor/exoplanet/snow/cold,
/area/exoplanet/adhomai)
"Nl" = (
/obj/item/reagent_containers/inhaler/raskara_dust{
	pixel_x = 8
	},
/obj/item/reagent_containers/inhaler/raskara_dust{
	pixel_x = 1;
	pixel_y = 4
	},
/turf/simulated/floor/exoplanet/wood,
/area/adhomai_raskariim_hideout)
"Nt" = (
/turf/simulated/wall/wood{
	can_open = 1
	},
/area/adhomai_raskariim_hideout)
"NN" = (
/obj/structure/bed/stool/chair/wood{
	dir = 4
	},
/turf/simulated/floor/exoplanet/wood,
/area/adhomai_raskariim_hideout)
"NT" = (
/obj/item/mirror,
/turf/simulated/floor/exoplanet/wood,
/area/adhomai_raskariim_hideout)
"Ol" = (
/obj/structure/coatrack,
/obj/item/clothing/accessory/poncho/tajarancloak/winter,
/obj/item/clothing/accessory/poncho/tajarancloak/winter,
/obj/item/clothing/head/tajaran/fur,
/obj/item/clothing/head/tajaran/fur,
/turf/simulated/floor/exoplanet/wood,
/area/adhomai_raskariim_hideout)
"OF" = (
/obj/effect/decal/cleanable/blood/splatter,
/obj/item/material/knife/raskariim,
/obj/structure/cult/tome{
	desc = "A stone altar dedicated to Raskara. The blood is still fresh.";
	icon_state = "churchaltar";
	name = "altar"
	},
/turf/simulated/floor/exoplanet/wood,
/area/adhomai_raskariim_hideout)
"Pz" = (
/obj/structure/noose,
/obj/structure/bed/stool/bar/padded/red,
/obj/effect/decal/cleanable/blood/splatter,
/obj/item/poppet,
/obj/machinery/light/small,
/turf/simulated/floor/exoplanet/wood,
/area/adhomai_raskariim_hideout)
"PT" = (
/obj/structure/flora/grass/adhomai,
/turf/simulated/floor/exoplanet/snow/cold,
/area/exoplanet/adhomai)
"Ru" = (
/obj/structure/railing/fence,
/obj/structure/railing/fence{
	dir = 8
	},
/turf/simulated/floor/exoplanet/snow/cold,
/area/exoplanet/adhomai)
"SE" = (
/turf/simulated/floor/exoplanet/wood,
/area/adhomai_raskariim_hideout)
"Te" = (
/obj/structure/barricade/wooden{
	dir = 1
	},
/turf/simulated/floor/exoplanet/wood,
/area/adhomai_raskariim_hideout)
"UC" = (
/obj/machinery/appliance/cooker/stove/adhomai,
/obj/effect/floor_decal/corner/grey/diagonal,
/obj/machinery/light/small{
	dir = 4
	},
/turf/simulated/floor/exoplanet/concrete,
/area/adhomai_raskariim_hideout)
"UQ" = (
/obj/item/reagent_containers/syringe{
	pixel_x = -10;
	pixel_y = -5
	},
/turf/simulated/floor/exoplanet/wood,
/area/adhomai_raskariim_hideout)
"Vm" = (
/obj/effect/decal/remains/xeno,
/turf/simulated/floor/exoplanet/wood,
/area/adhomai_raskariim_hideout)
"WM" = (
/turf/simulated/floor/exoplanet/snow/cold,
/area/exoplanet/adhomai)
"WO" = (
/turf/simulated/wall/wood,
/area/adhomai_raskariim_hideout)
"XF" = (
/obj/item/storage/box/fancy/candle_box,
/turf/simulated/floor/exoplanet/wood,
/area/adhomai_raskariim_hideout)
"Yu" = (
/obj/effect/ghostspawpoint{
	identifier = "raskariim_hideout";
	name = "igs - raskariim_hideout"
	},
/obj/item/flame/candle,
/turf/simulated/floor/exoplanet/wood,
/area/adhomai_raskariim_hideout)
"ZM" = (
/obj/effect/floor_decal/corner/grey/diagonal,
/obj/structure/closet/secure_closet/freezer,
/obj/item/reagent_containers/food/snacks/meat/adhomai,
/obj/item/reagent_containers/food/snacks/meat/adhomai,
/obj/item/organ/internal/liver/tajara,
/obj/structure/barricade/wooden{
	dir = 4
	},
/turf/simulated/floor/exoplanet/concrete,
/area/adhomai_raskariim_hideout)

(1,1,1) = {"
WO
WO
WO
WO
Jk
WO
WO
de
de
de
de
tZ
de
de
de
de
tZ
de
de
de
de
Ru
"}
(2,1,1) = {"
WO
Vm
Nt
Dg
fs
Pz
WO
WM
WM
WM
WM
WM
WM
WM
WM
WM
WM
WM
WM
ds
WM
MZ
"}
(3,1,1) = {"
WO
WO
WO
Dg
SE
NT
WO
WO
WO
Jk
WO
WO
WO
WO
WO
Jk
Jk
WO
WO
WM
WM
MZ
"}
(4,1,1) = {"
Dk
WM
WO
vA
SE
SE
SE
HE
WO
fs
tv
LC
rK
WO
rg
fs
fs
HG
WO
WM
PT
MZ
"}
(5,1,1) = {"
CS
WM
WO
Dl
SE
SE
SE
cq
WO
SE
SE
SE
SE
WO
kM
zn
zn
vD
WO
WM
WM
MZ
"}
(6,1,1) = {"
CS
WM
WO
WO
WO
rG
WO
WO
WO
SE
SE
NN
SE
WO
zC
zn
zn
wx
WO
WM
WM
MZ
"}
(7,1,1) = {"
CS
WM
WO
yF
DU
SE
SE
Ml
WO
zC
jX
ez
ka
WO
cW
zn
zn
wx
WO
WM
WM
MZ
"}
(8,1,1) = {"
CS
WM
WO
or
SE
Yu
SE
iJ
WO
SE
jX
ez
ka
WO
SE
zn
zn
wx
WO
WM
WM
MZ
"}
(9,1,1) = {"
CS
WM
ri
SE
Yu
OF
Yu
tY
WO
SE
jX
ez
ka
WO
xs
zn
zn
rw
WO
WO
WO
WO
"}
(10,1,1) = {"
CS
WM
WO
lj
SE
Yu
SE
UQ
WO
SE
jX
ez
ka
WO
SE
SE
SE
SE
WO
Ol
rA
WO
"}
(11,1,1) = {"
CS
WM
Jk
Te
SE
SE
SE
Nl
WO
SE
SE
lr
uQ
WO
SE
SE
SE
SE
ri
SE
zn
ri
"}
(12,1,1) = {"
CS
WM
WO
Jq
XF
SE
Ew
SE
ri
SE
SE
SE
SE
ri
SE
SE
SE
uQ
WO
cy
vI
WO
"}
(13,1,1) = {"
CS
WM
WO
WO
WO
rG
WO
WO
WO
Io
SE
SE
SE
WO
bE
SE
SE
zd
WO
WO
WO
WO
"}
(14,1,1) = {"
CS
dg
WO
ch
SE
SE
SE
SE
WO
WO
WO
WO
da
WO
WO
da
WO
WO
WO
WM
WM
MZ
"}
(15,1,1) = {"
CS
WM
WO
fj
ka
SE
SE
SE
SE
ez
WO
Hn
Hn
Hn
Hn
Hn
kX
WO
WM
WM
WM
MZ
"}
(16,1,1) = {"
CS
WM
WO
xo
zn
zn
zn
zn
SE
DD
WO
nm
Hn
Hn
Hn
Hn
xe
WO
WM
WM
Mo
MZ
"}
(17,1,1) = {"
CS
WM
WO
SE
zn
zn
zn
zn
SE
IW
WO
ah
Ig
UC
ZM
pR
xK
WO
WM
WM
WM
MZ
"}
(18,1,1) = {"
Ai
WM
WO
te
wq
kt
kt
lI
Ja
sX
WO
WO
WO
WO
Jk
WO
WO
WO
WM
PT
WM
MZ
"}
(19,1,1) = {"
bk
WM
WO
WO
WO
WO
WO
WO
Jk
WO
WO
WM
WM
WM
WM
WM
WM
WM
WM
WM
WM
MZ
"}
(20,1,1) = {"
CS
WM
WM
WM
WM
WM
WM
WM
WM
WM
WM
WM
ds
WM
WM
WM
WM
WM
WM
WM
ds
MZ
"}
(21,1,1) = {"
MY
cD
cD
cD
cD
cD
cD
cD
cD
cD
cD
cD
cD
cD
cD
cD
cD
cD
cD
cD
cD
vc
"}
