//MAP CONVERTED BY dmm2tgm.py THIS HEADER COMMENT PREVENTS RECONVERSION, DO NOT REMOVE
"c" = (
/turf/simulated/floor/exoplanet/snow{
	temperature = 268.15
	},
/area/exoplanet/adhomai)
"i" = (
/obj/machinery/light/small,
/turf/simulated/floor/exoplanet/snow{
	temperature = 268.15
	},
/area/adhomai_fallout_bunker)
"q" = (
/obj/machinery/button/remote/blast_door{
	dir = 1;
	pixel_y = -32;
	req_access = list(209)
	},
/turf/simulated/floor/exoplanet/snow{
	temperature = 268.15
	},
/area/adhomai_fallout_bunker)
"s" = (
/obj/machinery/door/blast/shutters{
	id = "bunker_entry";
	dir = 2
	},
/turf/simulated/floor/exoplanet/snow{
	temperature = 268.15
	},
/area/adhomai_fallout_bunker)
"E" = (
/obj/machinery/door/airlock/highsecurity,
/turf/simulated/floor/exoplanet/snow{
	temperature = 268.15
	},
/area/adhomai_fallout_bunker)
"I" = (
/turf/simulated/wall/r_wall,
/area/adhomai_fallout_bunker)
"O" = (
/obj/structure/blocker/steel/fence{
	dir = 4
	},
/turf/simulated/floor/exoplanet/snow{
	temperature = 268.15
	},
/area/adhomai_fallout_bunker)
"T" = (
/turf/simulated/floor/exoplanet/snow{
	temperature = 268.15
	},
/area/adhomai_fallout_bunker)
"Y" = (
/obj/structure/blocker/steel/fence,
/turf/simulated/floor/exoplanet/snow{
	temperature = 268.15
	},
/area/adhomai_fallout_bunker)

(1,1,1) = {"
c
I
Y
Y
Y
Y
Y
Y
Y
Y
Y
Y
Y
Y
Y
Y
Y
Y
Y
Y
Y
Y
Y
Y
Y
Y
Y
Y
I
c
"}
(2,1,1) = {"
c
O
T
T
T
T
T
T
T
T
T
T
T
T
T
T
T
T
T
T
T
T
T
T
T
T
T
T
O
c
"}
(3,1,1) = {"
c
O
T
T
T
T
T
T
T
T
T
T
T
T
T
T
T
T
T
T
T
T
T
T
T
T
T
T
O
c
"}
(4,1,1) = {"
c
O
T
T
T
T
T
T
T
T
T
T
T
T
T
T
T
T
T
T
T
T
T
T
T
T
T
T
O
c
"}
(5,1,1) = {"
c
O
T
T
T
T
T
T
T
T
T
T
T
T
T
T
T
T
T
T
T
T
T
T
T
T
T
T
O
c
"}
(6,1,1) = {"
c
O
T
T
T
T
T
T
T
T
T
T
T
T
T
T
T
T
T
T
T
T
T
T
T
T
T
T
O
c
"}
(7,1,1) = {"
c
O
T
T
T
T
T
T
T
T
T
T
T
T
T
T
T
T
T
T
T
T
T
T
T
T
T
T
O
c
"}
(8,1,1) = {"
c
O
T
T
T
T
T
T
T
T
T
T
T
T
T
T
T
T
T
T
T
T
T
T
T
T
T
T
O
c
"}
(9,1,1) = {"
c
O
T
T
T
T
T
T
T
T
T
T
T
T
T
T
T
T
T
T
T
T
T
T
T
T
T
T
O
c
"}
(10,1,1) = {"
c
O
T
T
T
T
T
T
T
T
T
T
T
T
T
T
T
T
T
T
T
T
T
T
T
T
T
T
O
c
"}
(11,1,1) = {"
c
O
T
T
T
T
T
T
T
T
T
T
T
T
T
T
T
T
T
T
T
T
T
T
T
T
T
T
O
c
"}
(12,1,1) = {"
c
O
T
T
T
T
T
T
T
T
T
T
T
T
T
T
T
T
T
T
T
T
T
T
T
T
T
T
O
c
"}
(13,1,1) = {"
c
O
T
T
T
T
I
T
T
T
T
T
T
T
T
T
T
T
T
T
T
T
T
T
T
T
T
T
O
c
"}
(14,1,1) = {"
i
I
T
T
T
I
I
T
T
T
T
T
T
T
T
T
T
T
T
T
T
T
T
T
T
T
T
T
O
c
"}
(15,1,1) = {"
c
s
T
T
T
E
T
T
T
T
T
T
T
T
T
T
T
T
T
T
T
T
T
T
T
T
T
T
O
c
"}
(16,1,1) = {"
q
I
T
T
T
I
I
T
T
T
T
T
T
T
T
T
T
T
T
T
T
T
T
T
T
T
T
T
O
c
"}
(17,1,1) = {"
c
O
T
T
T
T
I
T
T
T
T
T
T
T
T
T
T
T
T
T
T
T
T
T
T
T
T
T
O
c
"}
(18,1,1) = {"
c
O
T
T
T
T
T
T
T
T
T
T
T
T
T
T
T
T
T
T
T
T
T
T
T
T
T
T
O
c
"}
(19,1,1) = {"
c
O
T
T
T
T
T
T
T
T
T
T
T
T
T
T
T
T
T
T
T
T
T
T
T
T
T
T
O
c
"}
(20,1,1) = {"
c
O
T
T
T
T
T
T
T
T
T
T
T
T
T
T
T
T
T
T
T
T
T
T
T
T
T
T
O
c
"}
(21,1,1) = {"
c
O
T
T
T
T
T
T
T
T
T
T
T
T
T
T
T
T
T
T
T
T
T
T
T
T
T
T
O
c
"}
(22,1,1) = {"
c
O
T
T
T
T
T
T
T
T
T
T
T
T
T
T
T
T
T
T
T
T
T
T
T
T
T
T
O
c
"}
(23,1,1) = {"
c
O
T
T
T
T
T
T
T
T
T
T
T
T
T
T
T
T
T
T
T
T
T
T
T
T
T
T
O
c
"}
(24,1,1) = {"
c
O
T
T
T
T
T
T
T
T
T
T
T
T
T
T
T
T
T
T
T
T
T
T
T
T
T
T
O
c
"}
(25,1,1) = {"
c
O
T
T
T
T
T
T
T
T
T
T
T
T
T
T
T
T
T
T
T
T
T
T
T
T
T
T
O
c
"}
(26,1,1) = {"
c
O
T
T
T
T
T
T
T
T
T
T
T
T
T
T
T
T
T
T
T
T
T
T
T
T
T
T
O
c
"}
(27,1,1) = {"
c
O
T
T
T
T
T
T
T
T
T
T
T
T
T
T
T
T
T
T
T
T
T
T
T
T
T
T
O
c
"}
(28,1,1) = {"
c
O
T
T
T
T
T
T
T
T
T
T
T
T
T
T
T
T
T
T
T
T
T
T
T
T
T
T
O
c
"}
(29,1,1) = {"
c
I
Y
Y
Y
Y
Y
Y
Y
Y
Y
Y
Y
Y
Y
Y
Y
Y
Y
Y
Y
Y
Y
Y
Y
Y
Y
Y
I
c
"}
