//MAP CONVERTED BY dmm2tgm.py THIS HEADER COMMENT PREVENTS RECONVERSION, DO NOT REMOVE
"c" = (
/turf/simulated/floor/exoplanet/snow/cold,
/area/exoplanet/adhomai)
"m" = (
/obj/effect/ghostspawpoint{
	identifier = "adhomai_sole_rock_nomad";
	name = "igs - adhomai_sole_rock_nomad"
	},
/turf/simulated/floor/exoplanet/snow/cold,
/area/exoplanet/adhomai)
"s" = (
/obj/structure/flora/grass/adhomai,
/turf/simulated/floor/exoplanet/snow/cold,
/area/exoplanet/adhomai)
"x" = (
/obj/structure/flora/bush/adhomai,
/turf/simulated/floor/exoplanet/snow/cold,
/area/exoplanet/adhomai)
"z" = (
/obj/item/stack/medical/bruise_pack/full,
/obj/item/stack/medical/bruise_pack/full,
/turf/simulated/floor/exoplanet/snow/cold,
/area/exoplanet/adhomai)
"M" = (
/obj/vehicle/animal/climber,
/turf/simulated/floor/exoplanet/snow/cold,
/area/exoplanet/adhomai)
"P" = (
/obj/structure/bonfire/light_up,
/turf/simulated/floor/exoplanet/snow/cold,
/area/exoplanet/adhomai)

(1,1,1) = {"
c
c
c
s
c
"}
(2,1,1) = {"
c
M
z
c
c
"}
(3,1,1) = {"
c
m
P
c
c
"}
(4,1,1) = {"
c
c
c
c
c
"}
(5,1,1) = {"
c
x
c
c
c
"}
