//MAP CONVERTED BY dmm2tgm.py THIS HEADER COMMENT PREVENTS RECONVERSION, DO NOT REMOVE
"aH" = (
/obj/structure/bed/stool/chair/sofa/brown{
	dir = 1
	},
/turf/simulated/floor/carpet/art{
	temperature = 278.15
	},
/area/adhomai_hunting)
"cJ" = (
/obj/structure/bed/stool/chair/sofa/right/brown{
	dir = 1
	},
/turf/simulated/floor/carpet/art{
	temperature = 278.15
	},
/area/adhomai_hunting)
"dh" = (
/obj/structure/railing/fence,
/obj/structure/railing/fence{
	dir = 4
	},
/turf/simulated/floor/exoplanet/snow{
	temperature = 268.15
	},
/area/exoplanet/adhomai)
"dl" = (
/mob/living/simple_animal/hostile/commanded/dog/harron{
	dir = 4
	},
/turf/simulated/floor/exoplanet/snow{
	temperature = 268.15
	},
/area/exoplanet/adhomai)
"do" = (
/turf/simulated/floor/carpet/art{
	temperature = 278.15
	},
/area/adhomai_hunting)
"ev" = (
/obj/structure/flora/tree/adhomai,
/turf/simulated/floor/exoplanet/snow{
	temperature = 268.15
	},
/area/exoplanet/adhomai)
"ir" = (
/obj/effect/decal/fake_object{
	density = 1;
	desc = "An Adhomian television. Due to bad reception, there is nothing to watch.";
	icon = 'icons/obj/computer.dmi';
	icon_state = "television";
	name = "adhomian television"
	},
/turf/simulated/floor/wood{
	temperature = 268.15
	},
/area/adhomai_hunting)
"ix" = (
/obj/structure/flora/bush/adhomai,
/turf/simulated/floor/exoplanet/snow{
	temperature = 268.15
	},
/area/exoplanet/adhomai)
"jp" = (
/mob/living/simple_animal/hostile/commanded/dog/harron{
	dir = 1
	},
/turf/simulated/floor/exoplanet/snow{
	temperature = 268.15
	},
/area/exoplanet/adhomai)
"kx" = (
/obj/item/reagent_containers/glass/bucket/wood{
	pixel_x = -9;
	pixel_y = 5
	},
/turf/simulated/floor/exoplanet/snow{
	temperature = 268.15
	},
/area/exoplanet/adhomai)
"lr" = (
/obj/structure/flora/rock/ice,
/turf/simulated/floor/exoplanet/snow{
	temperature = 268.15
	},
/area/exoplanet/adhomai)
"lu" = (
/obj/structure/closet/crate/drop,
/obj/item/device/binoculars,
/obj/item/device/binoculars,
/turf/simulated/floor/wood{
	temperature = 268.15
	},
/area/adhomai_hunting)
"mo" = (
/obj/structure/closet/crate/drop,
/obj/item/ammo_magazine/boltaction,
/obj/item/ammo_magazine/boltaction,
/obj/item/ammo_magazine/boltaction,
/turf/simulated/floor/wood{
	temperature = 268.15
	},
/area/adhomai_hunting)
"mV" = (
/obj/structure/table/wood,
/obj/item/device/flashlight/lamp,
/turf/simulated/floor/wood{
	temperature = 268.15
	},
/area/adhomai_hunting)
"pp" = (
/obj/structure/railing/fence{
	dir = 4
	},
/obj/structure/railing/fence{
	dir = 1
	},
/turf/simulated/floor/exoplanet/snow{
	temperature = 268.15
	},
/area/exoplanet/adhomai)
"pA" = (
/obj/machinery/light/small{
	dir = 4
	},
/turf/simulated/floor/wood{
	temperature = 268.15
	},
/area/adhomai_hunting)
"qJ" = (
/obj/structure/table/wood,
/obj/item/material/hatchet/butch,
/obj/item/material/kitchen/utensil/knife,
/obj/item/material/kitchen/utensil/knife,
/obj/item/material/kitchen/utensil/fork,
/obj/item/material/kitchen/utensil/fork,
/obj/item/material/kitchen/utensil/spoon,
/obj/item/material/kitchen/utensil/spoon,
/obj/item/reagent_containers/food/condiment/shaker/salt{
	pixel_x = 5
	},
/obj/item/reagent_containers/food/condiment/shaker/peppermill{
	pixel_x = -5
	},
/obj/item/reagent_containers/food/condiment/shaker/spacespice,
/turf/simulated/floor/wood{
	temperature = 268.15
	},
/area/adhomai_hunting)
"rQ" = (
/obj/structure/table/wood,
/obj/item/material/ashtray/bronze,
/obj/item/flame/lighter/adhomai{
	pixel_x = 7
	},
/obj/item/clothing/mask/smokable/cigarette/adhomai{
	pixel_x = -5
	},
/turf/simulated/floor/wood{
	temperature = 268.15
	},
/area/adhomai_hunting)
"su" = (
/obj/structure/cult/tome{
	desc = "A stone altar dedicated to Ma'take, the god of hunting.";
	icon_state = "churchaltar";
	name = "altar"
	},
/obj/item/clothing/accessory/tajaran/charm/steel/silver{
	desc = "An expensive silver charm of tajaran origin. This one has the arrowhead of Ma'take";
	name = "mata'ke charm"
	},
/turf/simulated/floor/wood{
	temperature = 268.15
	},
/area/adhomai_hunting)
"tL" = (
/obj/effect/ghostspawpoint{
	identifier = "matake_hunter";
	name = "igs - matake_hunter"
	},
/turf/simulated/floor/wood{
	temperature = 268.15
	},
/area/adhomai_hunting)
"uJ" = (
/turf/simulated/floor/wood{
	temperature = 268.15
	},
/area/adhomai_hunting)
"vw" = (
/obj/machinery/portable_atmospherics/hydroponics/soil,
/turf/simulated/floor/exoplanet/snow{
	temperature = 268.15
	},
/area/exoplanet/adhomai)
"vA" = (
/obj/structure/table/wood,
/obj/item/toy/plushie/farwa,
/turf/simulated/floor/wood{
	temperature = 268.15
	},
/area/adhomai_hunting)
"wc" = (
/obj/machinery/light/small{
	dir = 1
	},
/turf/simulated/floor/exoplanet/snow{
	temperature = 268.15
	},
/area/adhomai_hunting)
"xy" = (
/obj/structure/bed/padded,
/obj/item/bedsheet/brown,
/turf/simulated/floor/wood{
	temperature = 268.15
	},
/area/adhomai_hunting)
"xK" = (
/obj/structure/railing/mapped{
	dir = 4
	},
/turf/simulated/floor/tiled/ramp,
/area/adhomai_hunting)
"xV" = (
/obj/structure/table/wood,
/obj/item/flame/candle/waxcandles{
	pixel_y = 7;
	pixel_x = -5
	},
/turf/simulated/floor/wood{
	temperature = 268.15
	},
/area/adhomai_hunting)
"Bn" = (
/obj/structure/table/wood/gamblingtable,
/obj/item/deck/cards,
/turf/simulated/floor/wood{
	temperature = 268.15
	},
/area/adhomai_hunting)
"Br" = (
/obj/structure/closet/crate/medical,
/obj/item/stack/medical/bruise_pack/full,
/obj/item/stack/medical/bruise_pack/full,
/obj/item/storage/firstaid,
/obj/item/stack/medical/splint/full,
/obj/item/stack/medical/splint/full,
/turf/simulated/floor/wood{
	temperature = 268.15
	},
/area/adhomai_hunting)
"Ds" = (
/obj/structure/railing/fence{
	dir = 1
	},
/turf/simulated/floor/exoplanet/snow{
	temperature = 268.15
	},
/area/exoplanet/adhomai)
"Ex" = (
/obj/structure/closet/cabinet,
/obj/item/ammo_magazine/boltaction,
/obj/item/ammo_magazine/boltaction,
/obj/item/clothing/suit/storage/tajaran/hunting,
/obj/item/device/flashlight/heavy,
/turf/simulated/floor/wood{
	temperature = 268.15
	},
/area/adhomai_hunting)
"Gq" = (
/obj/structure/table/wood,
/obj/item/storage/chewables/tobacco/bad,
/turf/simulated/floor/wood{
	temperature = 268.15
	},
/area/adhomai_hunting)
"GQ" = (
/obj/structure/table/wood/gamblingtable,
/obj/item/reagent_containers/food/snacks/hardbread,
/obj/item/reagent_containers/food/drinks/cans/adhomai_milk,
/turf/simulated/floor/wood{
	temperature = 268.15
	},
/area/adhomai_hunting)
"HL" = (
/obj/structure/closet/crate/drop,
/obj/item/trap,
/obj/item/trap,
/obj/item/trap,
/obj/item/trap,
/obj/item/trap,
/turf/simulated/floor/wood{
	temperature = 268.15
	},
/area/adhomai_hunting)
"HP" = (
/obj/structure/railing/fence{
	dir = 4
	},
/turf/simulated/floor/exoplanet/snow{
	temperature = 268.15
	},
/area/exoplanet/adhomai)
"IF" = (
/obj/structure/railing/fence{
	dir = 4
	},
/mob/living/simple_animal/hostile/commanded/dog/harron{
	dir = 8
	},
/turf/simulated/floor/exoplanet/snow{
	temperature = 268.15
	},
/area/exoplanet/adhomai)
"Jy" = (
/obj/structure/closet/crate/hydroponics,
/obj/item/seeds/mtearseed,
/obj/item/seeds/nifberries,
/obj/item/seeds/sugartree,
/obj/item/seeds/earthenroot,
/turf/simulated/floor/exoplanet/snow{
	temperature = 268.15
	},
/area/exoplanet/adhomai)
"LY" = (
/obj/structure/bed/padded,
/obj/item/bedsheet/yellow,
/turf/simulated/floor/wood{
	temperature = 268.15
	},
/area/adhomai_hunting)
"Mr" = (
/obj/structure/bed/stool/wood,
/obj/effect/ghostspawpoint{
	identifier = "adhomai_hunter";
	name = "igs - adhomai_hunter"
	},
/turf/simulated/floor/wood{
	temperature = 268.15
	},
/area/adhomai_hunting)
"Nm" = (
/obj/effect/decal/cleanable/blood/splatter,
/turf/simulated/floor/wood{
	temperature = 268.15
	},
/area/adhomai_hunting)
"NE" = (
/obj/structure/railing/mapped{
	dir = 8
	},
/turf/simulated/floor/tiled/ramp,
/area/adhomai_hunting)
"NZ" = (
/obj/structure/flora/grass/adhomai,
/turf/simulated/floor/exoplanet/snow{
	temperature = 268.15
	},
/area/exoplanet/adhomai)
"Pm" = (
/obj/structure/bed/stool/chair/sofa/left/brown{
	dir = 1
	},
/turf/simulated/floor/carpet/art{
	temperature = 278.15
	},
/area/adhomai_hunting)
"PY" = (
/obj/structure/closet/secure_closet/freezer,
/obj/effect/decal/cleanable/cobweb,
/turf/simulated/floor/wood{
	temperature = 268.15
	},
/area/adhomai_hunting)
"Rz" = (
/turf/simulated/floor/exoplanet/ice,
/area/exoplanet/adhomai)
"RN" = (
/obj/structure/table/wood/gamblingtable,
/obj/item/deck/tarot/adhomai,
/turf/simulated/floor/wood{
	temperature = 268.15
	},
/area/adhomai_hunting)
"RP" = (
/obj/structure/sink/puddle,
/turf/simulated/floor/exoplanet/snow{
	temperature = 268.15
	},
/area/exoplanet/adhomai)
"TJ" = (
/obj/structure/window/basic{
	dir = 8
	},
/obj/structure/curtain/black,
/turf/simulated/floor/wood{
	temperature = 268.15
	},
/area/adhomai_hunting)
"Vn" = (
/obj/structure/railing/mapped,
/turf/simulated/floor/wood{
	temperature = 268.15
	},
/area/adhomai_hunting)
"Vp" = (
/obj/structure/table/wood/gamblingtable,
/obj/item/storage/pill_bottle/dice/tajara,
/turf/simulated/floor/wood{
	temperature = 268.15
	},
/area/adhomai_hunting)
"VI" = (
/obj/machinery/light/small,
/turf/simulated/floor/wood{
	temperature = 268.15
	},
/area/adhomai_hunting)
"Wt" = (
/obj/machinery/light/small,
/turf/simulated/floor/exoplanet/snow{
	temperature = 268.15
	},
/area/exoplanet/adhomai)
"Wy" = (
/obj/structure/simple_door/wood,
/turf/simulated/floor/wood{
	temperature = 268.15
	},
/area/adhomai_hunting)
"XQ" = (
/turf/simulated/floor/exoplanet/snow{
	temperature = 268.15
	},
/area/exoplanet/adhomai)
"XW" = (
/turf/simulated/wall/wood,
/area/adhomai_hunting)
"Yn" = (
/obj/structure/table/wood/gamblingtable,
/obj/item/material/knife/bayonet,
/turf/simulated/floor/wood{
	temperature = 268.15
	},
/area/adhomai_hunting)
"YQ" = (
/obj/machinery/appliance/cooker/oven/adhomai,
/turf/simulated/floor/wood{
	temperature = 268.15
	},
/area/adhomai_hunting)
"Zo" = (
/obj/structure/table/wood/gamblingtable,
/turf/simulated/floor/wood{
	temperature = 268.15
	},
/area/adhomai_hunting)
"Zu" = (
/obj/structure/window/basic{
	dir = 4
	},
/obj/structure/curtain/black,
/turf/simulated/floor/wood{
	temperature = 268.15
	},
/area/adhomai_hunting)
"ZC" = (
/obj/machinery/light/small{
	dir = 8
	},
/turf/simulated/floor/wood{
	temperature = 268.15
	},
/area/adhomai_hunting)

(1,1,1) = {"
XQ
XQ
XQ
XQ
ix
XQ
XQ
XQ
XQ
XQ
XQ
XQ
XQ
XQ
XQ
XQ
XQ
XQ
XQ
XQ
XQ
XQ
XQ
XQ
XQ
XQ
XQ
XQ
XQ
XQ
XQ
XQ
"}
(2,1,1) = {"
XQ
XQ
XQ
XQ
XQ
XQ
XQ
XQ
XQ
XQ
XQ
XQ
XQ
XQ
XQ
XQ
XQ
XQ
XQ
XQ
XQ
ev
XQ
XQ
XQ
XQ
XQ
XQ
XQ
XQ
XQ
XQ
"}
(3,1,1) = {"
XQ
XQ
XQ
XQ
XQ
XQ
XQ
XQ
XQ
XQ
XQ
XQ
XQ
XQ
XQ
XQ
XQ
XQ
XQ
XQ
XQ
XQ
XQ
XQ
XQ
XQ
XQ
XQ
XQ
XQ
XQ
XQ
"}
(4,1,1) = {"
XQ
XQ
XQ
XQ
XQ
XQ
XQ
XQ
XQ
XQ
XQ
ev
XQ
XQ
XQ
NZ
XQ
XQ
XQ
XQ
XQ
XQ
XQ
XQ
XQ
XQ
XQ
XQ
XQ
XQ
XQ
XQ
"}
(5,1,1) = {"
XQ
XQ
XQ
XQ
XQ
XQ
XQ
ev
XQ
XQ
XQ
XQ
XQ
XQ
XQ
XQ
XQ
XQ
XQ
XQ
lr
XQ
XQ
XQ
XQ
XQ
XQ
NZ
XQ
XQ
XQ
XQ
"}
(6,1,1) = {"
XQ
XQ
NZ
XQ
XQ
lr
XQ
XQ
XQ
XQ
XQ
XQ
XQ
XQ
XQ
XQ
XQ
XQ
XQ
XQ
XQ
XQ
XQ
NZ
XQ
XQ
XQ
XQ
XQ
XQ
XQ
XQ
"}
(7,1,1) = {"
XQ
XQ
XQ
XQ
XQ
XQ
XQ
XQ
XQ
XQ
XQ
XQ
XQ
XQ
XQ
XQ
XQ
XQ
XQ
XQ
XQ
XQ
XQ
XQ
XQ
XQ
XQ
XQ
XQ
XQ
XQ
XQ
"}
(8,1,1) = {"
XQ
XQ
XQ
XQ
XQ
XQ
XQ
XQ
XQ
XQ
XQ
NZ
XQ
XQ
XQ
XQ
XQ
XQ
XQ
XQ
NZ
XQ
XQ
XQ
XQ
XQ
XQ
XQ
XQ
XQ
XQ
NZ
"}
(9,1,1) = {"
XQ
XQ
XQ
XQ
XQ
XQ
XQ
XQ
XQ
XQ
XQ
XQ
XQ
XQ
XW
XW
TJ
XW
vw
vw
vw
XQ
RP
XQ
XQ
XQ
ev
XQ
XQ
XQ
XQ
XQ
"}
(10,1,1) = {"
XQ
XQ
XQ
XQ
XQ
XQ
XQ
NZ
XQ
XQ
XQ
XQ
XQ
XQ
XW
LY
uJ
XW
wc
XQ
XQ
XQ
kx
XQ
XQ
XQ
XQ
XQ
XQ
XQ
XQ
XQ
"}
(11,1,1) = {"
XQ
XQ
XQ
XQ
XQ
XQ
XQ
XQ
XQ
XW
XW
TJ
XW
XW
XW
mV
uJ
XW
vw
vw
vw
XQ
XQ
XQ
NZ
XQ
XQ
XQ
XQ
XQ
XQ
XQ
"}
(12,1,1) = {"
XQ
XQ
XQ
XQ
XQ
XQ
XQ
XQ
XQ
XW
PY
uJ
ZC
Nm
XW
Ex
uJ
XW
XQ
XQ
XQ
XQ
XQ
XQ
XQ
XQ
XQ
XQ
XQ
XQ
XQ
XQ
"}
(13,1,1) = {"
XQ
XQ
XQ
XQ
XQ
XQ
XW
XW
XW
XW
YQ
uJ
uJ
qJ
XW
XW
Wy
XW
Jy
XQ
XQ
XQ
XQ
ix
XQ
XQ
XQ
XQ
XQ
XQ
XQ
XQ
"}
(14,1,1) = {"
XQ
XQ
XQ
XQ
XQ
XW
XW
uJ
ZC
xK
uJ
uJ
uJ
uJ
uJ
ZC
uJ
XW
XW
XW
XW
XW
XQ
XQ
XQ
XQ
XQ
XQ
XQ
XQ
XQ
XQ
"}
(15,1,1) = {"
XQ
XQ
XQ
ix
XQ
XW
xV
uJ
Vn
uJ
uJ
Mr
Bn
Zo
Mr
uJ
uJ
Wy
uJ
uJ
mV
XW
XQ
XQ
XQ
XQ
XQ
XQ
XQ
XQ
NZ
XQ
"}
(16,1,1) = {"
XQ
NZ
XQ
XQ
XQ
XW
su
tL
Vn
uJ
uJ
Mr
Yn
Vp
Mr
uJ
uJ
XW
Ex
uJ
xy
XW
XQ
XQ
XQ
XQ
XQ
ev
XQ
XQ
XQ
XQ
"}
(17,1,1) = {"
XQ
XQ
XQ
XQ
XQ
XW
xV
uJ
Vn
Br
uJ
Mr
RN
GQ
Mr
uJ
VI
XW
XW
Zu
XW
XW
XQ
XQ
ix
XQ
XQ
XQ
XQ
XQ
XQ
XQ
"}
(18,1,1) = {"
XQ
XQ
XQ
XQ
XQ
XW
XW
uJ
pA
NE
uJ
uJ
uJ
uJ
uJ
uJ
uJ
Wy
XQ
XQ
XQ
XQ
XQ
XQ
XQ
XQ
XQ
XQ
XQ
XQ
XQ
XQ
"}
(19,1,1) = {"
XQ
XQ
XQ
XQ
XQ
XQ
XW
XW
XW
XW
lu
HL
mo
uJ
uJ
uJ
rQ
XW
XQ
XQ
XQ
XQ
XQ
XQ
XQ
XQ
XQ
XQ
XQ
XQ
XQ
XQ
"}
(20,1,1) = {"
XQ
NZ
XQ
XQ
XQ
XQ
XQ
XQ
Ds
XW
XW
XW
XW
vA
uJ
do
cJ
XW
XQ
XQ
XQ
XQ
XQ
XQ
XQ
XQ
XQ
XQ
XQ
XQ
XQ
XQ
"}
(21,1,1) = {"
XQ
XQ
XQ
XQ
XQ
XQ
NZ
XQ
Ds
XQ
dl
XQ
XW
ir
uJ
do
aH
XW
XQ
XQ
XQ
XQ
NZ
XQ
NZ
XQ
XQ
XQ
XQ
XQ
XQ
XQ
"}
(22,1,1) = {"
XQ
XQ
XQ
XQ
XQ
XQ
XQ
XQ
XQ
dl
XQ
Wt
XW
Gq
pA
do
Pm
XW
XQ
XQ
XQ
XQ
XQ
XQ
XQ
XQ
NZ
XQ
XQ
XQ
XQ
XQ
"}
(23,1,1) = {"
XQ
XQ
XQ
XQ
Rz
XQ
XQ
XQ
Ds
XQ
XQ
jp
XW
XW
XW
Zu
XW
XW
XQ
XQ
XQ
XQ
XQ
XQ
XQ
XQ
XQ
XQ
XQ
XQ
XQ
XQ
"}
(24,1,1) = {"
XQ
XQ
XQ
Rz
Rz
Rz
XQ
XQ
pp
IF
HP
HP
dh
XQ
XQ
XQ
XQ
XQ
XQ
XQ
XQ
XQ
XQ
XQ
XQ
XQ
XQ
XQ
XQ
XQ
XQ
XQ
"}
(25,1,1) = {"
XQ
XQ
XQ
Rz
Rz
Rz
Rz
XQ
XQ
XQ
XQ
XQ
NZ
XQ
XQ
XQ
XQ
XQ
XQ
XQ
XQ
XQ
XQ
XQ
XQ
XQ
XQ
XQ
XQ
XQ
XQ
XQ
"}
(26,1,1) = {"
XQ
XQ
Rz
Rz
Rz
Rz
XQ
XQ
XQ
lr
XQ
XQ
XQ
XQ
XQ
XQ
XQ
XQ
NZ
XQ
XQ
XQ
NZ
XQ
XQ
XQ
ev
XQ
XQ
XQ
XQ
XQ
"}
(27,1,1) = {"
XQ
NZ
XQ
Rz
Rz
Rz
Rz
XQ
XQ
XQ
XQ
XQ
XQ
XQ
XQ
XQ
XQ
XQ
XQ
XQ
XQ
XQ
XQ
XQ
XQ
XQ
XQ
XQ
XQ
XQ
XQ
XQ
"}
(28,1,1) = {"
XQ
XQ
XQ
XQ
XQ
Rz
Rz
Rz
XQ
XQ
XQ
XQ
XQ
XQ
XQ
XQ
XQ
XQ
XQ
XQ
XQ
XQ
XQ
XQ
XQ
XQ
XQ
XQ
XQ
XQ
NZ
XQ
"}
(29,1,1) = {"
XQ
XQ
XQ
XQ
XQ
Rz
Rz
XQ
XQ
XQ
XQ
XQ
XQ
NZ
XQ
XQ
XQ
XQ
XQ
XQ
XQ
XQ
ev
XQ
XQ
XQ
XQ
XQ
XQ
XQ
XQ
XQ
"}
(30,1,1) = {"
XQ
XQ
XQ
XQ
XQ
XQ
XQ
XQ
XQ
XQ
XQ
ix
XQ
XQ
XQ
XQ
XQ
ix
XQ
XQ
XQ
XQ
XQ
XQ
XQ
XQ
XQ
XQ
XQ
XQ
XQ
XQ
"}
(31,1,1) = {"
XQ
XQ
XQ
XQ
XQ
XQ
XQ
XQ
XQ
XQ
XQ
XQ
XQ
XQ
XQ
XQ
XQ
XQ
XQ
XQ
XQ
XQ
XQ
XQ
XQ
XQ
XQ
XQ
XQ
XQ
XQ
XQ
"}
(32,1,1) = {"
XQ
XQ
XQ
XQ
XQ
XQ
XQ
XQ
XQ
XQ
XQ
XQ
XQ
XQ
XQ
XQ
XQ
XQ
XQ
XQ
XQ
XQ
XQ
XQ
XQ
XQ
XQ
XQ
XQ
XQ
XQ
XQ
"}
