//MAP CONVERTED BY dmm2tgm.py THIS HEADER COMMENT PREVENTS RECONVERSION, DO NOT REMOVE
"af" = (
/obj/structure/bed/padded,
/obj/item/bedsheet/yellow,
/turf/simulated/floor/wood{
	temperature = 268.15
	},
/area/adhomai_hunting)
"cS" = (
/obj/structure/closet/secure_closet/freezer,
/obj/effect/decal/cleanable/cobweb,
/turf/simulated/floor/wood{
	temperature = 268.15
	},
/area/adhomai_hunting)
"dK" = (
/obj/structure/railing/fence,
/obj/structure/railing/fence{
	dir = 4
	},
/turf/simulated/floor/exoplanet/snow{
	temperature = 268.15
	},
/area/exoplanet/adhomai)
"dN" = (
/obj/effect/decal/fake_object{
	density = 1;
	desc = "An Adhomian television. Due to bad reception, there is nothing to watch.";
	icon = 'icons/obj/computer.dmi';
	icon_state = "television";
	name = "adhomian television"
	},
/turf/simulated/floor/wood{
	temperature = 268.15
	},
/area/adhomai_hunting)
"gt" = (
/obj/machinery/light/small,
/turf/simulated/floor/exoplanet/snow{
	temperature = 268.15
	},
/area/adhomai_hunting)
"gQ" = (
/obj/structure/table/wood/gamblingtable,
/turf/simulated/floor/wood{
	temperature = 268.15
	},
/area/adhomai_hunting)
"gT" = (
/mob/living/simple_animal/hostile/commanded/dog/harron{
	dir = 1
	},
/turf/simulated/floor/exoplanet/snow{
	temperature = 268.15
	},
/area/exoplanet/adhomai)
"ih" = (
/obj/structure/sink/puddle,
/turf/simulated/floor/exoplanet/snow{
	temperature = 268.15
	},
/area/exoplanet/adhomai)
"iA" = (
/obj/structure/railing/mapped{
	dir = 4
	},
/turf/simulated/floor/tiled/ramp,
/area/adhomai_hunting)
"jN" = (
/obj/structure/flora/rock/ice,
/turf/simulated/floor/exoplanet/snow{
	temperature = 268.15
	},
/area/exoplanet/adhomai)
"ol" = (
/turf/simulated/floor/exoplanet/ice,
/area/exoplanet/adhomai)
"pk" = (
/obj/structure/bed/stool/chair/sofa/right/brown{
	dir = 1
	},
/turf/simulated/floor/carpet/art{
	temperature = 278.15
	},
/area/adhomai_hunting)
"pn" = (
/obj/structure/table/wood,
/obj/item/flame/candle/waxcandles{
	pixel_y = 7;
	pixel_x = -5
	},
/turf/simulated/floor/wood{
	temperature = 268.15
	},
/area/adhomai_hunting)
"pR" = (
/obj/structure/bed/padded,
/obj/item/bedsheet/brown,
/turf/simulated/floor/wood{
	temperature = 268.15
	},
/area/adhomai_hunting)
"qH" = (
/obj/structure/closet/crate/drop,
/obj/item/device/binoculars,
/obj/item/device/binoculars,
/turf/simulated/floor/wood{
	temperature = 268.15
	},
/area/adhomai_hunting)
"qL" = (
/obj/structure/table/wood,
/obj/item/device/flashlight/lamp,
/turf/simulated/floor/wood{
	temperature = 268.15
	},
/area/adhomai_hunting)
"sx" = (
/obj/structure/closet/crate/drop,
/obj/item/ammo_magazine/boltaction,
/obj/item/ammo_magazine/boltaction,
/obj/item/ammo_magazine/boltaction,
/turf/simulated/floor/wood{
	temperature = 268.15
	},
/area/adhomai_hunting)
"sK" = (
/turf/simulated/floor/exoplanet/snow{
	temperature = 268.15
	},
/area/exoplanet/adhomai)
"sR" = (
/obj/machinery/light/small{
	dir = 8
	},
/turf/simulated/floor/wood{
	temperature = 268.15
	},
/area/adhomai_hunting)
"tZ" = (
/obj/item/reagent_containers/glass/bucket/wood{
	pixel_x = -9;
	pixel_y = 5
	},
/turf/simulated/floor/exoplanet/snow{
	temperature = 268.15
	},
/area/exoplanet/adhomai)
"uD" = (
/obj/structure/railing/fence{
	dir = 4
	},
/mob/living/simple_animal/hostile/commanded/dog/harron{
	dir = 8
	},
/turf/simulated/floor/exoplanet/snow{
	temperature = 268.15
	},
/area/exoplanet/adhomai)
"vh" = (
/obj/effect/decal/cleanable/blood/splatter,
/turf/simulated/floor/wood{
	temperature = 268.15
	},
/area/adhomai_hunting)
"wZ" = (
/obj/structure/table/wood/gamblingtable,
/obj/item/material/knife/bayonet,
/turf/simulated/floor/wood{
	temperature = 268.15
	},
/area/adhomai_hunting)
"xA" = (
/obj/structure/closet/crate/drop,
/obj/item/trap,
/obj/item/trap,
/obj/item/trap,
/obj/item/trap,
/obj/item/trap,
/turf/simulated/floor/wood{
	temperature = 268.15
	},
/area/adhomai_hunting)
"yf" = (
/obj/structure/window/basic{
	dir = 4
	},
/obj/structure/curtain/black,
/turf/simulated/floor/wood{
	temperature = 268.15
	},
/area/adhomai_hunting)
"zG" = (
/obj/machinery/portable_atmospherics/hydroponics/soil,
/turf/simulated/floor/exoplanet/snow{
	temperature = 268.15
	},
/area/exoplanet/adhomai)
"zT" = (
/obj/structure/bed/stool/chair/sofa/left/brown{
	dir = 1
	},
/turf/simulated/floor/carpet/art{
	temperature = 278.15
	},
/area/adhomai_hunting)
"Ar" = (
/obj/structure/table/wood,
/obj/item/storage/chewables/tobacco/bad,
/turf/simulated/floor/wood{
	temperature = 268.15
	},
/area/adhomai_hunting)
"AF" = (
/obj/structure/bed/stool/chair/sofa/brown{
	dir = 1
	},
/turf/simulated/floor/carpet/art{
	temperature = 278.15
	},
/area/adhomai_hunting)
"Bg" = (
/obj/machinery/light/small,
/turf/simulated/floor/wood{
	temperature = 268.15
	},
/area/adhomai_hunting)
"BE" = (
/obj/structure/table/wood/gamblingtable,
/obj/item/storage/pill_bottle/dice/tajara,
/turf/simulated/floor/wood{
	temperature = 268.15
	},
/area/adhomai_hunting)
"Cj" = (
/obj/structure/table/wood/gamblingtable,
/obj/item/reagent_containers/food/snacks/hardbread,
/obj/item/reagent_containers/food/drinks/cans/adhomai_milk,
/turf/simulated/floor/wood{
	temperature = 268.15
	},
/area/adhomai_hunting)
"Cp" = (
/obj/machinery/appliance/cooker/oven/adhomai,
/turf/simulated/floor/wood{
	temperature = 268.15
	},
/area/adhomai_hunting)
"EY" = (
/obj/structure/closet/cabinet,
/obj/item/ammo_magazine/boltaction,
/obj/item/ammo_magazine/boltaction,
/obj/item/clothing/suit/storage/tajaran/hunting,
/obj/item/device/flashlight/heavy,
/turf/simulated/floor/wood{
	temperature = 268.15
	},
/area/adhomai_hunting)
"GY" = (
/turf/simulated/floor/wood{
	temperature = 268.15
	},
/area/adhomai_hunting)
"Ha" = (
/obj/structure/flora/bush/adhomai,
/turf/simulated/floor/exoplanet/snow{
	temperature = 268.15
	},
/area/exoplanet/adhomai)
"HP" = (
/obj/structure/window/basic{
	dir = 8
	},
/obj/structure/curtain/black,
/turf/simulated/floor/wood{
	temperature = 268.15
	},
/area/adhomai_hunting)
"Ii" = (
/obj/structure/flora/tree/adhomai,
/turf/simulated/floor/exoplanet/snow{
	temperature = 268.15
	},
/area/exoplanet/adhomai)
"IF" = (
/obj/structure/bed/stool/wood,
/obj/effect/ghostspawpoint{
	identifier = "adhomai_hunter";
	name = "igs - adhomai_hunter"
	},
/turf/simulated/floor/wood{
	temperature = 268.15
	},
/area/adhomai_hunting)
"IT" = (
/obj/structure/railing/fence{
	dir = 4
	},
/turf/simulated/floor/exoplanet/snow{
	temperature = 268.15
	},
/area/exoplanet/adhomai)
"IU" = (
/obj/structure/simple_door/wood,
/turf/simulated/floor/wood{
	temperature = 268.15
	},
/area/adhomai_hunting)
"Ju" = (
/obj/structure/cult/tome{
	desc = "A stone altar dedicated to Ma'take, the god of hunting.";
	icon_state = "churchaltar";
	name = "altar"
	},
/obj/item/clothing/accessory/tajaran/charm/steel/silver{
	desc = "An expensive silver charm of tajaran origin. This one has the arrowhead of Ma'take";
	name = "mata'ke charm"
	},
/turf/simulated/floor/wood{
	temperature = 268.15
	},
/area/adhomai_hunting)
"Lm" = (
/obj/structure/table/wood,
/obj/item/material/hatchet/butch,
/obj/item/material/kitchen/utensil/knife,
/obj/item/material/kitchen/utensil/knife,
/obj/item/material/kitchen/utensil/fork,
/obj/item/material/kitchen/utensil/fork,
/obj/item/material/kitchen/utensil/spoon,
/obj/item/material/kitchen/utensil/spoon,
/obj/item/reagent_containers/food/condiment/shaker/salt{
	pixel_x = 5
	},
/obj/item/reagent_containers/food/condiment/shaker/peppermill{
	pixel_x = -5
	},
/obj/item/reagent_containers/food/condiment/shaker/spacespice,
/turf/simulated/floor/wood{
	temperature = 268.15
	},
/area/adhomai_hunting)
"Lo" = (
/obj/structure/railing/mapped,
/turf/simulated/floor/wood{
	temperature = 268.15
	},
/area/adhomai_hunting)
"LO" = (
/obj/structure/closet/crate/hydroponics,
/obj/item/seeds/mtearseed,
/obj/item/seeds/nifberries,
/obj/item/seeds/sugartree,
/obj/item/seeds/earthenroot,
/turf/simulated/floor/exoplanet/snow{
	temperature = 268.15
	},
/area/exoplanet/adhomai)
"MU" = (
/obj/structure/railing/mapped{
	dir = 8
	},
/turf/simulated/floor/tiled/ramp,
/area/adhomai_hunting)
"QL" = (
/turf/simulated/wall/wood,
/area/adhomai_hunting)
"Rf" = (
/obj/structure/flora/grass/adhomai,
/turf/simulated/floor/exoplanet/snow{
	temperature = 268.15
	},
/area/exoplanet/adhomai)
"Sg" = (
/obj/structure/table/wood/gamblingtable,
/obj/item/deck/tarot/adhomai,
/turf/simulated/floor/wood{
	temperature = 268.15
	},
/area/adhomai_hunting)
"Tu" = (
/mob/living/simple_animal/hostile/commanded/dog/harron{
	dir = 4
	},
/turf/simulated/floor/exoplanet/snow{
	temperature = 268.15
	},
/area/exoplanet/adhomai)
"UG" = (
/obj/machinery/light/small{
	dir = 4
	},
/turf/simulated/floor/wood{
	temperature = 268.15
	},
/area/adhomai_hunting)
"UI" = (
/obj/structure/table/wood,
/obj/item/toy/plushie/farwa,
/turf/simulated/floor/wood{
	temperature = 268.15
	},
/area/adhomai_hunting)
"Vd" = (
/obj/structure/railing/fence{
	dir = 4
	},
/obj/structure/railing/fence{
	dir = 1
	},
/turf/simulated/floor/exoplanet/snow{
	temperature = 268.15
	},
/area/exoplanet/adhomai)
"Vi" = (
/obj/structure/table/wood,
/obj/item/material/ashtray/bronze,
/obj/item/flame/lighter/adhomai{
	pixel_x = 7
	},
/obj/item/clothing/mask/smokable/cigarette/adhomai{
	pixel_x = -5
	},
/turf/simulated/floor/wood{
	temperature = 268.15
	},
/area/adhomai_hunting)
"WR" = (
/obj/structure/table/wood/gamblingtable,
/obj/item/deck/cards,
/turf/simulated/floor/wood{
	temperature = 268.15
	},
/area/adhomai_hunting)
"Xz" = (
/obj/effect/ghostspawpoint{
	identifier = "matake_hunter";
	name = "igs - matake_hunter"
	},
/turf/simulated/floor/wood{
	temperature = 268.15
	},
/area/adhomai_hunting)
"XR" = (
/turf/simulated/floor/carpet/art{
	temperature = 278.15
	},
/area/adhomai_hunting)
"YR" = (
/obj/machinery/light/small{
	dir = 1
	},
/turf/simulated/floor/exoplanet/snow{
	temperature = 268.15
	},
/area/adhomai_hunting)
"ZD" = (
/obj/structure/railing/fence{
	dir = 1
	},
/turf/simulated/floor/exoplanet/snow{
	temperature = 268.15
	},
/area/exoplanet/adhomai)

(1,1,1) = {"
sK
sK
sK
sK
Ha
sK
sK
sK
sK
sK
sK
sK
sK
sK
sK
sK
sK
sK
sK
sK
sK
sK
sK
sK
sK
sK
sK
sK
sK
sK
sK
sK
"}
(2,1,1) = {"
sK
sK
sK
sK
sK
sK
sK
sK
sK
sK
sK
sK
sK
sK
sK
sK
sK
sK
sK
sK
sK
Ii
sK
sK
sK
sK
sK
sK
sK
sK
sK
sK
"}
(3,1,1) = {"
sK
sK
sK
sK
sK
sK
sK
sK
sK
sK
sK
sK
sK
sK
sK
sK
sK
sK
sK
sK
sK
sK
sK
sK
sK
sK
sK
sK
sK
sK
sK
sK
"}
(4,1,1) = {"
sK
sK
sK
sK
sK
sK
sK
sK
sK
sK
sK
Ii
sK
sK
sK
Rf
sK
sK
sK
sK
sK
sK
sK
sK
sK
sK
sK
sK
sK
sK
sK
sK
"}
(5,1,1) = {"
sK
sK
sK
sK
sK
sK
sK
Ii
sK
sK
sK
sK
sK
sK
sK
sK
sK
sK
sK
sK
jN
sK
sK
sK
sK
sK
sK
Rf
sK
sK
sK
sK
"}
(6,1,1) = {"
sK
sK
Rf
sK
sK
jN
sK
sK
sK
sK
sK
sK
sK
sK
sK
sK
sK
sK
sK
sK
sK
sK
sK
Rf
sK
sK
sK
sK
sK
sK
sK
sK
"}
(7,1,1) = {"
sK
sK
sK
sK
sK
sK
sK
sK
sK
sK
sK
sK
sK
sK
sK
sK
sK
sK
sK
sK
sK
sK
sK
sK
sK
sK
sK
sK
sK
sK
sK
sK
"}
(8,1,1) = {"
sK
sK
sK
sK
sK
sK
sK
sK
sK
sK
sK
Rf
sK
sK
sK
sK
sK
sK
sK
sK
Rf
sK
sK
sK
sK
sK
sK
sK
sK
sK
sK
Rf
"}
(9,1,1) = {"
sK
sK
sK
sK
sK
sK
sK
sK
sK
sK
sK
sK
sK
sK
QL
QL
HP
QL
zG
zG
zG
sK
ih
sK
sK
sK
Ii
sK
sK
sK
sK
sK
"}
(10,1,1) = {"
sK
sK
sK
sK
sK
sK
sK
Rf
sK
sK
sK
sK
sK
sK
QL
af
GY
QL
YR
sK
sK
sK
tZ
sK
sK
sK
sK
sK
sK
sK
sK
sK
"}
(11,1,1) = {"
sK
sK
sK
sK
sK
sK
sK
sK
sK
QL
QL
HP
QL
QL
QL
qL
GY
QL
zG
zG
zG
sK
sK
sK
Rf
sK
sK
sK
sK
sK
sK
sK
"}
(12,1,1) = {"
sK
sK
sK
sK
sK
sK
sK
sK
sK
QL
cS
GY
sR
vh
QL
EY
GY
QL
sK
sK
sK
sK
sK
sK
sK
sK
sK
sK
sK
sK
sK
sK
"}
(13,1,1) = {"
sK
sK
sK
sK
sK
sK
QL
QL
QL
QL
Cp
GY
GY
Lm
QL
QL
IU
QL
LO
sK
sK
sK
sK
Ha
sK
sK
sK
sK
sK
sK
sK
sK
"}
(14,1,1) = {"
sK
sK
sK
sK
sK
QL
QL
GY
sR
iA
GY
GY
GY
GY
GY
sR
GY
QL
QL
QL
QL
QL
sK
sK
sK
sK
sK
sK
sK
sK
sK
sK
"}
(15,1,1) = {"
sK
sK
sK
Ha
sK
QL
pn
GY
Lo
GY
GY
IF
WR
gQ
IF
GY
GY
IU
GY
GY
qL
QL
sK
sK
sK
sK
sK
sK
sK
sK
Rf
sK
"}
(16,1,1) = {"
sK
Rf
sK
sK
sK
QL
Ju
Xz
Lo
GY
GY
IF
wZ
BE
IF
GY
GY
QL
EY
GY
pR
QL
sK
sK
sK
sK
sK
Ii
sK
sK
sK
sK
"}
(17,1,1) = {"
sK
sK
sK
sK
sK
QL
pn
GY
Lo
GY
GY
IF
Sg
Cj
IF
GY
Bg
QL
QL
yf
QL
QL
sK
sK
Ha
sK
sK
sK
sK
sK
sK
sK
"}
(18,1,1) = {"
sK
sK
sK
sK
sK
QL
QL
GY
UG
MU
GY
GY
GY
GY
GY
GY
GY
IU
sK
sK
sK
sK
sK
sK
sK
sK
sK
sK
sK
sK
sK
sK
"}
(19,1,1) = {"
sK
sK
sK
sK
sK
sK
QL
QL
QL
QL
qH
xA
sx
GY
GY
GY
Vi
QL
sK
sK
sK
sK
sK
sK
sK
sK
sK
sK
sK
sK
sK
sK
"}
(20,1,1) = {"
sK
Rf
sK
sK
sK
sK
sK
sK
ZD
QL
QL
QL
QL
UI
GY
XR
pk
QL
sK
sK
sK
sK
sK
sK
sK
sK
sK
sK
sK
sK
sK
sK
"}
(21,1,1) = {"
sK
sK
sK
sK
sK
sK
Rf
sK
ZD
sK
Tu
sK
QL
dN
GY
XR
AF
QL
sK
sK
sK
sK
Rf
sK
Rf
sK
sK
sK
sK
sK
sK
sK
"}
(22,1,1) = {"
sK
sK
sK
sK
sK
sK
sK
sK
sK
Tu
sK
gt
QL
Ar
UG
XR
zT
QL
sK
sK
sK
sK
sK
sK
sK
sK
Rf
sK
sK
sK
sK
sK
"}
(23,1,1) = {"
sK
sK
sK
sK
ol
sK
sK
sK
ZD
sK
sK
gT
QL
QL
QL
yf
QL
QL
sK
sK
sK
sK
sK
sK
sK
sK
sK
sK
sK
sK
sK
sK
"}
(24,1,1) = {"
sK
sK
sK
ol
ol
ol
sK
sK
Vd
uD
IT
IT
dK
sK
sK
sK
sK
sK
sK
sK
sK
sK
sK
sK
sK
sK
sK
sK
sK
sK
sK
sK
"}
(25,1,1) = {"
sK
sK
sK
ol
ol
ol
ol
sK
sK
sK
sK
sK
Rf
sK
sK
sK
sK
sK
sK
sK
sK
sK
sK
sK
sK
sK
sK
sK
sK
sK
sK
sK
"}
(26,1,1) = {"
sK
sK
ol
ol
ol
ol
sK
sK
sK
jN
sK
sK
sK
sK
sK
sK
sK
sK
Rf
sK
sK
sK
Rf
sK
sK
sK
Ii
sK
sK
sK
sK
sK
"}
(27,1,1) = {"
sK
Rf
sK
ol
ol
ol
ol
sK
sK
sK
sK
sK
sK
sK
sK
sK
sK
sK
sK
sK
sK
sK
sK
sK
sK
sK
sK
sK
sK
sK
sK
sK
"}
(28,1,1) = {"
sK
sK
sK
sK
sK
ol
ol
ol
sK
sK
sK
sK
sK
sK
sK
sK
sK
sK
sK
sK
sK
sK
sK
sK
sK
sK
sK
sK
sK
sK
Rf
sK
"}
(29,1,1) = {"
sK
sK
sK
sK
sK
ol
ol
sK
sK
sK
sK
sK
sK
Rf
sK
sK
sK
sK
sK
sK
sK
sK
Ii
sK
sK
sK
sK
sK
sK
sK
sK
sK
"}
(30,1,1) = {"
sK
sK
sK
sK
sK
sK
sK
sK
sK
sK
sK
Ha
sK
sK
sK
sK
sK
Ha
sK
sK
sK
sK
sK
sK
sK
sK
sK
sK
sK
sK
sK
sK
"}
(31,1,1) = {"
sK
sK
sK
sK
sK
sK
sK
sK
sK
sK
sK
sK
sK
sK
sK
sK
sK
sK
sK
sK
sK
sK
sK
sK
sK
sK
sK
sK
sK
sK
sK
sK
"}
(32,1,1) = {"
sK
sK
sK
sK
sK
sK
sK
sK
sK
sK
sK
sK
sK
sK
sK
sK
sK
sK
sK
sK
sK
sK
sK
sK
sK
sK
sK
sK
sK
sK
sK
sK
"}
