//MAP CONVERTED BY dmm2tgm.py THIS HEADER COMMENT PREVENTS RECONVERSION, DO NOT REMOVE
"a" = (
/obj/effect/landmark/corpse/pra_soldier,
/obj/structure/pit/closed,
/turf/simulated/floor/exoplanet/snow/cold,
/area/exoplanet/adhomai)
"b" = (
/obj/effect/decal/cleanable/blood/splatter,
/turf/simulated/floor/exoplanet/snow/cold,
/area/exoplanet/adhomai)
"c" = (
/turf/simulated/floor/exoplanet/snow/cold,
/area/exoplanet/adhomai)
"i" = (
/obj/effect/decal/cleanable/blood/splatter,
/obj/item/gun/projectile/pistol/adhomai,
/turf/simulated/floor/exoplanet/snow/cold,
/area/exoplanet/adhomai)
"k" = (
/obj/item/ammo_casing/pistol/used,
/obj/item/ammo_casing/pistol/used,
/turf/simulated/floor/exoplanet/snow/cold,
/area/exoplanet/adhomai)
"m" = (
/turf/simulated/mineral/adhomai,
/area/exoplanet/adhomai)
"n" = (
/obj/item/material/shard/shrapnel,
/turf/simulated/floor/exoplanet/snow/cold,
/area/exoplanet/adhomai)
"o" = (
/obj/structure/pit/closed,
/turf/simulated/floor/exoplanet/snow/cold,
/area/exoplanet/adhomai)
"s" = (
/obj/item/gun/projectile/shotgun/pump/rifle,
/turf/simulated/floor/exoplanet/snow/cold,
/area/exoplanet/adhomai)
"t" = (
/obj/effect/decal/cleanable/blood/splatter,
/obj/item/ammo_casing/pistol/used,
/turf/simulated/floor/exoplanet/snow/cold,
/area/exoplanet/adhomai)
"u" = (
/obj/item/ammo_casing/pistol/used,
/turf/simulated/floor/exoplanet/snow/cold,
/area/exoplanet/adhomai)
"x" = (
/obj/structure/flora/bush/adhomai,
/turf/simulated/floor/exoplanet/snow/cold,
/area/exoplanet/adhomai)
"A" = (
/obj/effect/landmark/corpse/pra_soldier,
/obj/effect/decal/cleanable/blood/splatter,
/turf/simulated/floor/exoplanet/snow/cold,
/area/exoplanet/adhomai)
"C" = (
/obj/structure/flora/grass/adhomai,
/turf/simulated/floor/exoplanet/snow/cold,
/area/exoplanet/adhomai)
"F" = (
/obj/item/gun/projectile/pistol/adhomai,
/turf/simulated/floor/exoplanet/snow/cold,
/area/exoplanet/adhomai)
"G" = (
/obj/item/grenade/frag,
/turf/simulated/floor/exoplanet/snow/cold,
/area/exoplanet/adhomai)
"N" = (
/obj/effect/decal/fake_object{
	icon = 'icons/effects/64x64.dmi';
	icon_state = "adhomai_tank_wreck";
	name = "adhomian tank wreck";
	desc = "The remnants of a second revolution-era tank."
	},
/turf/simulated/floor/exoplanet/snow/cold,
/area/exoplanet/adhomai)
"O" = (
/obj/effect/landmark/corpse/pra_soldier,
/turf/simulated/floor/exoplanet/snow/cold,
/area/exoplanet/adhomai)
"P" = (
/obj/item/ammo_casing/rifle/used,
/turf/simulated/floor/exoplanet/snow/cold,
/area/exoplanet/adhomai)
"U" = (
/obj/item/ammo_casing/rifle/used,
/obj/item/ammo_casing/rifle/used,
/obj/item/ammo_casing/rifle/used,
/turf/simulated/floor/exoplanet/snow/cold,
/area/exoplanet/adhomai)
"X" = (
/obj/structure/flora/tree/adhomai,
/turf/simulated/floor/exoplanet/snow/cold,
/area/exoplanet/adhomai)

(1,1,1) = {"
c
c
c
c
c
c
c
c
m
c
m
c
c
c
c
c
c
c
c
c
c
c
c
c
c
c
c
c
c
c
c
c
"}
(2,1,1) = {"
c
c
c
c
c
c
c
c
m
m
m
c
c
c
c
c
c
c
c
c
c
c
c
c
c
c
c
c
c
c
c
m
"}
(3,1,1) = {"
c
c
c
c
C
c
c
c
m
m
c
c
c
c
c
C
c
c
c
c
c
c
c
X
c
c
c
c
c
c
m
m
"}
(4,1,1) = {"
c
c
c
c
c
c
c
c
m
m
c
c
c
c
c
c
c
c
c
X
c
c
c
c
c
c
c
c
c
c
m
m
"}
(5,1,1) = {"
c
c
c
c
c
c
c
c
c
c
c
c
c
c
c
c
c
c
c
c
c
c
c
c
c
c
C
c
c
m
m
m
"}
(6,1,1) = {"
c
c
C
c
c
x
c
b
c
c
c
c
c
c
c
s
c
c
c
c
c
c
c
c
c
c
c
c
c
m
m
m
"}
(7,1,1) = {"
c
c
c
c
c
c
c
c
c
c
c
O
c
c
c
c
c
c
c
c
c
c
a
c
c
c
c
c
c
m
m
m
"}
(8,1,1) = {"
m
c
c
c
c
c
c
c
c
n
c
c
c
b
c
c
c
c
A
c
c
c
c
c
c
c
c
c
x
m
m
m
"}
(9,1,1) = {"
m
m
c
c
b
c
c
c
c
c
c
c
c
c
u
c
c
c
c
c
c
c
x
c
c
c
c
c
c
m
m
m
"}
(10,1,1) = {"
m
c
c
c
c
c
c
o
c
c
c
c
c
c
c
c
c
c
c
c
c
c
c
c
c
U
c
c
c
m
m
m
"}
(11,1,1) = {"
m
m
c
c
c
c
c
c
c
c
c
c
s
c
c
c
c
c
i
c
c
c
c
c
c
c
c
c
c
m
m
m
"}
(12,1,1) = {"
m
m
c
x
c
c
c
c
c
c
c
c
A
c
c
c
c
c
c
c
c
c
c
c
c
c
x
c
c
m
m
m
"}
(13,1,1) = {"
m
m
c
c
c
c
c
c
c
c
c
c
c
c
k
c
c
c
c
c
c
c
c
c
c
c
c
c
c
c
c
c
"}
(14,1,1) = {"
c
c
c
c
c
c
A
c
c
X
c
c
c
c
c
m
m
c
c
t
c
c
C
c
c
c
c
c
c
c
c
c
"}
(15,1,1) = {"
c
c
c
c
c
c
c
c
c
c
c
c
c
c
c
m
m
c
c
c
c
c
c
c
c
c
c
c
c
c
c
c
"}
(16,1,1) = {"
c
c
c
c
b
c
c
c
c
c
c
G
c
c
c
c
c
c
c
c
c
c
c
c
c
c
c
X
c
c
c
c
"}
(17,1,1) = {"
c
c
c
c
c
c
c
c
c
c
c
c
c
c
O
c
c
u
c
c
c
c
s
c
c
c
c
c
c
c
c
c
"}
(18,1,1) = {"
c
c
x
c
c
c
c
b
c
u
c
c
c
c
c
c
c
c
c
c
c
c
c
c
c
c
c
c
c
c
c
c
"}
(19,1,1) = {"
c
c
c
c
c
c
c
s
c
c
c
c
c
c
P
c
c
c
c
c
c
c
c
c
c
c
c
c
c
c
c
c
"}
(20,1,1) = {"
c
c
c
c
c
c
c
c
c
c
c
c
c
c
c
c
c
c
c
c
c
c
c
c
c
c
c
c
c
X
c
c
"}
(21,1,1) = {"
c
c
C
c
c
c
c
c
c
c
c
c
c
c
c
c
c
c
n
O
c
c
c
c
c
c
c
c
c
c
c
c
"}
(22,1,1) = {"
c
c
c
c
c
N
c
c
c
c
A
c
c
c
c
c
c
c
c
c
c
c
c
c
C
c
c
c
c
c
c
c
"}
(23,1,1) = {"
c
c
c
c
c
c
c
c
c
c
c
c
c
u
c
c
c
c
c
c
c
c
c
F
c
c
c
c
c
c
c
c
"}
(24,1,1) = {"
c
c
c
c
c
c
c
c
c
c
c
c
c
c
b
c
c
c
c
c
c
c
c
c
c
c
P
c
c
c
c
c
"}
(25,1,1) = {"
c
c
c
c
c
c
c
c
c
c
c
c
c
c
c
c
c
c
c
c
c
c
c
c
c
c
c
c
c
c
c
c
"}
(26,1,1) = {"
c
c
c
c
c
X
c
c
c
c
c
c
c
c
c
c
o
c
c
c
C
c
c
c
c
c
c
c
c
c
c
c
"}
(27,1,1) = {"
c
c
c
c
c
c
c
c
c
c
c
c
c
c
c
c
c
c
c
c
c
c
n
c
c
c
c
c
c
c
c
c
"}
(28,1,1) = {"
c
c
c
c
c
c
c
c
c
c
c
X
c
c
x
c
c
c
c
P
c
c
c
c
P
c
c
c
c
c
c
c
"}
(29,1,1) = {"
c
c
c
c
c
c
c
c
c
c
c
c
c
c
c
c
c
c
c
c
c
c
c
c
c
c
c
c
c
c
c
c
"}
(30,1,1) = {"
c
c
c
c
c
c
c
c
c
c
c
c
c
c
C
c
c
c
c
c
c
c
c
c
c
c
c
X
c
c
c
c
"}
(31,1,1) = {"
c
c
c
c
m
m
m
m
m
m
c
c
c
c
c
c
c
c
c
C
c
c
c
c
c
c
c
c
c
c
c
c
"}
(32,1,1) = {"
c
m
m
m
m
m
m
m
m
m
m
m
c
c
c
c
c
c
c
c
c
c
c
c
c
c
c
c
m
m
m
m
"}
