//MAP CONVERTED BY dmm2tgm.py THIS HEADER COMMENT PREVENTS RECONVERSION, DO NOT REMOVE
"a" = (
/obj/item/trash/cigbutt,
/turf/simulated/floor/exoplanet/mineral/adhomai,
/area/exoplanet/adhomai)
"b" = (
/obj/structure/bed/stool/wood,
/turf/simulated/floor/exoplanet/mineral/adhomai,
/area/exoplanet/adhomai)
"c" = (
/turf/simulated/floor/exoplanet/snow/cold,
/area/exoplanet/adhomai)
"h" = (
/obj/item/material/caltrops,
/obj/structure/barricade/wooden,
/turf/simulated/floor/exoplanet/mineral/adhomai,
/area/exoplanet/adhomai)
"i" = (
/obj/structure/closet/crate/weapon/alt,
/obj/item/gun/projectile/dragunov,
/turf/simulated/floor/exoplanet/mineral/adhomai,
/area/exoplanet/adhomai)
"k" = (
/obj/structure/flora/rock/ice,
/turf/simulated/floor/exoplanet/mineral/adhomai,
/area/exoplanet/adhomai)
"m" = (
/turf/simulated/mineral/adhomai,
/area/exoplanet/adhomai)
"p" = (
/obj/structure/target_stake,
/obj/item/target,
/turf/simulated/floor/exoplanet/mineral/adhomai,
/area/exoplanet/adhomai)
"q" = (
/obj/structure/closet/crate/weapon/alt,
/obj/item/gun/projectile/shotgun/pump/rifle,
/obj/item/gun/projectile/shotgun/pump/rifle,
/obj/item/gun/projectile/shotgun/pump/rifle,
/turf/simulated/floor/exoplanet/mineral/adhomai,
/area/exoplanet/adhomai)
"r" = (
/obj/structure/closet/crate/freezer,
/obj/item/storage/field_ration/dpra,
/obj/item/storage/field_ration/dpra,
/obj/item/storage/field_ration/dpra,
/turf/simulated/floor/exoplanet/mineral/adhomai,
/area/exoplanet/adhomai)
"s" = (
/obj/structure/flora/grass/adhomai,
/turf/simulated/floor/exoplanet/snow/cold,
/area/exoplanet/adhomai)
"u" = (
/obj/structure/closet/crate/weapon/alt,
/obj/item/gun/projectile/silenced,
/obj/item/gun/projectile/silenced,
/obj/item/gun/projectile/silenced,
/turf/simulated/floor/exoplanet/mineral/adhomai,
/area/exoplanet/adhomai)
"v" = (
/obj/structure/table/wood,
/obj/item/device/flashlight/flare/torch,
/obj/item/device/flashlight/flare/torch,
/turf/simulated/floor/exoplanet/mineral/adhomai,
/area/exoplanet/adhomai)
"x" = (
/obj/structure/flora/bush/adhomai,
/turf/simulated/floor/exoplanet/snow/cold,
/area/exoplanet/adhomai)
"A" = (
/obj/item/landmine{
	deployed = 1
	},
/obj/structure/barricade/wooden,
/turf/simulated/floor/exoplanet/mineral/adhomai,
/area/exoplanet/adhomai)
"B" = (
/obj/item/trap{
	deployed = 1
	},
/obj/structure/barricade/wooden,
/turf/simulated/floor/exoplanet/mineral/adhomai,
/area/exoplanet/adhomai)
"C" = (
/obj/structure/reagent_dispensers/keg/mead,
/obj/structure/sign/flag/dpra/large/north{
	pixel_y = 32
	},
/turf/simulated/floor/exoplanet/mineral/adhomai,
/area/exoplanet/adhomai)
"F" = (
/obj/structure/barricade/wooden,
/turf/simulated/floor/exoplanet/mineral/adhomai,
/area/exoplanet/adhomai)
"G" = (
/obj/item/reagent_containers/food/drinks/bottle/messa_mead{
	pixel_y = 8
	},
/obj/item/reagent_containers/food/drinks/drinkingglass/newglass/mug{
	pixel_x = -8
	},
/turf/simulated/floor/exoplanet/mineral/adhomai,
/area/exoplanet/adhomai)
"H" = (
/obj/structure/table/wood,
/obj/item/pickaxe,
/obj/item/pickaxe,
/obj/item/pickaxe,
/obj/structure/sign/flag/dpra/large/north{
	pixel_y = 32
	},
/turf/simulated/floor/exoplanet/mineral/adhomai,
/area/exoplanet/adhomai)
"J" = (
/obj/structure/sign/flag/dpra{
	pixel_y = 32;
	stand_icon = null
	},
/turf/simulated/floor/exoplanet/mineral/adhomai,
/area/exoplanet/adhomai)
"K" = (
/obj/structure/closet/crate/weapon/alt,
/obj/item/landmine,
/obj/item/landmine,
/obj/item/landmine,
/turf/simulated/floor/exoplanet/mineral/adhomai,
/area/exoplanet/adhomai)
"L" = (
/obj/structure/bonfire,
/turf/simulated/floor/exoplanet/mineral/adhomai,
/area/exoplanet/adhomai)
"N" = (
/obj/structure/closet/crate/weapon/alt,
/obj/item/material/caltrops,
/obj/item/material/caltrops,
/turf/simulated/floor/exoplanet/mineral/adhomai,
/area/exoplanet/adhomai)
"O" = (
/obj/structure/closet/crate/weapon/alt,
/obj/item/material/knife/trench,
/obj/item/material/knife/trench,
/obj/item/material/knife/trench,
/turf/simulated/floor/exoplanet/mineral/adhomai,
/area/exoplanet/adhomai)
"P" = (
/turf/simulated/floor/exoplanet/mineral/adhomai,
/area/exoplanet/adhomai)
"T" = (
/obj/structure/table/wood,
/obj/structure/sign/painting_frame/nated{
	pixel_y = 32
	},
/obj/item/device/flashlight/lantern,
/obj/item/device/flashlight/lantern,
/obj/item/device/flashlight/lantern,
/turf/simulated/floor/exoplanet/mineral/adhomai,
/area/exoplanet/adhomai)
"U" = (
/obj/structure/closet/crate/weapon/alt,
/obj/item/grenade/frag,
/obj/item/grenade/frag,
/obj/item/grenade/frag,
/turf/simulated/floor/exoplanet/mineral/adhomai,
/area/exoplanet/adhomai)
"W" = (
/obj/structure/closet/crate/weapon/alt,
/obj/item/storage/box/dynamite,
/obj/item/flame/lighter/adhomai,
/turf/simulated/floor/exoplanet/mineral/adhomai,
/area/exoplanet/adhomai)
"X" = (
/obj/structure/flora/tree/adhomai,
/turf/simulated/floor/exoplanet/snow/cold,
/area/exoplanet/adhomai)

(1,1,1) = {"
c
c
c
c
c
c
c
c
c
c
c
c
c
c
c
c
c
X
c
c
c
c
c
c
c
c
c
c
c
c
s
c
"}
(2,1,1) = {"
c
X
c
c
c
c
c
c
c
c
X
c
c
c
c
c
c
c
c
c
c
s
c
c
c
c
c
c
c
c
c
c
"}
(3,1,1) = {"
c
c
c
c
c
c
x
c
c
c
c
c
c
c
c
c
c
c
c
c
c
c
c
c
c
c
X
c
c
c
c
c
"}
(4,1,1) = {"
c
c
c
c
X
c
c
c
c
c
c
c
c
c
c
X
c
c
x
c
c
c
m
c
c
c
c
c
c
c
c
c
"}
(5,1,1) = {"
c
c
c
c
c
c
c
c
s
c
c
c
c
c
c
c
c
c
c
c
m
c
m
c
c
c
c
c
x
c
c
c
"}
(6,1,1) = {"
c
c
c
c
c
c
c
c
c
c
c
x
c
c
c
c
c
c
m
m
m
m
m
m
m
m
c
c
c
c
c
c
"}
(7,1,1) = {"
c
c
c
c
c
x
c
c
c
X
c
c
c
c
c
c
c
c
m
m
m
m
m
m
m
m
c
c
c
c
s
c
"}
(8,1,1) = {"
c
c
X
c
c
c
c
c
c
c
c
c
c
c
m
m
m
m
m
m
m
m
m
m
m
m
c
c
c
c
c
c
"}
(9,1,1) = {"
c
c
c
c
c
c
c
c
c
c
c
c
c
c
m
m
m
m
m
P
P
m
m
m
c
c
c
s
c
c
c
c
"}
(10,1,1) = {"
c
c
c
c
m
m
m
m
m
m
m
m
m
m
m
m
m
m
m
P
P
K
m
m
c
c
c
c
c
c
c
c
"}
(11,1,1) = {"
c
c
s
c
m
m
m
m
m
m
m
m
m
m
m
m
m
N
P
P
P
O
m
m
c
c
c
c
c
c
X
c
"}
(12,1,1) = {"
c
c
c
c
m
m
m
m
m
m
m
m
m
m
m
m
m
m
P
P
P
U
m
m
c
c
x
c
c
c
c
c
"}
(13,1,1) = {"
x
c
c
m
m
m
m
m
m
m
m
P
p
p
P
P
m
m
P
P
P
m
m
m
c
c
c
c
c
c
c
c
"}
(14,1,1) = {"
c
c
c
m
m
m
m
m
W
P
P
P
P
P
P
P
m
P
P
P
m
m
m
m
c
c
c
c
c
c
x
c
"}
(15,1,1) = {"
c
c
m
m
m
m
m
m
P
P
P
k
P
P
P
P
A
P
P
P
m
m
c
c
c
s
c
c
c
c
c
c
"}
(16,1,1) = {"
c
c
m
m
m
m
C
P
P
P
P
P
P
P
P
P
m
m
m
m
m
m
c
c
c
c
c
c
c
c
c
c
"}
(17,1,1) = {"
c
c
m
m
m
m
v
P
P
b
P
P
P
P
P
P
m
m
m
m
m
m
c
c
c
c
c
c
c
c
c
c
"}
(18,1,1) = {"
c
c
m
m
m
m
T
P
b
L
b
P
P
P
m
m
m
m
m
m
m
m
c
c
c
c
X
c
c
c
c
c
"}
(19,1,1) = {"
s
c
m
m
m
m
H
P
a
b
G
P
P
P
m
m
P
P
m
m
m
m
m
c
c
c
c
c
c
c
c
X
"}
(20,1,1) = {"
c
c
m
m
m
m
r
P
P
P
P
P
P
P
P
m
P
P
P
P
P
m
m
c
c
c
c
c
c
c
c
c
"}
(21,1,1) = {"
c
c
m
m
m
m
m
P
P
P
m
P
P
P
P
B
P
P
k
P
P
m
m
m
c
c
c
c
c
c
c
c
"}
(22,1,1) = {"
c
c
c
m
m
m
q
P
P
m
m
P
P
P
P
A
P
P
P
P
P
P
P
h
c
c
c
x
c
c
c
c
"}
(23,1,1) = {"
x
c
c
m
m
m
u
P
P
m
m
P
P
P
P
F
P
P
P
P
P
P
P
m
c
c
c
c
c
c
c
c
"}
(24,1,1) = {"
c
c
c
m
m
m
i
P
P
m
m
k
P
m
m
m
m
J
P
P
P
P
P
m
c
s
c
c
c
c
c
x
"}
(25,1,1) = {"
c
c
c
c
m
m
m
m
m
m
m
P
P
m
m
m
m
P
P
P
P
P
P
m
c
c
c
c
c
c
c
c
"}
(26,1,1) = {"
c
c
c
c
m
m
m
m
m
m
m
m
m
m
m
m
m
m
P
P
P
P
P
m
c
c
c
c
c
s
c
c
"}
(27,1,1) = {"
c
c
c
c
m
m
m
m
m
m
m
m
m
m
m
m
m
m
m
m
m
P
P
m
c
c
x
c
c
c
c
c
"}
(28,1,1) = {"
c
c
c
c
m
m
m
m
m
m
m
m
m
m
m
m
m
m
m
m
m
P
k
m
c
c
c
c
c
c
c
c
"}
(29,1,1) = {"
c
s
c
x
m
m
m
m
m
m
m
m
m
m
m
m
m
m
m
m
m
P
P
m
c
c
c
c
c
c
c
c
"}
(30,1,1) = {"
c
c
c
c
m
m
m
m
m
m
m
m
m
m
m
m
m
m
m
m
m
P
P
m
c
c
c
s
c
c
X
c
"}
(31,1,1) = {"
c
c
X
c
m
m
m
m
m
m
m
m
m
m
m
m
m
m
m
m
m
m
m
m
c
c
c
c
x
c
c
c
"}
(32,1,1) = {"
c
c
c
c
c
c
c
c
c
c
c
c
c
s
c
m
m
m
m
m
m
m
m
m
m
m
c
c
c
c
c
c
"}
