//MAP CONVERTED BY dmm2tgm.py THIS HEADER COMMENT PREVENTS RECONVERSION, DO NOT REMOVE
"aa" = (
/obj/structure/table/wood,
/obj/item/storage/box/fancy/cigarettes/nka,
/obj/item/storage/box/fancy/cigarettes/nka,
/obj/item/storage/box/fancy/cigarettes/nka,
/obj/item/storage/box/fancy/cigarettes/nka,
/obj/item/storage/box/fancy/cigarettes/nka,
/obj/item/storage/box/fancy/cigarettes/nka,
/obj/item/flame/lighter/adhomai,
/turf/simulated/floor/exoplanet/wood,
/area/nka_base)
"ak" = (
/obj/structure/sign/painting_frame/shumaila{
	pixel_y = 31
	},
/turf/simulated/floor/exoplanet/tiled,
/area/nka_base)
"bK" = (
/obj/item/reagent_containers/glass/bucket/wood{
	pixel_x = 11;
	pixel_y = -11
	},
/turf/simulated/floor/exoplanet/snow{
	temperature = 268.15
	},
/area/nka_base)
"bR" = (
/obj/machinery/light/small{
	dir = 8
	},
/turf/simulated/floor/exoplanet/wood,
/area/nka_base)
"bU" = (
/obj/structure/simple_door/wood{
	initial_lock_value = "nka_commander"
	},
/turf/simulated/floor/exoplanet/wood,
/area/nka_base)
"cM" = (
/obj/structure/simple_door/iron{
	initial_lock_value = "nka_cell";
	name = "cell"
	},
/turf/simulated/floor/exoplanet/tiled,
/area/nka_base)
"eF" = (
/obj/structure/sign/emergency/meetingpoint{
	name = "\improper AID STATION sign";
	desc = "A green sign which showcases the location of a medical aid station.";
	pixel_y = -32
	},
/turf/simulated/floor/exoplanet/barren{
	temperature = 268.15
	},
/area/nka_base)
"fq" = (
/obj/structure/bed/padded,
/obj/structure/curtain/open/bed,
/obj/item/bedsheet/blue,
/turf/simulated/floor/exoplanet/wood,
/area/nka_base)
"fY" = (
/obj/structure/sign/flag/nka{
	pixel_x = -32
	},
/turf/simulated/floor/exoplanet/snow{
	temperature = 268.15
	},
/area/nka_base)
"gF" = (
/obj/structure/bed/stool/chair/wood,
/obj/item/handcuffs,
/obj/item/handcuffs/legcuffs,
/obj/effect/decal/cleanable/blood,
/turf/simulated/floor/exoplanet/tiled,
/area/nka_base)
"gU" = (
/obj/structure/blocker/steel/fence{
	dir = 4
	},
/turf/simulated/floor/exoplanet/snow{
	temperature = 268.15
	},
/area/nka_base)
"hK" = (
/obj/item/stack/material/wood/log/full,
/obj/item/stack/material/wood/log/full,
/obj/item/stack/material/wood/log/full,
/obj/structure/closet/crate/bin{
	name = "fire wood bin"
	},
/turf/simulated/floor/exoplanet/snow{
	temperature = 268.15
	},
/area/nka_base)
"hT" = (
/obj/structure/flora/bush/adhomai,
/turf/simulated/floor/exoplanet/snow{
	temperature = 268.15
	},
/area/exoplanet/adhomai)
"ji" = (
/obj/machinery/light/small{
	dir = 4
	},
/turf/simulated/floor/exoplanet/snow{
	temperature = 268.15
	},
/area/nka_base)
"jN" = (
/obj/structure/table/rack,
/obj/item/shovel,
/obj/item/shovel,
/obj/item/shovel,
/turf/simulated/floor/exoplanet/snow{
	temperature = 268.15
	},
/area/nka_base)
"ka" = (
/obj/structure/bed/padded,
/turf/simulated/floor/exoplanet/tiled,
/area/nka_base)
"kO" = (
/obj/structure/bed/stool/chair/wood{
	dir = 8
	},
/obj/effect/ghostspawpoint{
	identifier = "nka_base_commander";
	name = "igs - nka_base_commander"
	},
/turf/simulated/floor/exoplanet/wood,
/area/nka_base)
"lX" = (
/obj/machinery/light/small,
/turf/simulated/floor/exoplanet/snow{
	temperature = 268.15
	},
/area/nka_base)
"mf" = (
/obj/structure/closet/secure_closet/cabinet{
	req_access = list(213);
	name = "rifle cabinet"
	},
/obj/item/gun/projectile/shotgun/pump/rifle,
/obj/item/gun/projectile/shotgun/pump/rifle,
/obj/item/gun/projectile/shotgun/pump/rifle,
/obj/item/gun/projectile/shotgun/pump/rifle,
/obj/effect/floor_decal/industrial/outline/blue,
/turf/simulated/floor/exoplanet/tiled,
/area/nka_base)
"mj" = (
/obj/structure/window/reinforced{
	dir = 4
	},
/obj/structure/table/wood,
/obj/item/key{
	key_data = "nka_base_entry";
	name = "gate key"
	},
/obj/item/key{
	key_data = "nka_base_entry";
	name = "gate key"
	},
/turf/simulated/floor/exoplanet/wood,
/area/nka_base)
"mB" = (
/turf/simulated/floor/exoplanet/wood,
/area/nka_base)
"nc" = (
/obj/structure/bed/padded,
/obj/item/bedsheet/brown,
/obj/structure/curtain/open/bed,
/obj/effect/ghostspawpoint{
	identifier = "nka_base_soldier";
	name = "igs - nka_base_soldier"
	},
/turf/simulated/floor/exoplanet/wood,
/area/nka_base)
"nA" = (
/obj/machinery/shower{
	dir = 1
	},
/obj/structure/curtain/open/shower,
/obj/machinery/light/small{
	dir = 4
	},
/turf/simulated/floor/exoplanet/barren{
	temperature = 268.15
	},
/area/nka_base)
"oA" = (
/obj/structure/simple_door/iron{
	initial_lock_value = "nka_base_entry"
	},
/turf/simulated/floor/exoplanet/barren{
	temperature = 268.15
	},
/area/nka_base)
"pb" = (
/obj/structure/table/rack,
/obj/item/wrench,
/obj/item/screwdriver,
/turf/simulated/floor/exoplanet/snow{
	temperature = 268.15
	},
/area/nka_base)
"pB" = (
/obj/structure/closet/cabinet,
/obj/item/clothing/shoes/jackboots/tajara,
/obj/item/clothing/under/tajaran/nka_uniform,
/obj/item/clothing/head/tajaran/nka_cap,
/obj/item/clothing/accessory/badge/nka_passport,
/turf/simulated/floor/exoplanet/wood,
/area/nka_base)
"pV" = (
/obj/structure/flora/bush/adhomai,
/turf/simulated/floor/exoplanet/snow{
	temperature = 268.15
	},
/area/nka_base)
"qa" = (
/obj/structure/reagent_dispensers/keg/mead,
/obj/machinery/light/small{
	dir = 8
	},
/turf/simulated/floor/exoplanet/wood,
/area/nka_base)
"qE" = (
/obj/structure/reagent_dispensers/coolanttank{
	reagents_to_add = list(/singleton/reagent/water=1000);
	name = "water tank";
	desc = "A tank of water filed by melting local snow."
	},
/turf/simulated/floor/exoplanet/snow{
	temperature = 268.15
	},
/area/nka_base)
"rV" = (
/obj/machinery/light/small{
	dir = 8
	},
/obj/effect/decal/cleanable/blood/drip,
/turf/simulated/floor/exoplanet/wood,
/area/nka_base)
"tI" = (
/obj/structure/closet/walllocker/medical{
	pixel_y = 31
	},
/obj/item/stack/medical/bruise_pack/full,
/obj/item/stack/medical/bruise_pack/full,
/obj/item/stack/medical/bruise_pack/full,
/obj/item/stack/medical/splint/full,
/obj/item/stack/medical/splint/full,
/obj/item/stack/medical/ointment/full,
/obj/item/clothing/suit/storage/hooded/tajaran/surgery,
/obj/item/reagent_containers/blood/OMinus,
/turf/simulated/floor/exoplanet/wood,
/area/nka_base)
"tT" = (
/obj/effect/floor_decal/industrial/outline/blue,
/obj/structure/closet/secure_closet/cabinet{
	req_access = list(213);
	name = "bayonet cabinet"
	},
/obj/item/clothing/accessory/storage/bayonet,
/obj/item/clothing/accessory/storage/bayonet,
/obj/item/clothing/accessory/storage/bayonet,
/obj/item/clothing/accessory/storage/bayonet,
/obj/item/clothing/accessory/storage/bayonet,
/obj/item/clothing/accessory/storage/bayonet,
/turf/simulated/floor/exoplanet/tiled,
/area/nka_base)
"uO" = (
/obj/structure/table/wood,
/obj/item/storage/pill_bottle/dice/tajara,
/obj/item/deck/cards,
/obj/machinery/light/small,
/turf/simulated/floor/exoplanet/wood,
/area/nka_base)
"vd" = (
/obj/structure/table/standard,
/obj/item/surgery/scalpel,
/obj/item/surgery/retractor,
/obj/item/flame/lighter/adhomai,
/obj/effect/decal/cleanable/blood/drip,
/obj/item/surgery/circular_saw,
/obj/item/tape_roll,
/obj/item/stack/cable_coil,
/turf/simulated/floor/exoplanet/wood,
/area/nka_base)
"vi" = (
/turf/simulated/floor/exoplanet/snow{
	temperature = 268.15
	},
/area/exoplanet/adhomai)
"vl" = (
/obj/item/reagent_containers/glass/bucket/wood{
	pixel_x = 9
	},
/turf/simulated/floor/exoplanet/wood,
/area/nka_base)
"vs" = (
/obj/structure/table/wood,
/obj/item/saddle,
/obj/item/saddle,
/turf/simulated/floor/exoplanet/wood,
/area/nka_base)
"vQ" = (
/obj/structure/closet/secure_closet/cabinet{
	req_access = list(213);
	name = "revolver ammunition cabinet"
	},
/obj/effect/floor_decal/industrial/outline/blue,
/obj/item/ammo_magazine/c38,
/obj/item/ammo_magazine/c38,
/obj/item/ammo_magazine/c38,
/obj/item/ammo_magazine/c38,
/obj/item/ammo_magazine/c38,
/obj/item/ammo_magazine/c38,
/turf/simulated/floor/exoplanet/tiled,
/area/nka_base)
"vX" = (
/obj/structure/reagent_dispensers/keg/mead{
	reagents_to_add = list(/singleton/reagent/water=1000);
	name = "water barrel"
	},
/turf/simulated/floor/exoplanet/wood,
/area/nka_base)
"wy" = (
/obj/structure/bonfire,
/turf/simulated/floor/exoplanet/snow{
	temperature = 268.15
	},
/area/nka_base)
"wB" = (
/obj/machinery/light/small{
	dir = 4
	},
/obj/structure/sign/flag/nka{
	pixel_x = 32
	},
/turf/simulated/floor/exoplanet/snow{
	temperature = 268.15
	},
/area/nka_base)
"wC" = (
/obj/structure/closet/secure_closet/cabinet{
	req_access = list(213);
	name = "explosive cabinet"
	},
/obj/item/grenade/frag,
/obj/item/grenade/frag,
/obj/item/grenade/frag,
/obj/item/grenade/frag,
/obj/item/landmine,
/obj/item/landmine,
/obj/item/landmine,
/obj/item/landmine,
/obj/effect/floor_decal/industrial/outline/blue,
/turf/simulated/floor/exoplanet/tiled,
/area/nka_base)
"xj" = (
/obj/item/gun/projectile/automatic/tommygun,
/obj/effect/floor_decal/industrial/outline/blue,
/obj/structure/closet/secure_closet/cabinet{
	req_access = list(213);
	name = "revolver ammunition cabinet"
	},
/obj/machinery/light/small{
	dir = 8
	},
/turf/simulated/floor/exoplanet/tiled,
/area/nka_base)
"xN" = (
/obj/item/gun/projectile/revolver/adhomian,
/obj/item/gun/projectile/revolver/adhomian,
/obj/item/gun/projectile/revolver/adhomian,
/obj/item/gun/projectile/revolver/adhomian,
/obj/effect/floor_decal/industrial/outline/blue,
/obj/structure/closet/secure_closet/cabinet{
	req_access = list(213);
	name = "revolver cabinet"
	},
/obj/structure/sign/flag/nka{
	pixel_x = -32
	},
/turf/simulated/floor/exoplanet/tiled,
/area/nka_base)
"yk" = (
/obj/machinery/shower{
	dir = 1
	},
/obj/structure/curtain/open/shower,
/obj/machinery/light/small{
	dir = 8
	},
/turf/simulated/floor/exoplanet/barren{
	temperature = 268.15
	},
/area/nka_base)
"yx" = (
/obj/machinery/light/small{
	dir = 8
	},
/turf/simulated/floor/exoplanet/snow{
	temperature = 268.15
	},
/area/nka_base)
"yB" = (
/turf/simulated/wall/wood,
/area/nka_base)
"zC" = (
/obj/item/clothing/head/helmet/kettle,
/obj/item/clothing/head/helmet/kettle,
/obj/item/clothing/head/helmet/kettle,
/obj/item/clothing/head/helmet/kettle,
/obj/item/clothing/suit/armor/cuirass,
/obj/item/clothing/suit/armor/cuirass,
/obj/item/clothing/suit/armor/cuirass,
/obj/item/clothing/suit/armor/cuirass,
/obj/item/clothing/gloves/tajaran_gauntlets,
/obj/item/clothing/gloves/tajaran_gauntlets,
/obj/item/clothing/gloves/tajaran_gauntlets,
/obj/item/clothing/gloves/tajaran_gauntlets,
/obj/item/clothing/shoes/tajara/armored,
/obj/item/clothing/shoes/tajara/armored,
/obj/item/clothing/shoes/tajara/armored,
/obj/item/clothing/shoes/tajara/armored,
/obj/effect/floor_decal/industrial/outline/blue,
/obj/structure/closet/secure_closet/cabinet{
	req_access = list(213);
	name = "armor cabinet"
	},
/obj/structure/sign/flag/nka{
	pixel_x = -32
	},
/turf/simulated/floor/exoplanet/tiled,
/area/nka_base)
"Ab" = (
/obj/structure/bonfire/fireplace{
	density = 0
	},
/obj/structure/bedsheetbin{
	pixel_y = -4;
	pixel_x = 9
	},
/obj/item/clothing/under/tajaran/nka_uniform{
	pixel_x = 10
	},
/turf/simulated/floor/exoplanet/wood,
/area/nka_base)
"AC" = (
/obj/item/reagent_containers/glass/bucket/wood{
	pixel_y = 6;
	pixel_x = 10
	},
/turf/simulated/floor/exoplanet/tiled,
/area/nka_base)
"BZ" = (
/obj/structure/closet/secure_closet/cabinet{
	req_access = list(213);
	name = "rifle ammunition cabinet"
	},
/obj/item/ammo_magazine/boltaction,
/obj/item/ammo_magazine/boltaction,
/obj/item/ammo_magazine/boltaction,
/obj/item/ammo_magazine/boltaction,
/obj/item/ammo_magazine/boltaction,
/obj/item/ammo_magazine/boltaction,
/obj/item/ammo_magazine/boltaction,
/obj/item/ammo_magazine/boltaction,
/obj/effect/floor_decal/industrial/outline/blue,
/turf/simulated/floor/exoplanet/tiled,
/area/nka_base)
"CO" = (
/turf/simulated/wall/iron,
/area/nka_base)
"CW" = (
/obj/machinery/light/small,
/turf/simulated/floor/exoplanet/tiled,
/area/nka_base)
"DB" = (
/obj/structure/simple_door/iron{
	initial_lock_value = "nka_armory"
	},
/turf/simulated/floor/exoplanet/tiled,
/area/nka_base)
"DL" = (
/turf/simulated/floor/exoplanet/snow{
	temperature = 268.15
	},
/area/nka_base)
"Ec" = (
/obj/structure/closet/cabinet,
/obj/item/clothing/shoes/jackboots/tajara,
/obj/item/clothing/under/tajaran/nka_uniform,
/obj/item/clothing/head/tajaran/nka_cap,
/obj/item/clothing/accessory/badge/nka_passport,
/obj/machinery/light/small{
	dir = 8
	},
/turf/simulated/floor/exoplanet/wood,
/area/nka_base)
"Em" = (
/obj/structure/table/standard,
/obj/item/device/flashlight/lamp/green{
	pixel_y = 12;
	pixel_x = 5
	},
/obj/item/reagent_containers/food/drinks/drinkingglass/newglass/shot{
	pixel_y = 10;
	pixel_x = -7
	},
/obj/item/stack/medical/bruise_pack/full,
/obj/item/reagent_containers/food/drinks/bottle/treebark_firewater{
	pixel_y = -16;
	pixel_x = 9
	},
/turf/simulated/floor/exoplanet/wood,
/area/nka_base)
"Et" = (
/obj/structure/closet/cabinet,
/obj/item/clothing/shoes/jackboots/tajara,
/obj/item/clothing/under/tajaran/nka_uniform,
/obj/item/clothing/head/tajaran/nka_cap,
/obj/item/clothing/accessory/badge/nka_passport,
/obj/machinery/light/small{
	dir = 4
	},
/turf/simulated/floor/exoplanet/wood,
/area/nka_base)
"EK" = (
/obj/structure/blocker/steel/fence,
/turf/simulated/floor/exoplanet/snow{
	temperature = 268.15
	},
/area/nka_base)
"EP" = (
/turf/simulated/floor/exoplanet/barren{
	temperature = 268.15
	},
/area/nka_base)
"Fo" = (
/obj/structure/curtain/black{
	pixel_y = -33
	},
/turf/simulated/floor/exoplanet/barren{
	temperature = 268.15
	},
/area/nka_base)
"IG" = (
/obj/structure/closet/outhouse,
/turf/simulated/floor/exoplanet/snow{
	temperature = 268.15
	},
/area/nka_base)
"Jc" = (
/obj/structure/closet/cabinet,
/obj/item/reagent_containers/food/drinks/bottle/messa_mead,
/obj/item/reagent_containers/food/drinks/bottle/messa_mead,
/obj/item/reagent_containers/food/drinks/bottle/messa_mead,
/obj/item/reagent_containers/food/drinks/drinkingglass/newglass/mug,
/obj/item/reagent_containers/food/drinks/drinkingglass/newglass/mug,
/obj/item/reagent_containers/food/drinks/bottle/nmshaan_liquor,
/turf/simulated/floor/exoplanet/wood,
/area/nka_base)
"Jg" = (
/obj/structure/closet/secure_closet/cabinet{
	req_access = list(213);
	name = "submachine gun ammunition cabinet"
	},
/obj/effect/floor_decal/industrial/outline/blue,
/obj/item/ammo_magazine/submachinemag,
/obj/item/ammo_magazine/submachinemag,
/obj/item/ammo_magazine/submachinedrum,
/turf/simulated/floor/exoplanet/tiled,
/area/nka_base)
"Md" = (
/obj/machinery/light/small{
	dir = 1
	},
/turf/simulated/floor/exoplanet/tiled,
/area/nka_base)
"NP" = (
/obj/structure/table/wood,
/obj/item/paper_bin,
/obj/item/pen/black,
/obj/structure/sign/painting_frame/shumaila{
	pixel_x = -32
	},
/turf/simulated/floor/exoplanet/wood,
/area/nka_base)
"NW" = (
/obj/structure/table/wood,
/obj/item/device/binoculars/spyglass,
/obj/item/storage/box/fancy/cigarettes/cigar,
/obj/item/flame/lighter/adhomai,
/obj/machinery/light/small{
	dir = 8
	},
/obj/item/key{
	key_data = "nka_armory";
	name = "armory key";
	pixel_x = 5
	},
/obj/item/key{
	key_data = "nka_cell";
	name = "cell key";
	pixel_x = -5
	},
/obj/item/key{
	key_data = "nka_commander";
	name = "officer room key";
	pixel_x = -5
	},
/turf/simulated/floor/exoplanet/wood,
/area/nka_base)
"Qx" = (
/obj/structure/sign/flag/nka/large/south,
/turf/simulated/floor/exoplanet/wood,
/area/nka_base)
"Rb" = (
/turf/simulated/floor/exoplanet/tiled,
/area/nka_base)
"Rg" = (
/obj/effect/map_effect/window_spawner/basic,
/turf/simulated/floor/exoplanet/tiled,
/area/nka_base)
"Sr" = (
/obj/structure/bed/padded,
/obj/item/bedsheet/brown,
/obj/structure/curtain/open/bed,
/turf/simulated/floor/exoplanet/wood,
/area/nka_base)
"St" = (
/obj/structure/bed/stool/bar/padded/brown,
/obj/structure/sign/flag/nka{
	pixel_y = 32
	},
/turf/simulated/floor/exoplanet/wood,
/area/nka_base)
"SZ" = (
/obj/structure/table/standard,
/obj/item/reagent_containers/glass/rag/handkerchief,
/obj/item/reagent_containers/blood/empty,
/obj/item/reagent_containers/syringe,
/obj/effect/decal/cleanable/blood/drip,
/turf/simulated/floor/exoplanet/wood,
/area/nka_base)
"TH" = (
/obj/structure/bed/padded,
/obj/effect/decal/cleanable/blood/drip,
/obj/item/bedsheet/medical,
/turf/simulated/floor/exoplanet/wood,
/area/nka_base)
"Up" = (
/obj/structure/table/wood,
/obj/item/device/flashlight/lamp,
/obj/structure/sign/flag/nka/large/north,
/turf/simulated/floor/exoplanet/wood,
/area/nka_base)
"Uz" = (
/obj/item/torch,
/obj/effect/decal/cleanable/ash,
/turf/simulated/floor/exoplanet/snow{
	temperature = 268.15
	},
/area/nka_base)
"UX" = (
/obj/structure/bed/stool/bar/padded/brown,
/turf/simulated/floor/exoplanet/wood,
/area/nka_base)
"Vn" = (
/obj/structure/simple_door/wood{
	name = "shower"
	},
/turf/simulated/floor/exoplanet/barren{
	temperature = 268.15
	},
/area/nka_base)
"Vy" = (
/obj/structure/table/wood,
/obj/item/book/manual/nka_manifesto,
/turf/simulated/floor/exoplanet/wood,
/area/nka_base)
"VN" = (
/obj/structure/closet/cabinet,
/obj/item/clothing/shoes/jackboots/tajara,
/obj/item/clothing/under/tajaran/nka_uniform/commander,
/obj/item/clothing/head/tajaran/nka_cap/commander,
/obj/item/ammo_magazine/c38,
/obj/item/ammo_magazine/c38,
/obj/machinery/light/small{
	dir = 1
	},
/turf/simulated/floor/exoplanet/wood,
/area/nka_base)
"WG" = (
/obj/structure/simple_door/wood,
/turf/simulated/floor/exoplanet/wood,
/area/nka_base)
"WS" = (
/obj/structure/closet/crate/freezer,
/obj/item/storage/field_ration/nka/army,
/obj/item/storage/field_ration/nka/army,
/obj/item/storage/field_ration/nka/army,
/obj/item/storage/field_ration/nka/army,
/obj/item/storage/field_ration/nka/army,
/obj/item/reagent_containers/food/drinks/drinkingglass/newglass/mug,
/obj/item/reagent_containers/food/drinks/drinkingglass/newglass/mug,
/obj/item/reagent_containers/food/drinks/drinkingglass/newglass/mug,
/obj/item/reagent_containers/food/drinks/drinkingglass/newglass/mug,
/turf/simulated/floor/exoplanet/wood,
/area/nka_base)
"Xb" = (
/obj/machinery/door/window/brigdoor{
	dir = 4;
	req_access = list(213);
	name = "checkpoint"
	},
/obj/structure/table/wood,
/obj/item/paper_bin,
/obj/item/pen/black,
/turf/simulated/floor/exoplanet/wood,
/area/nka_base)
"Yr" = (
/obj/structure/sign/flag/nka/large/north,
/turf/simulated/floor/exoplanet/wood,
/area/nka_base)
"Yv" = (
/obj/structure/railing/fence,
/obj/structure/railing/fence{
	dir = 8
	},
/obj/structure/railing/fence{
	dir = 4
	},
/obj/vehicle/animal/climber,
/turf/simulated/floor/exoplanet/wood,
/area/nka_base)
"YC" = (
/obj/machinery/light/small{
	dir = 8
	},
/obj/item/trash/tray,
/turf/simulated/floor/exoplanet/tiled,
/area/nka_base)
"YD" = (
/obj/structure/table/wood,
/obj/machinery/light/small,
/obj/machinery/photocopier/faxmachine{
	department = "NKA Outpost";
	req_one_access = null
	},
/turf/simulated/floor/exoplanet/wood,
/area/nka_base)
"YT" = (
/obj/item/reagent_containers/glass/bucket/wood{
	pixel_y = 19
	},
/turf/simulated/floor/exoplanet/wood,
/area/nka_base)

(1,1,1) = {"
DL
DL
DL
vi
vi
vi
vi
vi
vi
vi
vi
vi
vi
hT
vi
vi
vi
vi
vi
vi
vi
vi
vi
vi
vi
hT
vi
vi
vi
vi
vi
vi
"}
(2,1,1) = {"
DL
DL
DL
vi
vi
vi
vi
vi
vi
vi
vi
vi
vi
vi
vi
vi
vi
vi
vi
hT
vi
vi
vi
vi
vi
vi
vi
vi
vi
vi
vi
vi
"}
(3,1,1) = {"
DL
DL
pV
vi
vi
vi
vi
vi
vi
vi
hT
vi
vi
vi
vi
vi
vi
vi
vi
vi
vi
vi
vi
vi
vi
vi
vi
vi
vi
vi
vi
vi
"}
(4,1,1) = {"
DL
DL
DL
CO
EK
EK
EK
EK
EK
EK
EK
EK
EK
EK
EK
EK
EK
EK
EK
EK
EK
EK
EK
EK
EK
EK
EK
EK
EK
EK
EK
CO
"}
(5,1,1) = {"
DL
DL
DL
CO
CO
CO
CO
DL
DL
DL
DL
DL
DL
DL
DL
DL
DL
DL
DL
DL
DL
DL
DL
DL
DL
DL
DL
DL
DL
DL
DL
gU
"}
(6,1,1) = {"
pV
DL
lX
CO
St
bR
WG
DL
DL
DL
DL
DL
hK
wy
Uz
DL
DL
DL
DL
DL
DL
DL
DL
DL
DL
DL
qE
yB
yB
yB
DL
gU
"}
(7,1,1) = {"
DL
DL
DL
CO
Xb
mj
CO
DL
DL
DL
DL
DL
DL
DL
DL
DL
DL
DL
DL
DL
DL
DL
DL
DL
DL
DL
DL
Vn
yk
yB
DL
gU
"}
(8,1,1) = {"
EP
EP
EP
oA
EP
EP
oA
EP
EP
EP
EP
EP
EP
EP
EP
EP
EP
EP
EP
EP
EP
EP
EP
EP
EP
EP
DL
yB
yB
yB
DL
gU
"}
(9,1,1) = {"
EP
EP
EP
gU
DL
DL
gU
EP
EP
EP
EP
EP
EP
EP
EP
EP
EP
EP
EP
EP
EP
EP
EP
EP
EP
EP
DL
Vn
nA
yB
DL
gU
"}
(10,1,1) = {"
EP
EP
EP
oA
EP
EP
oA
EP
EP
EP
EP
EP
EP
EP
EP
EP
EP
EP
EP
EP
EP
EP
EP
EP
EP
EP
DL
yB
yB
yB
DL
gU
"}
(11,1,1) = {"
DL
DL
DL
CO
EK
EK
CO
DL
DL
DL
DL
DL
EP
DL
wB
DL
DL
DL
DL
DL
DL
pb
jN
DL
EP
EP
DL
DL
DL
DL
DL
gU
"}
(12,1,1) = {"
DL
DL
DL
gU
DL
DL
DL
DL
DL
DL
DL
yB
WG
yB
yB
yB
yB
yB
yB
yB
yB
yB
yB
DL
EP
EP
yB
yB
yB
yB
yB
gU
"}
(13,1,1) = {"
DL
DL
DL
gU
DL
DL
DL
DL
DL
DL
DL
yB
mB
WS
qa
pB
Sr
Ec
nc
vX
YT
UX
yB
DL
EP
EP
yB
tI
mB
rV
yB
gU
"}
(14,1,1) = {"
DL
DL
DL
gU
DL
DL
DL
DL
bK
DL
DL
yB
Yr
mB
mB
mB
mB
mB
mB
mB
mB
uO
yB
DL
EP
EP
WG
mB
mB
vd
yB
gU
"}
(15,1,1) = {"
DL
DL
DL
gU
DL
DL
DL
DL
IG
DL
DL
yB
mB
UX
mB
mB
mB
mB
mB
mB
mB
aa
yB
DL
EP
eF
yB
Em
TH
SZ
yB
gU
"}
(16,1,1) = {"
DL
DL
DL
gU
DL
DL
DL
DL
DL
DL
DL
yB
Ab
Vy
UX
pB
nc
Et
nc
mB
mB
UX
yB
DL
EP
EP
yB
yB
yB
yB
yB
gU
"}
(17,1,1) = {"
DL
DL
DL
gU
DL
DL
DL
DL
DL
DL
DL
yB
yB
yB
yB
yB
yB
yB
yB
yB
yB
yB
yB
DL
EP
EP
DL
DL
yx
DL
DL
gU
"}
(18,1,1) = {"
DL
DL
DL
gU
DL
DL
DL
DL
DL
DL
DL
DL
DL
DL
DL
DL
DL
DL
DL
DL
DL
DL
DL
DL
EP
EP
DL
mB
mB
Yv
DL
gU
"}
(19,1,1) = {"
DL
pV
DL
gU
DL
DL
CO
CO
CO
CO
CO
CO
CO
DL
DL
CO
CO
CO
CO
CO
CO
CO
DL
DL
EP
EP
DL
mB
mB
Yv
DL
gU
"}
(20,1,1) = {"
DL
DL
DL
gU
DL
DL
CO
Up
mB
NW
NP
YD
CO
DL
DL
CO
wC
zC
xj
xN
mf
CO
DL
DL
EP
EP
DL
vl
mB
Yv
DL
gU
"}
(21,1,1) = {"
DL
DL
DL
gU
DL
DL
CO
fq
mB
mB
kO
Qx
CO
DL
DL
CO
Md
Rb
Rb
Rb
CW
CO
DL
DL
EP
EP
DL
vs
mB
Yv
DL
gU
"}
(22,1,1) = {"
DL
DL
DL
gU
DL
DL
CO
VN
mB
mB
mB
Jc
CO
DL
DL
CO
tT
Jg
Rb
vQ
BZ
CO
DL
DL
EP
EP
DL
DL
ji
DL
DL
gU
"}
(23,1,1) = {"
DL
DL
DL
gU
DL
DL
CO
CO
CO
bU
CO
CO
CO
DL
DL
CO
CO
CO
DB
CO
CO
CO
DL
DL
EP
EP
yB
yB
yB
yB
DL
gU
"}
(24,1,1) = {"
DL
DL
DL
gU
DL
DL
DL
DL
fY
EP
yx
DL
DL
DL
DL
DL
DL
yx
EP
fY
DL
DL
DL
DL
EP
Fo
Rg
gF
YC
yB
DL
gU
"}
(25,1,1) = {"
DL
DL
DL
gU
DL
DL
DL
DL
EP
EP
EP
EP
EP
EP
EP
EP
EP
EP
EP
EP
EP
EP
EP
EP
EP
EP
cM
Rb
AC
yB
DL
gU
"}
(26,1,1) = {"
DL
DL
DL
gU
DL
DL
DL
DL
EP
EP
EP
EP
EP
EP
EP
EP
EP
EP
EP
EP
EP
EP
EP
EP
EP
EP
yB
ak
ka
yB
DL
gU
"}
(27,1,1) = {"
DL
DL
DL
gU
DL
DL
DL
DL
EP
EP
EP
EP
EP
EP
EP
EP
EP
EP
EP
EP
EP
EP
EP
EP
EP
EP
yB
yB
yB
yB
DL
gU
"}
(28,1,1) = {"
DL
DL
DL
gU
DL
DL
DL
DL
DL
DL
DL
DL
DL
DL
DL
DL
DL
DL
DL
DL
DL
DL
DL
DL
DL
DL
DL
DL
DL
DL
DL
gU
"}
(29,1,1) = {"
DL
pV
DL
CO
EK
EK
EK
EK
EK
EK
EK
EK
EK
EK
EK
EK
EK
EK
EK
EK
EK
EK
EK
EK
EK
EK
EK
EK
EK
EK
EK
CO
"}
(30,1,1) = {"
DL
DL
DL
vi
vi
vi
vi
vi
vi
vi
vi
vi
vi
vi
hT
vi
vi
vi
vi
vi
vi
vi
vi
vi
vi
vi
vi
vi
vi
vi
vi
vi
"}
(31,1,1) = {"
DL
DL
DL
vi
vi
vi
vi
vi
vi
hT
vi
vi
vi
vi
vi
vi
vi
vi
vi
hT
vi
vi
vi
vi
vi
vi
vi
hT
vi
vi
vi
vi
"}
(32,1,1) = {"
DL
DL
DL
vi
hT
vi
vi
vi
vi
vi
vi
vi
vi
vi
vi
vi
vi
vi
vi
vi
vi
vi
vi
vi
vi
vi
vi
vi
vi
vi
vi
vi
"}
