//MAP CONVERTED BY dmm2tgm.py THIS HEADER COMMENT PREVENTS RECONVERSION, DO NOT REMOVE
"ao" = (
/obj/effect/floor_decal/industrial/outline/yellow,
/obj/random/dirt_75,
/obj/random/dirt_75,
/obj/item/cargo_package{
	pixel_y = 3
	},
/turf/simulated/floor/exoplanet/concrete,
/area/template_noop)
"aQ" = (
/obj/effect/floor_decal/industrial/warning{
	dir = 9
	},
/obj/random/dirt_75,
/obj/random/dirt_75,
/turf/simulated/floor/exoplanet/concrete,
/area/template_noop)
"aR" = (
/obj/structure/closet/walllocker/medical{
	pixel_y = 32
	},
/obj/item/stack/medical/splint/full,
/obj/item/reagent_containers/hypospray/autoinjector/inaprovaline,
/obj/item/reagent_containers/hypospray/autoinjector/inaprovaline,
/obj/item/stack/medical/ointment/full,
/obj/item/stack/medical/ointment/full,
/obj/item/stack/medical/bruise_pack/full,
/obj/item/stack/medical/bruise_pack/full,
/obj/effect/floor_decal/industrial/outline/medical,
/obj/random/dirt_75,
/obj/random/dirt_75,
/turf/simulated/floor/exoplanet/concrete,
/area/template_noop)
"bi" = (
/obj/effect/floor_decal/industrial/warning{
	dir = 5
	},
/obj/structure/sign/flag/orion_express/unmovable{
	dir = 1;
	pixel_y = 32
	},
/obj/random/dirt_75,
/turf/simulated/floor/exoplanet/concrete,
/area/template_noop)
"bk" = (
/obj/effect/floor_decal/industrial/warning/corner{
	dir = 8
	},
/obj/random/dirt_75,
/obj/random/dirt_75,
/turf/simulated/floor/exoplanet/concrete,
/area/template_noop)
"bA" = (
/obj/structure/cargo_receptacle,
/obj/random/dirt_75,
/obj/random/dirt_75,
/obj/random/dirt_75,
/obj/effect/floor_decal/industrial/outline/yellow,
/turf/simulated/floor/exoplanet/concrete,
/area/template_noop)
"bE" = (
/obj/effect/floor_decal/industrial/warning{
	dir = 10
	},
/obj/structure/sign/flag/orion_express/unmovable{
	dir = 1;
	pixel_x = -32
	},
/obj/random/dirt_75,
/turf/simulated/floor/exoplanet/concrete,
/area/template_noop)
"bP" = (
/obj/random/dirt_75,
/obj/random/dirt_75,
/obj/random/dirt_75,
/turf/simulated/floor/exoplanet/concrete,
/area/template_noop)
"bQ" = (
/turf/simulated/wall,
/area/template_noop)
"ec" = (
/obj/effect/floor_decal/industrial/warning/corner{
	dir = 8
	},
/obj/random/dirt_75,
/turf/simulated/floor/exoplanet/concrete,
/area/template_noop)
"hE" = (
/obj/effect/floor_decal/industrial/outline/yellow,
/obj/random/dirt_75,
/obj/random/dirt_75,
/turf/simulated/floor/exoplanet/concrete,
/area/template_noop)
"ig" = (
/obj/effect/floor_decal/industrial/outline/yellow,
/obj/random/dirt_75,
/turf/simulated/floor/exoplanet/concrete,
/area/template_noop)
"iQ" = (
/obj/effect/floor_decal/industrial/outline/emergency_closet,
/obj/structure/closet/walllocker/emerglocker/west,
/obj/random/dirt_75,
/turf/simulated/floor/exoplanet/concrete,
/area/template_noop)
"lK" = (
/obj/effect/floor_decal/industrial/outline/yellow,
/obj/random/dirt_75,
/obj/structure/closet/crate,
/obj/item/storage/backpack/duffel/orion,
/obj/item/stack/packageWrap,
/obj/item/device/hand_labeler,
/obj/random/tech_supply,
/obj/random/tool,
/obj/item/crowbar,
/obj/item/clothing/accessory/pin/corporate/orion,
/turf/simulated/floor/exoplanet/concrete,
/area/template_noop)
"qc" = (
/obj/effect/floor_decal/industrial/warning{
	dir = 6
	},
/obj/random/dirt_75,
/turf/simulated/floor/exoplanet/concrete,
/area/template_noop)
"qY" = (
/obj/effect/floor_decal/industrial/outline/yellow,
/obj/random/dirt_75,
/obj/item/cargo_package{
	pixel_y = 3
	},
/turf/simulated/floor/exoplanet/concrete,
/area/template_noop)
"CG" = (
/obj/effect/floor_decal/industrial/warning{
	dir = 5
	},
/obj/random/dirt_75,
/turf/simulated/floor/exoplanet/concrete,
/area/template_noop)
"EK" = (
/turf/template_noop,
/area/template_noop)
"FF" = (
/obj/effect/floor_decal/industrial/warning{
	dir = 10
	},
/obj/random/dirt_75,
/turf/simulated/floor/exoplanet/concrete,
/area/template_noop)
"Ku" = (
/obj/effect/landmark/clear,
/turf/template_noop,
/area/template_noop)
"Ru" = (
/obj/effect/floor_decal/industrial/warning/corner{
	dir = 4
	},
/obj/random/dirt_75,
/obj/random/dirt_75,
/obj/random/dirt_75,
/turf/simulated/floor/exoplanet/concrete,
/area/template_noop)
"VP" = (
/obj/random/dirt_75,
/turf/simulated/floor/exoplanet/concrete,
/area/template_noop)

(1,1,1) = {"
EK
EK
EK
Ku
Ku
Ku
Ku
"}
(2,1,1) = {"
EK
bQ
bQ
bQ
bQ
bQ
Ku
"}
(3,1,1) = {"
Ku
bQ
aQ
iQ
bE
bQ
Ku
"}
(4,1,1) = {"
Ku
bQ
aR
bA
bk
FF
Ku
"}
(5,1,1) = {"
Ku
bQ
bi
Ru
bP
ec
Ku
"}
(6,1,1) = {"
Ku
bQ
bQ
lK
ao
hE
Ku
"}
(7,1,1) = {"
Ku
Ku
Ku
ig
ig
qY
Ku
"}
(8,1,1) = {"
EK
Ku
Ku
CG
VP
qc
Ku
"}
(9,1,1) = {"
EK
Ku
Ku
Ku
Ku
Ku
Ku
"}
