//MAP CONVERTED BY dmm2tgm.py THIS HEADER COMMENT PREVENTS RECONVERSION, DO NOT REMOVE
"ch" = (
/obj/effect/decal/cleanable/dirt,
/obj/item/material/shard{
	icon_state = "small"
	},
/turf/simulated/floor/exoplanet/snow/cold,
/area/space)
"dF" = (
/obj/effect/map_effect/window_spawner/full/shuttle/raider,
/obj/machinery/door/blast/regular/open{
	dir = 2;
	name = "Safety Shutters";
	id = "sol_interceptor_lockdown"
	},
/turf/simulated/floor/plating,
/area/space)
"dN" = (
/obj/effect/floor_decal/snow/corner{
	dir = 10
	},
/obj/effect/decal/cleanable/dirt,
/turf/simulated/floor/tiled/dark,
/area/space)
"fo" = (
/obj/structure/flora/rock/snow,
/turf/simulated/floor/exoplanet/snow/cold,
/area/space)
"hc" = (
/obj/structure/lattice/catwalk/indoor/grate/dark,
/obj/machinery/atmospherics/pipe/manifold4w/hidden/yellow,
/obj/machinery/meter,
/obj/machinery/atmospherics/pipe/manifold/hidden/aux{
	dir = 4
	},
/turf/simulated/floor/plating,
/area/space)
"hT" = (
/obj/machinery/atmospherics/pipe/simple/hidden/yellow{
	dir = 5
	},
/turf/simulated/wall/shuttle/raider,
/area/space)
"il" = (
/obj/effect/floor_decal/corner/orange/full{
	dir = 8
	},
/obj/effect/floor_decal/industrial/outline/red,
/obj/machinery/light{
	dir = 1
	},
/obj/effect/floor_decal/snow/corner{
	dir = 8
	},
/turf/simulated/floor/tiled/dark,
/area/space)
"jR" = (
/turf/simulated/wall/shuttle/raider,
/area/space)
"mk" = (
/turf/simulated/wall/shuttle/raider{
	color = "#ff8c00"
	},
/area/space)
"mw" = (
/obj/effect/map_effect/window_spawner/full/shuttle/raider,
/obj/machinery/door/blast/regular/open{
	dir = 8;
	name = "Safety Shutters";
	id = "sol_interceptor_lockdown"
	},
/turf/simulated/floor/plating,
/area/space)
"mS" = (
/obj/effect/floor_decal/corner/orange/full{
	dir = 1
	},
/obj/machinery/button/remote/blast_door{
	dir = 4;
	pixel_y = 4;
	pixel_x = 18;
	id = "sol_interceptor_lockdown";
	name = "Windshield Blast Doors"
	},
/obj/effect/floor_decal/industrial/outline/yellow,
/obj/machinery/light{
	dir = 1
	},
/obj/machinery/computer/terminal/inactive{
	dir = 8
	},
/turf/simulated/floor/tiled/dark,
/area/space)
"nH" = (
/obj/machinery/atmospherics/pipe/tank/carbon_dioxide{
	dir = 8
	},
/obj/effect/floor_decal/corner/orange{
	dir = 6
	},
/obj/machinery/light{
	dir = 4
	},
/turf/simulated/floor/tiled/dark,
/area/space)
"nU" = (
/obj/effect/decal/cleanable/dirt,
/obj/effect/decal/cleanable/dirt,
/turf/template_noop,
/area/space)
"pB" = (
/obj/effect/decal/cleanable/liquid_fuel,
/turf/simulated/floor/exoplanet/barren,
/area/space)
"qe" = (
/obj/item/material/shard{
	icon_state = "small"
	},
/turf/simulated/floor/exoplanet/snow/cold,
/area/space)
"qw" = (
/obj/machinery/atmospherics/unary/engine,
/obj/structure/rod_railing{
	dir = 8
	},
/turf/simulated/floor/plating,
/area/space)
"rA" = (
/obj/effect/floor_decal/corner/orange/full{
	dir = 8
	},
/obj/machinery/atmospherics/pipe/simple/hidden/yellow{
	dir = 5
	},
/obj/machinery/portable_atmospherics/canister/air,
/obj/effect/floor_decal/industrial/outline,
/obj/machinery/atmospherics/portables_connector/aux{
	name = "Air Connector Port"
	},
/turf/simulated/floor/tiled/dark,
/area/space)
"rV" = (
/turf/simulated/floor/exoplanet/snow/cold,
/area/space)
"sC" = (
/turf/simulated/floor/tiled/dark,
/area/space)
"tI" = (
/obj/machinery/door/airlock/hatch{
	name = "cockpit"
	},
/obj/effect/floor_decal/corner/orange/diagonal,
/obj/machinery/atmospherics/pipe/simple/hidden/aux,
/obj/effect/floor_decal/industrial/hatch_door/yellow,
/turf/simulated/floor/tiled/dark,
/area/space)
"ux" = (
/obj/effect/floor_decal/corner/orange{
	dir = 10
	},
/obj/effect/floor_decal/industrial/outline/security,
/obj/effect/floor_decal/snow/corner{
	dir = 8
	},
/obj/machinery/computer/terminal/inactive{
	dir = 1
	},
/turf/simulated/floor/tiled/dark,
/area/space)
"vv" = (
/obj/effect/floor_decal/snow/corner{
	dir = 9
	},
/turf/simulated/floor/plating,
/area/space)
"wv" = (
/obj/machinery/atmospherics/binary/pump/high_power{
	dir = 8;
	name = "Fuel Tank to Thrusters"
	},
/obj/effect/floor_decal/corner/orange/diagonal,
/obj/structure/cable{
	icon_state = "1-2"
	},
/turf/simulated/floor/tiled/dark,
/area/space)
"xV" = (
/obj/machinery/atmospherics/pipe/simple/hidden/yellow{
	dir = 5
	},
/turf/simulated/wall/shuttle/raider{
	color = "#ff8c00"
	},
/area/space)
"zq" = (
/turf/template_noop,
/area/space)
"zs" = (
/obj/structure/flora/bush,
/turf/simulated/floor/exoplanet/snow/cold,
/area/space)
"zv" = (
/obj/effect/decal/cleanable/dirt,
/turf/template_noop,
/area/space)
"Af" = (
/obj/machinery/atmospherics/pipe/simple/hidden/yellow{
	dir = 9
	},
/obj/machinery/vending/wallmed1{
	pixel_x = 32
	},
/obj/effect/floor_decal/industrial/warning/full,
/obj/structure/cable{
	dir = 1
	},
/turf/simulated/floor/tiled/dark,
/area/space)
"BT" = (
/obj/effect/floor_decal/corner/orange{
	dir = 6
	},
/obj/effect/floor_decal/industrial/outline/security,
/obj/machinery/computer/terminal/inactive{
	dir = 8
	},
/turf/simulated/floor/tiled/dark,
/area/space)
"CY" = (
/obj/effect/floor_decal/corner/orange/diagonal,
/obj/structure/bed/handrail{
	dir = 1
	},
/obj/effect/floor_decal/industrial/loading/red{
	dir = 8
	},
/turf/simulated/floor/tiled/dark,
/area/space)
"Dg" = (
/obj/machinery/atmospherics/pipe/simple/hidden/yellow{
	dir = 8
	},
/obj/machinery/atmospherics/pipe/simple/hidden/aux{
	dir = 5
	},
/obj/effect/floor_decal/corner/orange/diagonal,
/turf/simulated/floor/tiled/dark,
/area/space)
"DR" = (
/obj/structure/table/rack,
/obj/machinery/atmospherics/pipe/simple/hidden/yellow{
	dir = 8
	},
/obj/effect/floor_decal/corner/orange{
	dir = 9
	},
/obj/effect/floor_decal/industrial/outline/red,
/obj/item/ship_ammunition/francisca{
	pixel_y = 6;
	pixel_x = -3
	},
/obj/machinery/light{
	dir = 8
	},
/obj/effect/floor_decal/snow/corner{
	dir = 8
	},
/turf/simulated/floor/tiled/dark,
/area/space)
"EC" = (
/obj/structure/lattice/catwalk/indoor/grate/dark,
/obj/machinery/atmospherics/pipe/manifold/hidden/yellow{
	dir = 1
	},
/obj/machinery/atmospherics/pipe/simple/hidden/aux,
/turf/simulated/floor/plating,
/area/space)
"Gu" = (
/obj/machinery/atmospherics/pipe/simple/hidden/yellow{
	dir = 8
	},
/turf/simulated/wall/shuttle/raider,
/area/space)
"GH" = (
/obj/machinery/atmospherics/pipe/simple/hidden/yellow,
/turf/simulated/wall/shuttle/raider,
/area/space)
"GJ" = (
/obj/item/material/shard{
	pixel_x = 10;
	pixel_y = -10
	},
/turf/simulated/floor/exoplanet/snow/cold,
/area/space)
"Ia" = (
/obj/effect/decal/fake_object{
	icon = 'icons/obj/machinery/ship_guns/ship_weapon_attachments.dmi';
	icon_state = "ammo_loader_sol";
	desc = "An ammunition loader for ship weapons systems. All hands to battlestations!";
	name = "ammunition loader";
	dir = 4
	},
/turf/simulated/floor/tiled/dark,
/area/space)
"Is" = (
/obj/structure/lattice/catwalk/indoor/grate/dark,
/obj/machinery/atmospherics/pipe/simple/hidden/yellow{
	dir = 5
	},
/obj/machinery/atmospherics/pipe/simple/hidden/aux,
/turf/simulated/floor/plating,
/area/space)
"It" = (
/turf/simulated/floor/exoplanet/barren,
/area/space)
"IH" = (
/obj/machinery/atmospherics/pipe/simple/hidden/yellow{
	dir = 9
	},
/turf/simulated/wall/shuttle/raider{
	color = "#ff8c00"
	},
/area/space)
"Jb" = (
/obj/machinery/atmospherics/pipe/simple/hidden/yellow{
	dir = 8
	},
/obj/structure/closet/walllocker{
	pixel_x = 32
	},
/obj/item/storage/toolbox/mechanical,
/obj/item/clothing/glasses/welding,
/obj/item/storage/bag/inflatable/emergency,
/obj/item/device/oxycandle,
/obj/item/device/oxycandle,
/obj/item/stack/material/steel/full,
/obj/effect/floor_decal/corner/orange/diagonal,
/obj/machinery/power/apc/super/south,
/obj/structure/cable,
/turf/simulated/floor/tiled/dark,
/area/space)
"Km" = (
/obj/effect/decal/cleanable/dirt,
/obj/effect/decal/cleanable/dirt,
/turf/simulated/floor/exoplanet/barren,
/area/space)
"LB" = (
/obj/effect/floor_decal/spline/plain/yellow{
	dir = 4
	},
/obj/effect/decal/fake_object{
	icon = 'icons/obj/machinery/sensors.dmi';
	icon_state = "sensors";
	desc = "Miniaturized gravity scanner with various other sensors, used to detect irregularities in surrounding space. Can only run in vacuum to protect delicate quantum BS elements. This one is extremely damaged, and likely will need to be scrapped or heavily repaired to ever see work again.";
	name = "damaged sensors suite";
	dir = 4
	},
/turf/simulated/floor/reinforced,
/area/space)
"LO" = (
/obj/effect/floor_decal/corner/orange/diagonal,
/obj/item/material/shard{
	icon_state = "small";
	pixel_x = 12;
	pixel_y = 7
	},
/obj/item/material/shard{
	icon_state = "small";
	pixel_x = -6;
	pixel_y = -16
	},
/obj/effect/decal/cleanable/floor_damage/broken2,
/turf/simulated/floor/tiled/dark,
/area/space)
"Mq" = (
/obj/effect/floor_decal/snow/corner{
	dir = 10
	},
/obj/item/clothing/head/sol/marine{
	pixel_y = 10;
	pixel_x = 10
	},
/turf/simulated/floor/tiled/dark,
/area/space)
"Mv" = (
/obj/effect/decal/cleanable/dirt,
/turf/simulated/floor/exoplanet/snow/cold,
/area/space)
"MM" = (
/obj/machinery/atmospherics/pipe/simple/hidden/yellow{
	dir = 9
	},
/turf/simulated/wall/shuttle/raider,
/area/space)
"Ow" = (
/obj/effect/floor_decal/corner/orange/diagonal,
/obj/item/material/shard{
	icon_state = "small";
	pixel_x = 7;
	pixel_y = -13
	},
/obj/effect/decal/cleanable/floor_damage/broken2,
/turf/simulated/floor/tiled/dark,
/area/space)
"QK" = (
/obj/effect/floor_decal/snowrocks,
/turf/simulated/floor/exoplanet/snow/cold,
/area/space)
"Ri" = (
/obj/effect/decal/cleanable/dirt,
/turf/simulated/floor/exoplanet/barren,
/area/space)
"Ue" = (
/obj/effect/decal/cleanable/dirt,
/obj/effect/decal/cleanable/liquid_fuel,
/turf/simulated/floor/exoplanet/snow/cold,
/area/space)
"Vv" = (
/obj/machinery/atmospherics/pipe/simple/hidden/yellow{
	dir = 6
	},
/obj/effect/decal/cleanable/dirt,
/turf/simulated/wall/shuttle/raider,
/area/space)
"Wz" = (
/obj/machinery/atmospherics/unary/engine,
/turf/simulated/floor/plating,
/area/space)
"WF" = (
/obj/machinery/atmospherics/pipe/simple/hidden/yellow{
	dir = 10
	},
/turf/simulated/wall/shuttle/raider,
/area/space)
"WW" = (
/obj/machinery/atmospherics/pipe/simple/visible/fuel{
	dir = 10
	},
/obj/effect/decal/cleanable/liquid_fuel,
/turf/simulated/floor/exoplanet/barren,
/area/space)
"XE" = (
/obj/machinery/atmospherics/unary/engine,
/obj/structure/rod_railing{
	dir = 4
	},
/turf/simulated/floor/plating,
/area/space)
"YD" = (
/obj/machinery/door/airlock/external,
/obj/machinery/atmospherics/pipe/simple/hidden/aux,
/turf/simulated/floor/tiled/dark,
/area/space)
"YJ" = (
/obj/effect/decal/cleanable/liquid_fuel,
/turf/simulated/floor/exoplanet/snow/cold,
/area/space)
"ZV" = (
/obj/machinery/atmospherics/unary/vent_pump/high_volume/aux,
/obj/machinery/light/small{
	dir = 4
	},
/obj/structure/bed/handrail{
	dir = 8
	},
/turf/simulated/floor/tiled/dark,
/area/space)

(1,1,1) = {"
zv
zq
zq
zq
zq
zq
zv
zv
zq
zq
zq
It
zq
zq
rV
Mv
Mv
Mv
qw
xV
rV
rV
rV
zq
zq
"}
(2,1,1) = {"
zq
zv
zq
zv
zq
zq
zq
zq
zq
zq
zv
jR
jR
It
Mv
rV
zs
mk
mk
Ue
Mv
rV
rV
QK
zq
"}
(3,1,1) = {"
zq
zq
zq
zq
zq
zq
zv
zv
zv
zv
Km
Wz
hT
mk
rV
Mv
jR
Ri
WW
jR
ch
Mv
qe
rV
rV
"}
(4,1,1) = {"
zq
zv
zv
zv
Ri
Ri
zv
zv
zq
zq
It
jR
WF
YJ
Ue
Ri
jR
jR
DR
Ia
dN
Mv
rV
rV
rV
"}
(5,1,1) = {"
Ri
Km
zq
It
zq
zv
zq
Ri
Ri
zv
zv
zv
Mv
rV
pB
GH
GH
rA
Dg
CY
jR
il
Mq
GJ
Mv
"}
(6,1,1) = {"
zq
zq
zv
zv
zv
zv
zq
zv
zv
zq
zq
It
rV
vv
sC
ZV
YD
EC
hc
Is
tI
LO
Ow
ux
mw
"}
(7,1,1) = {"
zq
zv
zv
zq
It
zv
Ri
Ri
nU
zq
zv
zq
Mv
jR
Vv
GH
GH
Af
wv
Jb
jR
mS
BT
mw
Mv
"}
(8,1,1) = {"
zv
It
zv
Ri
zq
zq
zq
It
Ri
Ri
nU
Mv
Ri
Wz
MM
mk
jR
jR
nH
Gu
jR
jR
dF
dF
Mv
"}
(9,1,1) = {"
zq
zq
zv
zv
zv
zq
zv
zv
zv
zv
zq
Mv
Ri
jR
jR
It
jR
mk
mk
Gu
LB
rV
Mv
Mv
rV
"}
(10,1,1) = {"
zq
zq
zq
zq
zv
zv
zv
zq
zq
zq
zq
zq
rV
Mv
Mv
Mv
Mv
Ri
XE
IH
Mv
rV
fo
rV
zq
"}
(11,1,1) = {"
zv
zq
zq
zv
zv
zq
zq
zq
zq
zv
zv
zv
zq
rV
QK
rV
rV
rV
Mv
Mv
rV
rV
rV
zq
zq
"}
