//MAP CONVERTED BY dmm2tgm.py THIS HEADER COMMENT PREVENTS RECONVERSION, DO NOT REMOVE
"ar" = (
/obj/structure/closet/crate/secure/phoron{
	name = "secure crate";
	req_one_access = list(229, 217)
	},
/obj/item/nullrod/athame,
/obj/item/nullrod/rredouane,
/obj/item/nullrod/luceiansceptre,
/obj/item/storage/assunzionesheath/filled,
/turf/template_noop,
/area/template_noop)
"br" = (
/obj/structure/closet/crate/secure/phoron{
	name = "secure crate";
	req_one_access = list(229, 217)
	},
/obj/random/finances,
/obj/random/finances,
/turf/template_noop,
/area/template_noop)
"bs" = (
/obj/structure/closet/crate/solar{
	name = "backup power generation supplies"
	},
/obj/item/circuitboard/portgen/fusion,
/obj/item/stack/material/tritium/full,
/obj/item/stack/material/graphite/full,
/obj/item/stack/material/uranium/full,
/turf/template_noop,
/area/template_noop)
"by" = (
/obj/random/dirt_75,
/obj/structure/closet/cabinet,
/obj/item/device/versebook/trinary,
/obj/item/device/versebook/templeist,
/obj/item/device/versebook/gadpathur,
/obj/item/device/versebook/dpra,
/obj/item/device/versebook/biesel,
/obj/item/device/versebook/autakh,
/obj/item/device/versebook/assunzione,
/obj/item/device/versebook/tribunal,
/obj/item/device/versebook/thakh,
/obj/item/device/versebook/skakh,
/obj/item/device/versebook/siakh,
/obj/item/device/versebook/pra,
/obj/item/device/versebook/nka,
/turf/template_noop,
/area/template_noop)
"ci" = (
/obj/structure/closet/crate/hydroponics,
/obj/item/material/minihoe,
/obj/item/material/hatchet,
/obj/item/wirecutters/clippers,
/obj/item/reagent_containers/glass/bucket,
/obj/item/storage/backpack/hydroponics,
/obj/random/dirt_75,
/turf/template_noop,
/area/template_noop)
"ck" = (
/obj/structure/table/steel,
/obj/item/saddle{
	pixel_y = 5
	},
/obj/item/saddle{
	pixel_y = 5;
	pixel_x = 10
	},
/turf/template_noop,
/area/template_noop)
"co" = (
/obj/structure/closet/crate/secure/phoron{
	name = "secure crate";
	req_one_access = list(229, 217)
	},
/obj/item/melee/vaurca/rock,
/obj/random/dirt_75,
/turf/template_noop,
/area/template_noop)
"cS" = (
/obj/random/dirt_75,
/obj/random/keg,
/turf/template_noop,
/area/template_noop)
"eM" = (
/obj/structure/closet/crate/secure/large/viscerator,
/obj/random/hardhat,
/obj/random/hoodie,
/obj/random/kitchen_staples,
/obj/random/kitchen_staples,
/obj/random/lavalamp,
/obj/random/medical,
/obj/random/random_flag,
/obj/random/random_flag,
/obj/random/random_flag,
/obj/random/seed,
/obj/random/seed,
/obj/random/syrup,
/obj/random/survival_weapon,
/obj/random/smokable,
/obj/random/suit,
/turf/template_noop,
/area/template_noop)
"fj" = (
/obj/structure/table/rack/no_cargo,
/obj/item/rfd/construction,
/obj/item/rfd_ammo,
/obj/item/rfd_ammo,
/turf/template_noop,
/area/template_noop)
"fy" = (
/obj/structure/closet/crate/secure/phoron{
	name = "secure crate";
	req_one_access = list(229, 217)
	},
/obj/random/dirt_75,
/obj/random/highvalue/no_weapon,
/obj/random/highvalue/no_weapon,
/obj/random/highvalue/no_weapon,
/turf/template_noop,
/area/template_noop)
"fM" = (
/obj/structure/bed/psych,
/obj/random/plushie,
/turf/template_noop,
/area/template_noop)
"gP" = (
/obj/machinery/chem_heater,
/obj/random/dirt_75,
/turf/template_noop,
/area/template_noop)
"gY" = (
/obj/structure/anomaly_container,
/turf/template_noop,
/area/template_noop)
"hx" = (
/obj/vehicle/bike/speeder/izweski,
/turf/template_noop,
/area/template_noop)
"hN" = (
/obj/effect/map_effect/marker/mapmanip/submap/extract/golden_deep,
/obj/machinery/reagentgrinder{
	pixel_y = 17;
	pixel_x = 6
	},
/obj/item/reagent_containers/glass/beaker/large{
	pixel_y = 4;
	pixel_x = -8
	},
/obj/item/reagent_containers/glass/beaker/large{
	pixel_y = 4;
	pixel_x = 8
	},
/obj/structure/table/steel,
/turf/template_noop,
/area/template_noop)
"ji" = (
/obj/structure/closet/cabinet,
/obj/item/clothing/under/dressshirt/tshirt/skrell/nebula/black,
/obj/item/clothing/under/dressshirt/tshirt/skrell/nebula/nralakk,
/obj/item/clothing/under/dressshirt/tshirt/skrell/nebula/teal,
/obj/item/clothing/under/dressshirt/tshirt/skrell/reef,
/obj/item/clothing/ears/skrell/band,
/obj/item/clothing/ears/skrell/chain/black,
/obj/item/clothing/ears/skrell/chain/ebony,
/obj/item/clothing/ears/skrell/chain/festive/long,
/obj/item/clothing/ears/skrell/chain/silver/average,
/obj/item/clothing/ears/skrell/cloth,
/obj/item/clothing/ears/skrell/scrunchy,
/obj/item/clothing/mask/breath/skrell,
/obj/item/clothing/mask/skrell/horned,
/obj/item/clothing/mask/skrell/thirdeye,
/obj/item/clothing/mask/skrell/weeping,
/obj/item/clothing/under/skrell/qeblak,
/obj/item/device/hearing_aid/skrell,
/obj/item/reagent_containers/food/drinks/bottle/skrellwineylpha,
/obj/item/skrell_projector,
/obj/item/toy/plushie/axic,
/turf/template_noop,
/area/template_noop)
"jV" = (
/obj/random/dirt_75,
/obj/machinery/portable_atmospherics/canister/phoron,
/turf/template_noop,
/area/template_noop)
"kI" = (
/obj/effect/map_effect/marker_helper/mapmanip/submap/edge{
	dir = 8
	},
/turf/template_noop,
/area/template_noop)
"lc" = (
/obj/structure/closet/crate/secure/weapon/alt{
	req_one_access = list(229, 217)
	},
/obj/item/melee/telebaton/nlom,
/obj/random/dirt_75,
/obj/item/gun/energy/blaster/himeo,
/obj/item/gun/energy/gun/qukala,
/obj/random/civgun/rifle,
/turf/template_noop,
/area/template_noop)
"lT" = (
/obj/effect/map_effect/marker/mapmanip/submap/extract/golden_deep,
/obj/random/animal_crate,
/turf/template_noop,
/area/template_noop)
"mp" = (
/obj/structure/table/rack/no_cargo,
/obj/random/toolbox,
/obj/random/tool,
/obj/random/tech_supply,
/turf/template_noop,
/area/template_noop)
"nM" = (
/obj/structure/closet/crate,
/obj/item/smes_coil/super_io,
/obj/item/smes_coil/super_io,
/obj/item/smes_coil/super_capacity,
/obj/item/smes_coil/super_capacity,
/obj/item/smes_coil/weak,
/obj/item/smes_coil/weak,
/turf/template_noop,
/area/template_noop)
"nP" = (
/obj/random/dirt_75,
/obj/structure/trash_pile,
/turf/template_noop,
/area/template_noop)
"pe" = (
/obj/machinery/suspension_gen,
/turf/template_noop,
/area/template_noop)
"rg" = (
/obj/effect/map_effect/marker/mapmanip/submap/extract/golden_deep,
/obj/random/dirt_75,
/obj/structure/closet/crate/secure/phoron{
	name = "secure crate";
	req_one_access = list(229, 217)
	},
/obj/item/rig/unathi,
/turf/template_noop,
/area/template_noop)
"rC" = (
/obj/machinery/portable_atmospherics/canister/chlorine,
/turf/template_noop,
/area/template_noop)
"sq" = (
/turf/template_noop,
/area/template_noop)
"sC" = (
/obj/item/storage/box/fancy/vials{
	pixel_x = -4;
	pixel_y = 13
	},
/obj/item/reagent_containers/dropper/electronic_pipette{
	pixel_x = 8;
	pixel_y = 2
	},
/obj/structure/table/steel,
/turf/template_noop,
/area/template_noop)
"uo" = (
/obj/structure/closet/cabinet,
/obj/item/clothing/accessory/dominia,
/obj/item/clothing/accessory/poncho/dominia_cape,
/obj/item/clothing/accessory/poncho/dominia_cape/zavod,
/obj/item/clothing/head/ushanka/dominia,
/obj/item/clothing/suit/storage/dominia/coat,
/obj/item/clothing/suit/storage/toggle/dominia/bomber/long,
/obj/item/clothing/suit/storage/toggle/dominia/bomber,
/obj/item/clothing/under/dominia/dress/fancy,
/obj/item/flag/dominia,
/obj/item/flame/lighter/zippo/dominia,
/obj/item/clothing/under/dominia/sweater,
/turf/template_noop,
/area/template_noop)
"uJ" = (
/obj/structure/closet/crate,
/obj/random/dirt_75,
/obj/item/circuitboard/stove,
/obj/item/circuitboard/smartfridge,
/obj/item/circuitboard/grill,
/obj/item/circuitboard/candymachine,
/obj/item/circuitboard/oven,
/obj/item/circuitboard/fryer,
/turf/template_noop,
/area/template_noop)
"vl" = (
/obj/structure/closet/crate/secure/phoron{
	name = "secure crate";
	req_one_access = list(229, 217)
	},
/obj/item/skrell_projector/vaurca_projector,
/obj/item/vaurca/box,
/obj/item/stellascope,
/turf/template_noop,
/area/template_noop)
"vs" = (
/obj/structure/table/rack/no_cargo,
/obj/item/rfd/mining,
/obj/item/rfd_ammo,
/obj/item/rfd_ammo,
/obj/random/dirt_75,
/turf/template_noop,
/area/template_noop)
"xk" = (
/obj/item/clothing/suit/hazmat/anomaly,
/obj/item/clothing/head/hazmat/anomaly,
/obj/item/clothing/glasses/safety/goggles,
/obj/structure/closet/toolcloset/empty,
/obj/item/storage/belt/archaeology,
/obj/item/device/ano_scanner,
/obj/item/storage/bag/fossils,
/obj/item/device/measuring_tape,
/obj/item/device/core_sampler,
/obj/item/device/depth_scanner,
/obj/item/storage/box/excavation,
/obj/item/book/manual/excavation,
/obj/item/pickaxe/hand,
/obj/random/dirt_75,
/turf/template_noop,
/area/template_noop)
"xt" = (
/obj/item/melee/ceremonial_sword,
/obj/structure/closet/crate/secure/weapon/alt{
	req_one_access = list(229, 217)
	},
/obj/item/clothing/head/sol/dress/officer,
/obj/item/clothing/under/rank/sol/dress/officer,
/obj/item/clothing/under/rank/sol/dress/pettyofficer,
/obj/item/clothing/head/sol/dress,
/obj/item/clothing/accessory/sol_pin,
/turf/template_noop,
/area/template_noop)
"xA" = (
/obj/structure/reagent_dispensers/watertank,
/obj/random/dirt_75,
/turf/template_noop,
/area/template_noop)
"xD" = (
/obj/structure/closet/cabinet,
/obj/random/suit,
/obj/random/suit,
/obj/random/suit,
/obj/random/suit,
/obj/random/suit,
/obj/random/softcap,
/obj/random/softcap,
/obj/random/smokable,
/obj/random/bandana,
/obj/random/backpack,
/obj/random/backpack,
/obj/random/gloves,
/obj/random/gloves,
/obj/random/hoodie,
/obj/random/hoodie,
/obj/random/hoodie,
/obj/random/watches,
/turf/template_noop,
/area/template_noop)
"yn" = (
/obj/random/dirt_75,
/obj/structure/table/rack,
/obj/item/clothing/accessory/tajaran/charm/raskariim{
	pixel_x = 4;
	pixel_y = -2
	},
/turf/template_noop,
/area/template_noop)
"zk" = (
/obj/effect/map_effect/marker/mapmanip/submap/extract/golden_deep,
/obj/structure/table/rack,
/obj/random/dirt_75,
/obj/item/flag/nka,
/obj/item/flag/dpra{
	pixel_y = 5
	},
/obj/item/flag/pra{
	pixel_y = 9
	},
/turf/template_noop,
/area/template_noop)
"zz" = (
/obj/random/dirt_75,
/obj/structure/closet/crate/loot,
/turf/template_noop,
/area/template_noop)
"Ah" = (
/obj/structure/closet/cabinet,
/obj/random/dirt_75,
/obj/item/clothing/suit/vaurca/brown,
/obj/item/clothing/suit/vaurca/silver,
/obj/item/clothing/shoes/vaurca/red,
/obj/item/clothing/shoes/vaurca/brown,
/obj/item/clothing/shoes/magboots/vaurca,
/obj/item/clothing/mask/gas/vaurca/tactical,
/obj/item/clothing/accessory/poncho/vaurca,
/obj/item/clothing/suit/space/void/vaurca,
/obj/item/clothing/head/helmet/space/void/vaurca,
/obj/item/clothing/shoes/magboots/vaurca,
/turf/template_noop,
/area/template_noop)
"AU" = (
/obj/structure/bed/stool/chair/office/light{
	dir = 1
	},
/turf/template_noop,
/area/template_noop)
"Bp" = (
/obj/random/civgun/rifle,
/obj/random/civgun,
/obj/structure/closet/crate/secure/weapon/alt{
	req_one_access = list(229, 217)
	},
/obj/random/prebuilt_ka,
/turf/template_noop,
/area/template_noop)
"Bw" = (
/obj/structure/table/steel,
/obj/item/newspaper{
	pixel_y = 3;
	pixel_x = 3
	},
/obj/random/dirt_75,
/turf/template_noop,
/area/template_noop)
"BJ" = (
/obj/random/animal_crate,
/turf/template_noop,
/area/template_noop)
"BP" = (
/obj/machinery/shieldwallgen,
/turf/template_noop,
/area/template_noop)
"CF" = (
/mob/living/simple_animal/chicken,
/turf/template_noop,
/area/template_noop)
"CG" = (
/obj/structure/closet/crate/secure/phoron{
	name = "secure crate";
	req_one_access = list(229, 217)
	},
/obj/item/clothing/suit/armor/amohda,
/obj/item/clothing/head/helmet/amohda,
/obj/item/material/sword/amohdan_sword,
/obj/item/clothing/accessory/poncho/tajarancloak/amohda,
/obj/random/dirt_75,
/obj/item/clothing/gloves/tajaran_gauntlets,
/turf/template_noop,
/area/template_noop)
"DM" = (
/obj/machinery/power/portgen/basic/advanced,
/turf/template_noop,
/area/template_noop)
"Fw" = (
/obj/structure/closet/crate/secure/large/larva,
/obj/random/softcap,
/obj/random/medical,
/obj/random/med_stack,
/obj/random/loot,
/obj/random/loot,
/obj/random/light,
/obj/random/gift,
/obj/random/firstaid,
/obj/random/coin,
/obj/random/coin,
/obj/random/booze,
/obj/random/booze,
/obj/random/beret,
/obj/random/belt,
/obj/random/belt,
/obj/random/action_figure,
/turf/template_noop,
/area/template_noop)
"Fy" = (
/obj/effect/map_effect/marker/mapmanip/submap/extract/golden_deep,
/obj/structure/table/rack/folding_table,
/obj/item/storage/overloader/screenshaker{
	pixel_y = 3;
	pixel_x = -10
	},
/obj/item/storage/overloader/jitterbug{
	pixel_y = 2;
	pixel_x = 7
	},
/obj/item/storage/overloader/rainbow{
	pixel_y = 4
	},
/turf/template_noop,
/area/template_noop)
"FV" = (
/obj/structure/closet/cabinet,
/obj/item/clothing/accessory/tajaran/charm/steel,
/obj/item/clothing/accessory/tajaran/charm/bone,
/obj/item/clothing/accessory/tajaran/nka_vest,
/obj/item/clothing/accessory/tajaran/nka_waistcoat,
/obj/item/clothing/gloves/black/tajara/smithgloves,
/obj/item/clothing/gloves/botanic_leather/tajara,
/obj/item/clothing/head/beret/tajaran/nka,
/obj/item/clothing/head/beret/tajaran/dpra/alt,
/obj/item/clothing/head/beret/tajaran/pra,
/obj/item/clothing/head/tajaran/circlet,
/obj/item/clothing/head/tajaran/circlet/silver,
/obj/item/clothing/head/tajaran/archeologist,
/obj/item/clothing/head/tajaran/fur,
/obj/item/clothing/ring/tajara,
/obj/item/clothing/shoes/flats/tajara,
/obj/item/clothing/suit/storage/hooded/tajaran/royalist,
/obj/item/clothing/suit/storage/hooded/tajaran/winter,
/obj/item/clothing/suit/storage/hooded/tajaran/maroon,
/obj/item/clothing/suit/storage/tajaran/finecoat,
/obj/item/clothing/under/tajaran/relaxed,
/obj/item/clothing/under/tajaran/summer,
/obj/item/clothing/wrists/watch/tajara,
/obj/item/material/knife/raskariim,
/obj/item/storage/pill_bottle/dice/tajara,
/turf/template_noop,
/area/template_noop)
"Ge" = (
/obj/structure/closet/crate/secure/weapon/alt{
	req_one_access = list(229, 217)
	},
/obj/random/high_grade_weapon,
/obj/random/civgun/rifle,
/obj/random/civgun,
/obj/item/gun/energy/galatea,
/obj/random/melee/highvalue,
/turf/template_noop,
/area/template_noop)
"GC" = (
/obj/effect/map_effect/marker/mapmanip/submap/extract/golden_deep,
/obj/structure/closet/crate/loot,
/turf/template_noop,
/area/template_noop)
"GF" = (
/obj/machinery/stasis_cage{
	req_access = list()
	},
/turf/template_noop,
/area/template_noop)
"Ht" = (
/obj/effect/map_effect/marker/mapmanip/submap/extract/golden_deep,
/obj/random/plushie,
/obj/random/plushie,
/obj/random/hoodie,
/obj/random/hardhat,
/obj/random/finances,
/obj/random/coin,
/obj/random/coin,
/obj/structure/closet/crate/secure/large/viscerator,
/obj/random/belt,
/obj/random/backpack,
/obj/random/backpack,
/obj/random/plushie,
/obj/random/plushie,
/turf/template_noop,
/area/template_noop)
"Hv" = (
/obj/structure/table/reinforced/steel,
/obj/item/neuralbroke{
	pixel_y = 7;
	pixel_x = 7
	},
/obj/random/med_stack,
/turf/template_noop,
/area/template_noop)
"HK" = (
/obj/machinery/chemical_dispenser/full{
	dir = 1
	},
/turf/template_noop,
/area/template_noop)
"Iy" = (
/obj/structure/closet/crate/drop,
/obj/item/stack/material/phoron{
	amount = 15
	},
/obj/item/grenade/chem_grenade,
/obj/item/grenade/chem_grenade,
/obj/item/grenade/chem_grenade,
/obj/item/grenade/chem_grenade,
/obj/item/device/assembly/igniter,
/obj/item/device/assembly/igniter,
/obj/item/device/assembly/igniter,
/obj/item/device/assembly/igniter,
/obj/item/device/assembly/timer,
/obj/item/device/assembly/timer,
/obj/item/device/assembly/timer,
/obj/item/device/assembly/timer,
/obj/item/storage/box/autoinjectors,
/obj/item/storage/box/inhalers_auto,
/obj/random/dirt_75,
/turf/template_noop,
/area/template_noop)
"IT" = (
/obj/effect/map_effect/marker/mapmanip/submap/extract/golden_deep,
/obj/machinery/shieldwallgen,
/turf/template_noop,
/area/template_noop)
"Ja" = (
/obj/random/dirt_75,
/turf/template_noop,
/area/template_noop)
"Km" = (
/obj/structure/reagent_dispensers/fueltank,
/turf/template_noop,
/area/template_noop)
"Ky" = (
/obj/machinery/portable_atmospherics/hydroponics,
/obj/random/dirt_75,
/turf/template_noop,
/area/template_noop)
"KW" = (
/obj/machinery/stasis_cage{
	req_access = list()
	},
/obj/effect/map_effect/marker/mapmanip/submap/extract/golden_deep,
/turf/template_noop,
/area/template_noop)
"Ld" = (
/obj/machinery/vending/dinnerware,
/turf/template_noop,
/area/template_noop)
"LF" = (
/obj/machinery/portable_atmospherics/hydroponics,
/turf/template_noop,
/area/template_noop)
"LS" = (
/obj/effect/map_effect/marker/mapmanip/submap/extract/golden_deep,
/obj/structure/closet/secure_closet/freezer/meat,
/obj/item/reagent_containers/food/snacks/meat/chicken,
/obj/item/reagent_containers/food/snacks/meat/chicken,
/obj/item/reagent_containers/food/snacks/meat/chicken,
/obj/item/reagent_containers/food/snacks/meat/chicken,
/obj/item/reagent_containers/food/snacks/meat/chicken,
/obj/item/reagent_containers/food/snacks/fish/fishfillet,
/obj/item/reagent_containers/food/snacks/fish/fishfillet,
/obj/item/reagent_containers/food/snacks/fish/fishfillet,
/obj/item/reagent_containers/food/snacks/fish/fishfillet,
/obj/item/reagent_containers/food/snacks/fish/fishfillet,
/turf/template_noop,
/area/template_noop)
"Mm" = (
/obj/structure/largecrate/animal/shark,
/turf/template_noop,
/area/template_noop)
"MJ" = (
/obj/machinery/vending/security{
	req_access = null
	},
/turf/template_noop,
/area/template_noop)
"Na" = (
/obj/effect/decal/cleanable/generic,
/turf/template_noop,
/area/template_noop)
"Ow" = (
/obj/effect/map_effect/marker_helper/mapmanip/submap/edge,
/turf/template_noop,
/area/template_noop)
"OR" = (
/obj/effect/map_effect/marker/mapmanip/submap/extract/golden_deep,
/obj/machinery/vending/hydronutrients,
/turf/template_noop,
/area/template_noop)
"Qz" = (
/obj/effect/decal/cleanable/generic,
/obj/random/dirt_75,
/obj/structure/closet/crate/loot,
/turf/template_noop,
/area/template_noop)
"QO" = (
/obj/structure/closet/crate/loot,
/turf/template_noop,
/area/template_noop)
"Sh" = (
/obj/machinery/chem_master,
/obj/random/dirt_75,
/turf/template_noop,
/area/template_noop)
"Th" = (
/obj/item/device/versebook/biesel,
/obj/item/storage/stickersheet/biesel,
/obj/item/clothing/accessory/poncho/shouldercape/nationcapes/biesel,
/obj/item/clothing/suit/storage/legion/tcaf{
	desc = "A pale blue canvas jacket embossed with the insignia of the Tau Ceti Armed Forces. It looks a little knocked about."
	},
/obj/item/clothing/suit/storage/toggle/leather_jacket/flight/legion/tcaf{
	desc = "A cheap pilot's jacket. An immense stock of exactly this design has been grandfathered into the Tau Ceti Armed Forces via its predecessor, the Tau Ceti Foreign Legion, to the point of a near-complete ubiquity. This one looks a little worn, as if it were well loved by its previous owner."
	},
/obj/item/clothing/head/beret/legion/tcaf/tcaf_field,
/obj/item/clothing/head/beret/legion/tcaf,
/obj/item/clothing/head/softcap/tcaf_cap,
/obj/structure/closet/crate/secure/legion{
	name = "tau ceti armed forces supply crate";
	req_access = null;
	req_one_access = list(229, 217)
	},
/obj/random/dirt_75,
/turf/template_noop,
/area/template_noop)
"Tw" = (
/obj/effect/map_effect/marker/mapmanip/submap/extract/golden_deep,
/obj/structure/closet/crate/medical,
/obj/random/medical,
/obj/random/medical,
/obj/random/medical,
/obj/random/medical,
/obj/random/medical,
/obj/random/medical,
/obj/random/medical,
/obj/random/firstaid,
/obj/random/firstaid,
/obj/random/firstaid,
/obj/random/medical,
/obj/random/medical,
/obj/random/medical,
/turf/template_noop,
/area/template_noop)
"Uw" = (
/obj/structure/table/steel,
/obj/item/toy/desk/fan{
	pixel_y = 11;
	pixel_x = -7
	},
/obj/item/paper_bin{
	pixel_x = 10;
	pixel_y = 1
	},
/obj/item/pen{
	pixel_x = 9
	},
/obj/random/dirt_75,
/turf/template_noop,
/area/template_noop)
"VD" = (
/obj/machinery/vending/hydroseeds,
/obj/random/dirt_75,
/turf/template_noop,
/area/template_noop)
"VT" = (
/obj/structure/closet/crate,
/obj/random/booze,
/obj/random/booze,
/obj/random/booze,
/obj/random/booze,
/obj/random/booze,
/obj/random/booze,
/obj/random/booze,
/obj/random/booze,
/obj/random/booze,
/obj/random/booze,
/obj/random/dirt_75,
/turf/template_noop,
/area/template_noop)
"Wp" = (
/obj/structure/closet/secure_closet/refrigerator/standard,
/turf/template_noop,
/area/template_noop)
"Wr" = (
/obj/structure/closet/crate/secure/weapon/alt{
	req_one_access = list(229, 217)
	},
/obj/item/melee/energy/vaurca_zweihander,
/obj/item/melee/energy/vaurca,
/obj/random/dirt_75,
/turf/template_noop,
/area/template_noop)
"YM" = (
/obj/structure/table/steel,
/obj/random/dirt_75,
/obj/random/mre,
/obj/item/material/hatchet/butch{
	pixel_x = 2;
	pixel_y = 3
	},
/turf/template_noop,
/area/template_noop)
"Za" = (
/obj/effect/map_effect/marker_helper/mapmanip/submap/edge{
	dir = 1
	},
/turf/template_noop,
/area/template_noop)
"Zd" = (
/obj/structure/table/steel,
/obj/item/melee/whip{
	pixel_x = -14
	},
/obj/item/gun/energy/net{
	pixel_y = -4
	},
/obj/item/storage/box/tranquilizer{
	pixel_y = 14
	},
/obj/item/storage/box/tranquilizer{
	pixel_y = 14
	},
/obj/item/gun/projectile/heavysniper/tranq{
	pixel_y = 2
	},
/turf/template_noop,
/area/template_noop)
"ZD" = (
/obj/structure/closet/crate/secure/phoron{
	name = "secure crate";
	req_one_access = list(229, 217)
	},
/obj/item/rig/tesla,
/obj/random/dirt_75,
/turf/template_noop,
/area/template_noop)
"ZZ" = (
/obj/effect/map_effect/marker_helper/mapmanip/submap/edge{
	dir = 4
	},
/turf/template_noop,
/area/template_noop)

(1,1,1) = {"
sq
sq
sq
sq
sq
sq
sq
sq
sq
sq
sq
sq
sq
sq
sq
sq
sq
sq
sq
sq
sq
sq
sq
sq
sq
sq
sq
sq
sq
"}
(2,1,1) = {"
sq
sq
ZZ
ZZ
sq
sq
sq
sq
sq
ZZ
ZZ
sq
sq
sq
sq
sq
ZZ
ZZ
sq
sq
sq
sq
sq
ZZ
ZZ
sq
sq
sq
sq
"}
(3,1,1) = {"
sq
Ow
ji
sq
sq
zk
sq
sq
Ow
HK
sq
sq
hN
sq
sq
Ow
ar
sq
sq
lT
sq
sq
Ow
rC
sq
sq
Tw
sq
sq
"}
(4,1,1) = {"
sq
Ow
FV
sq
sq
Ah
sq
sq
Ow
sC
AU
sq
gP
sq
sq
Ow
CG
sq
sq
hx
sq
sq
Ow
lc
sq
sq
nP
sq
sq
"}
(5,1,1) = {"
sq
Ow
yn
sq
sq
uo
Za
sq
Ow
Sh
sq
sq
jV
Za
sq
Ow
vl
sq
sq
co
Za
sq
Ow
Wr
sq
sq
QO
Za
sq
"}
(6,1,1) = {"
sq
Ow
Fw
sq
sq
xD
Za
sq
Ow
Iy
sq
sq
zz
Za
sq
Ow
Hv
sq
sq
QO
Za
sq
Ow
Bp
sq
sq
QO
Za
sq
"}
(7,1,1) = {"
sq
sq
kI
kI
kI
kI
sq
sq
sq
kI
kI
kI
kI
sq
sq
sq
kI
kI
kI
kI
sq
sq
sq
kI
kI
kI
kI
sq
sq
"}
(8,1,1) = {"
sq
sq
sq
sq
sq
sq
sq
sq
sq
sq
sq
sq
sq
sq
sq
sq
sq
sq
sq
sq
sq
sq
sq
sq
sq
sq
sq
sq
sq
"}
(9,1,1) = {"
sq
sq
ZZ
ZZ
sq
sq
sq
sq
sq
ZZ
ZZ
sq
sq
sq
sq
sq
ZZ
ZZ
sq
sq
sq
sq
sq
ZZ
ZZ
sq
sq
sq
sq
"}
(10,1,1) = {"
sq
Ow
QO
sq
sq
Fy
sq
sq
Ow
QO
Na
sq
KW
sq
sq
Ow
BP
sq
sq
IT
sq
sq
Ow
QO
sq
sq
rg
sq
sq
"}
(11,1,1) = {"
sq
Ow
QO
sq
sq
QO
sq
sq
Ow
BJ
sq
sq
GF
sq
sq
Ow
MJ
sq
sq
mp
sq
sq
Ow
ZD
Ja
sq
Th
sq
sq
"}
(12,1,1) = {"
sq
Ow
QO
sq
sq
QO
Za
sq
Ow
BJ
sq
sq
ck
Za
sq
Ow
Km
sq
sq
DM
Za
sq
Ow
fy
sq
sq
QO
Za
sq
"}
(13,1,1) = {"
sq
Ow
QO
sq
sq
fM
Za
sq
Ow
Mm
sq
sq
Zd
Za
sq
Ow
nM
sq
sq
bs
Za
sq
Ow
br
sq
sq
eM
Za
sq
"}
(14,1,1) = {"
sq
sq
kI
kI
kI
kI
sq
sq
sq
kI
kI
kI
kI
sq
sq
sq
kI
kI
kI
kI
sq
sq
sq
kI
kI
kI
kI
sq
sq
"}
(15,1,1) = {"
sq
sq
sq
sq
sq
sq
sq
sq
sq
sq
sq
sq
sq
sq
sq
sq
sq
sq
sq
sq
sq
sq
sq
sq
sq
sq
sq
sq
sq
"}
(16,1,1) = {"
sq
sq
ZZ
ZZ
sq
sq
sq
sq
sq
ZZ
ZZ
sq
sq
sq
sq
sq
ZZ
ZZ
sq
sq
sq
sq
sq
ZZ
ZZ
sq
sq
sq
sq
"}
(17,1,1) = {"
sq
Ow
QO
sq
sq
GC
sq
sq
Ow
QO
sq
sq
LS
sq
sq
Ow
by
sq
sq
Ht
sq
sq
Ow
Qz
sq
sq
OR
sq
sq
"}
(18,1,1) = {"
sq
Ow
Uw
AU
sq
QO
sq
sq
Ow
cS
sq
sq
Wp
sq
sq
Ow
QO
sq
sq
QO
sq
sq
Ow
LF
sq
sq
VD
sq
sq
"}
(19,1,1) = {"
sq
Ow
Bw
sq
sq
gY
Za
sq
Ow
YM
sq
CF
uJ
Za
sq
Ow
xt
sq
sq
vs
Za
sq
Ow
Ky
sq
sq
ci
Za
sq
"}
(20,1,1) = {"
sq
Ow
xk
Ja
sq
pe
Za
sq
Ow
Ld
sq
sq
VT
Za
sq
Ow
Ge
sq
sq
fj
Za
sq
Ow
Ky
Ja
sq
xA
Za
sq
"}
(21,1,1) = {"
sq
sq
kI
kI
kI
kI
sq
sq
sq
kI
kI
kI
kI
sq
sq
sq
kI
kI
kI
kI
sq
sq
sq
kI
kI
kI
kI
sq
sq
"}
(22,1,1) = {"
sq
sq
sq
sq
sq
sq
sq
sq
sq
sq
sq
sq
sq
sq
sq
sq
sq
sq
sq
sq
sq
sq
sq
sq
sq
sq
sq
sq
sq
"}
