//MAP CONVERTED BY dmm2tgm.py THIS HEADER COMMENT PREVENTS RECONVERSION, DO NOT REMOVE
"a" = (
/turf/template_noop,
/area/space)
"b" = (
/obj/structure/closet/crate/loot,
/turf/template_noop,
/area/space)
"c" = (
/obj/structure/closet/crate/secure/phoron{
	name = "secure crate";
	req_one_access = list(229, 217)
	},
/turf/template_noop,
/area/space)
"d" = (
/obj/structure/table/rack/folding_table,
/obj/item/storage/box/fancy/vials{
	pixel_x = -4;
	pixel_y = 13
	},
/obj/item/reagent_containers/dropper/electronic_pipette{
	pixel_x = 8;
	pixel_y = 2
	},
/turf/template_noop,
/area/space)
"e" = (
/obj/structure/largecrate/animal/adhomai/schlorrgo,
/turf/template_noop,
/area/space)
"f" = (
/obj/effect/map_effect/marker/mapmanip/submap/extract/golden_deep,
/obj/structure/table/rack/folding_table,
/obj/machinery/reagentgrinder{
	pixel_y = 17;
	pixel_x = 6
	},
/obj/item/reagent_containers/glass/beaker/large{
	pixel_y = 4;
	pixel_x = -8
	},
/obj/item/reagent_containers/glass/beaker/large{
	pixel_y = 4;
	pixel_x = 8
	},
/turf/template_noop,
/area/space)
"g" = (
/obj/structure/closet/crate/drop,
/obj/item/stack/material/phoron{
	amount = 15
	},
/obj/item/grenade/chem_grenade,
/obj/item/grenade/chem_grenade,
/obj/item/grenade/chem_grenade,
/obj/item/grenade/chem_grenade,
/obj/item/device/assembly/igniter,
/obj/item/device/assembly/igniter,
/obj/item/device/assembly/igniter,
/obj/item/device/assembly/igniter,
/obj/item/device/assembly/timer,
/obj/item/device/assembly/timer,
/obj/item/device/assembly/timer,
/obj/item/device/assembly/timer,
/obj/item/storage/box/autoinjectors,
/obj/item/storage/box/inhalers_auto,
/turf/template_noop,
/area/space)
"j" = (
/obj/machinery/stasis_cage{
	req_access = list()
	},
/turf/template_noop,
/area/space)
"k" = (
/obj/effect/map_effect/marker/mapmanip/submap/extract/golden_deep,
/turf/template_noop,
/area/space)
"m" = (
/obj/effect/map_effect/marker_helper/mapmanip/submap/edge{
	dir = 1
	},
/turf/template_noop,
/area/space)
"n" = (
/obj/effect/map_effect/marker_helper/mapmanip/submap/edge{
	dir = 4
	},
/turf/template_noop,
/area/space)
"p" = (
/obj/effect/map_effect/marker/mapmanip/submap/extract/golden_deep,
/obj/structure/table/reinforced/steel,
/turf/template_noop,
/area/space)
"s" = (
/obj/structure/table/rack,
/turf/template_noop,
/area/space)
"u" = (
/obj/machinery/stasis_cage{
	req_access = list()
	},
/obj/effect/map_effect/marker/mapmanip/submap/extract/golden_deep,
/turf/template_noop,
/area/space)
"z" = (
/obj/structure/table/reinforced/steel,
/turf/template_noop,
/area/space)
"A" = (
/obj/effect/map_effect/marker/mapmanip/submap/extract/golden_deep,
/obj/structure/closet/crate/loot,
/turf/template_noop,
/area/space)
"C" = (
/obj/effect/map_effect/marker_helper/mapmanip/submap/edge,
/turf/template_noop,
/area/space)
"E" = (
/obj/effect/map_effect/marker/mapmanip/submap/extract/golden_deep,
/obj/structure/table/rack,
/turf/template_noop,
/area/space)
"F" = (
/obj/structure/largecrate/animal/moghes/miervesh,
/turf/template_noop,
/area/space)
"G" = (
/obj/structure/table/steel,
/turf/template_noop,
/area/space)
"H" = (
/obj/effect/map_effect/marker_helper/mapmanip/submap/edge{
	dir = 8
	},
/turf/template_noop,
/area/space)
"K" = (
/obj/machinery/chem_master,
/turf/template_noop,
/area/space)
"L" = (
/obj/structure/closet/cabinet,
/turf/template_noop,
/area/space)
"M" = (
/obj/structure/closet/crate/secure/weapon/alt,
/turf/template_noop,
/area/space)
"P" = (
/obj/effect/map_effect/marker/mapmanip/submap/extract/golden_deep,
/obj/structure/largecrate/animal/adhomai/fatshouter,
/turf/template_noop,
/area/space)
"Q" = (
/obj/structure/largecrate/animal/adhomai/rafama,
/turf/template_noop,
/area/space)
"R" = (
/obj/structure/largecrate/animal/moghes/warmount,
/turf/template_noop,
/area/space)
"S" = (
/obj/structure/largecrate/animal/adhomai/harron,
/turf/template_noop,
/area/space)
"V" = (
/obj/machinery/chemical_dispenser/full{
	dir = 1
	},
/turf/template_noop,
/area/space)
"W" = (
/obj/structure/bed/stool/chair/office/light{
	dir = 1
	},
/turf/template_noop,
/area/space)
"X" = (
/obj/machinery/chem_heater,
/turf/template_noop,
/area/space)
"Y" = (
/obj/structure/largecrate/animal/moghes/otzek,
/turf/template_noop,
/area/space)
"Z" = (
/obj/structure/table/rack/folding_table,
/turf/template_noop,
/area/space)

(1,1,1) = {"
a
a
a
a
a
a
a
a
a
a
a
a
a
a
a
a
a
a
a
a
a
a
a
a
a
a
a
a
a
"}
(2,1,1) = {"
a
a
n
n
a
a
a
a
a
n
n
a
a
a
a
a
n
n
a
a
a
a
a
n
n
a
a
a
a
"}
(3,1,1) = {"
a
C
L
a
a
E
a
a
C
V
a
a
f
a
a
C
z
a
a
p
a
a
C
Z
a
a
A
a
a
"}
(4,1,1) = {"
a
C
L
a
a
L
a
a
C
d
W
a
X
a
a
C
c
a
a
c
a
a
C
M
a
a
z
a
a
"}
(5,1,1) = {"
a
C
L
a
a
L
m
a
C
K
a
a
b
m
a
C
c
a
a
c
m
a
C
M
a
a
z
m
a
"}
(6,1,1) = {"
a
C
s
a
a
L
m
a
C
g
a
a
b
m
a
C
z
a
a
z
m
a
C
M
a
a
z
m
a
"}
(7,1,1) = {"
a
a
H
H
H
H
a
a
a
H
H
H
H
a
a
a
H
H
H
H
a
a
a
H
H
H
H
a
a
"}
(8,1,1) = {"
a
a
a
a
a
a
a
a
a
a
a
a
a
a
a
a
a
a
a
a
a
a
a
a
a
a
a
a
a
"}
(9,1,1) = {"
a
a
n
n
a
a
a
a
a
n
n
a
a
a
a
a
n
n
a
a
a
a
a
n
n
a
a
a
a
"}
(10,1,1) = {"
a
C
G
a
a
P
a
a
C
R
a
a
u
a
a
C
a
a
a
k
a
a
C
a
a
a
k
a
a
"}
(11,1,1) = {"
a
C
G
a
a
e
a
a
C
Y
a
a
j
a
a
C
a
a
a
a
a
a
C
a
a
a
a
a
a
"}
(12,1,1) = {"
a
C
j
a
a
S
m
a
C
F
a
a
G
m
a
C
a
a
a
a
m
a
C
a
a
a
a
m
a
"}
(13,1,1) = {"
a
C
j
a
a
Q
m
a
C
b
a
a
G
m
a
C
a
a
a
a
m
a
C
a
a
a
a
m
a
"}
(14,1,1) = {"
a
a
H
H
H
H
a
a
a
H
H
H
H
a
a
a
H
H
H
H
a
a
a
H
H
H
H
a
a
"}
(15,1,1) = {"
a
a
a
a
a
a
a
a
a
a
a
a
a
a
a
a
a
a
a
a
a
a
a
a
a
a
a
a
a
"}
(16,1,1) = {"
a
a
n
n
a
a
a
a
a
n
n
a
a
a
a
a
n
n
a
a
a
a
a
n
n
a
a
a
a
"}
(17,1,1) = {"
a
C
a
a
a
k
a
a
C
a
a
a
k
a
a
C
a
a
a
k
a
a
C
a
a
a
k
a
a
"}
(18,1,1) = {"
a
C
a
a
a
a
a
a
C
a
a
a
a
a
a
C
a
a
a
a
a
a
C
a
a
a
a
a
a
"}
(19,1,1) = {"
a
C
a
a
a
a
m
a
C
a
a
a
a
m
a
C
a
a
a
a
m
a
C
a
a
a
a
m
a
"}
(20,1,1) = {"
a
C
a
a
a
a
m
a
C
a
a
a
a
m
a
C
a
a
a
a
m
a
C
a
a
a
a
m
a
"}
(21,1,1) = {"
a
a
H
H
H
H
a
a
a
H
H
H
H
a
a
a
H
H
H
H
a
a
a
H
H
H
H
a
a
"}
(22,1,1) = {"
a
a
a
a
a
a
a
a
a
a
a
a
a
a
a
a
a
a
a
a
a
a
a
a
a
a
a
a
a
"}
