//MAP CONVERTED BY dmm2tgm.py THIS HEADER COMMENT PREVENTS RECONVERSION, DO NOT REMOVE
"a" = (
/obj/machinery/suit_cycler/medical,
/turf/unsimulated/floor{
	icon_state = "vault";
	dir = 5
	},
/area/centcom/distress_prep)
"b" = (
/turf/unsimulated/floor{
	icon_state = "vault";
	dir = 5
	},
/area/centcom/distress_prep)
"c" = (
/obj/structure/table/rack,
/obj/item/clothing/suit/space/void/medical,
/obj/item/clothing/suit/space/void/medical,
/obj/item/clothing/mask/breath,
/obj/item/clothing/mask/breath,
/obj/item/clothing/head/helmet/space/void/medical,
/obj/item/clothing/head/helmet/space/void/medical,
/obj/structure/fireaxecabinet{
	pixel_x = -30;
	unlocked = 1
	},
/turf/unsimulated/floor{
	icon_state = "vault";
	dir = 5
	},
/area/centcom/distress_prep)
"d" = (
/obj/structure/closet/crate/freezer{
	layer = 2.99;
	name = "rations"
	},
/obj/item/reagent_containers/food/snacks/koisbar_clean,
/obj/item/reagent_containers/food/snacks/koisbar_clean,
/obj/item/reagent_containers/food/snacks/koisbar_clean,
/obj/item/reagent_containers/food/snacks/koisbar_clean,
/obj/item/reagent_containers/food/snacks/liquidfood,
/obj/item/reagent_containers/food/snacks/liquidfood,
/obj/item/reagent_containers/food/snacks/liquidfood,
/obj/item/reagent_containers/food/snacks/liquidfood,
/obj/item/reagent_containers/food/snacks/liquidfood,
/obj/item/reagent_containers/food/snacks/liquidfood,
/obj/item/reagent_containers/food/snacks/liquidfood,
/obj/item/reagent_containers/food/snacks/liquidfood,
/obj/item/reagent_containers/food/snacks/liquidfood,
/obj/item/reagent_containers/food/snacks/liquidfood,
/obj/item/reagent_containers/food/snacks/skrellsnacks,
/obj/item/reagent_containers/food/snacks/skrellsnacks,
/obj/item/reagent_containers/food/snacks/skrellsnacks,
/obj/item/reagent_containers/food/snacks/skrellsnacks,
/obj/item/reagent_containers/food/snacks/nathisnack,
/obj/item/reagent_containers/food/snacks/nathisnack,
/obj/item/reagent_containers/food/drinks/cans/waterbottle,
/obj/item/reagent_containers/food/drinks/cans/waterbottle,
/obj/item/reagent_containers/food/drinks/cans/waterbottle,
/obj/item/reagent_containers/food/drinks/cans/waterbottle,
/obj/item/reagent_containers/food/drinks/cans/waterbottle,
/obj/item/reagent_containers/food/drinks/cans/waterbottle,
/obj/item/reagent_containers/food/drinks/cans/waterbottle,
/obj/item/reagent_containers/food/drinks/cans/waterbottle,
/obj/item/reagent_containers/food/drinks/cans/waterbottle,
/obj/item/reagent_containers/food/drinks/cans/waterbottle,
/obj/random/plushie,
/obj/random/plushie,
/turf/unsimulated/floor{
	icon_state = "platebot"
	},
/area/centcom/distress_prep)
"e" = (
/obj/structure/closet/crate/freezer{
	layer = 2.99;
	name = "blood, surgery equipment"
	},
/obj/item/reagent_containers/blood/OMinus,
/obj/item/reagent_containers/blood/OMinus,
/obj/item/reagent_containers/blood/OMinus,
/obj/item/reagent_containers/blood/OMinus,
/obj/item/reagent_containers/blood/OMinus,
/obj/item/reagent_containers/blood/OMinus,
/obj/item/reagent_containers/blood/OMinus,
/obj/item/reagent_containers/blood/OMinus,
/obj/item/reagent_containers/blood/OMinus,
/obj/item/reagent_containers/blood/OMinus,
/obj/item/reagent_containers/blood/OMinus,
/obj/item/reagent_containers/blood/OMinus,
/obj/item/reagent_containers/spray/cleaner,
/obj/item/deployable_kit/surgery_table,
/obj/item/deployable_kit/surgery_table,
/obj/item/storage/firstaid/surgery,
/obj/item/storage/firstaid/surgery,
/obj/item/deployable_kit/iv_drip,
/obj/item/deployable_kit/iv_drip,
/obj/item/deployable_kit/iv_drip,
/turf/unsimulated/floor{
	icon_state = "platebot"
	},
/area/centcom/distress_prep)
"f" = (
/obj/structure/closet/crate/medical{
	layer = 2.99
	},
/obj/item/cane/crutch,
/obj/item/cane/crutch,
/obj/item/cane/crutch,
/obj/item/cane/crutch,
/obj/item/roller,
/obj/item/roller,
/obj/item/roller,
/obj/item/roller,
/obj/item/roller,
/obj/item/roller,
/obj/item/roller,
/obj/item/roller,
/obj/item/storage/box/masks,
/obj/item/storage/box/gloves,
/obj/item/storage/box/bodybags,
/obj/item/storage/firstaid/adv,
/obj/item/storage/firstaid/adv,
/obj/item/storage/firstaid/regular,
/obj/item/storage/firstaid/regular,
/obj/item/storage/firstaid/o2{
	pixel_x = -3;
	pixel_y = -1
	},
/obj/item/storage/firstaid/fire{
	pixel_x = 2;
	pixel_y = 6
	},
/obj/item/storage/firstaid/toxin{
	pixel_x = 6
	},
/obj/item/stack/material/steel{
	amount = 50
	},
/obj/item/stack/material/plastic{
	amount = 50
	},
/turf/unsimulated/floor{
	icon_state = "platebot"
	},
/area/centcom/distress_prep)
"r" = (
/mob/living/heavy_vehicle/premade/light/iac,
/turf/unsimulated/floor{
	icon_state = "platebot"
	},
/area/centcom/distress_prep)

(1,1,1) = {"
a
c
d
"}
(2,1,1) = {"
b
b
f
"}
(3,1,1) = {"
b
b
e
"}
(4,1,1) = {"
b
b
r
"}
