//MAP CONVERTED BY dmm2tgm.py THIS HEADER COMMENT PREVENTS RECONVERSION, DO NOT REMOVE
"d" = (
/obj/structure/closet/crate/freezer{
	layer = 2.99;
	name = "rations"
	},
/obj/item/reagent_containers/food/snacks/koisbar_clean,
/obj/item/reagent_containers/food/snacks/koisbar_clean,
/obj/item/reagent_containers/food/snacks/koisbar_clean,
/obj/item/reagent_containers/food/snacks/koisbar_clean,
/obj/item/reagent_containers/food/snacks/liquidfood,
/obj/item/reagent_containers/food/snacks/liquidfood,
/obj/item/reagent_containers/food/snacks/liquidfood,
/obj/item/reagent_containers/food/snacks/liquidfood,
/obj/item/reagent_containers/food/snacks/liquidfood,
/obj/item/reagent_containers/food/snacks/liquidfood,
/obj/item/reagent_containers/food/snacks/liquidfood,
/obj/item/reagent_containers/food/snacks/liquidfood,
/obj/item/reagent_containers/food/snacks/liquidfood,
/obj/item/reagent_containers/food/snacks/liquidfood,
/obj/item/reagent_containers/food/snacks/skrellsnacks,
/obj/item/reagent_containers/food/snacks/skrellsnacks,
/obj/item/reagent_containers/food/snacks/skrellsnacks,
/obj/item/reagent_containers/food/snacks/skrellsnacks,
/obj/item/reagent_containers/food/snacks/nathisnack,
/obj/item/reagent_containers/food/snacks/nathisnack,
/obj/item/reagent_containers/food/drinks/cans/waterbottle,
/obj/item/reagent_containers/food/drinks/cans/waterbottle,
/obj/item/reagent_containers/food/drinks/cans/waterbottle,
/obj/item/reagent_containers/food/drinks/cans/waterbottle,
/obj/item/reagent_containers/food/drinks/cans/waterbottle,
/obj/item/reagent_containers/food/drinks/cans/waterbottle,
/obj/item/reagent_containers/food/drinks/cans/waterbottle,
/obj/item/reagent_containers/food/drinks/cans/waterbottle,
/obj/item/reagent_containers/food/drinks/cans/waterbottle,
/obj/item/reagent_containers/food/drinks/cans/waterbottle,
/obj/random/plushie,
/obj/random/plushie,
/turf/unsimulated/floor{
	icon_state = "platebot"
	},
/area/centcom/distress_prep)
"f" = (
/obj/structure/closet/crate/medical{
	layer = 2.99
	},
/obj/item/cane/crutch,
/obj/item/cane/crutch,
/obj/item/cane/crutch,
/obj/item/cane/crutch,
/obj/item/roller,
/obj/item/roller,
/obj/item/roller,
/obj/item/roller,
/obj/item/roller,
/obj/item/roller,
/obj/item/roller,
/obj/item/roller,
/obj/item/storage/box/masks,
/obj/item/storage/box/gloves,
/obj/item/storage/box/bodybags,
/obj/item/storage/firstaid/adv,
/obj/item/storage/firstaid/adv,
/obj/item/storage/firstaid/regular,
/obj/item/storage/firstaid/regular,
/obj/item/storage/firstaid/o2{
	pixel_x = -3;
	pixel_y = -1
	},
/obj/item/storage/firstaid/fire{
	pixel_x = 2;
	pixel_y = 6
	},
/obj/item/storage/firstaid/toxin{
	pixel_x = 6
	},
/obj/item/stack/material/steel{
	amount = 50
	},
/obj/item/stack/material/plastic{
	amount = 50
	},
/turf/unsimulated/floor{
	icon_state = "platebot"
	},
/area/centcom/distress_prep)
"r" = (
/mob/living/heavy_vehicle/premade/light/iac,
/turf/unsimulated/floor{
	icon_state = "platebot"
	},
/area/centcom/distress_prep)
"S" = (
/obj/structure/closet/crate/freezer{
	layer = 2.99;
	name = "blood, surgery equipment"
	},
/obj/item/reagent_containers/blood/OMinus,
/obj/item/reagent_containers/blood/OMinus,
/obj/item/reagent_containers/blood/OMinus,
/obj/item/reagent_containers/blood/OMinus,
/obj/item/reagent_containers/blood/OMinus,
/obj/item/reagent_containers/blood/OMinus,
/obj/item/reagent_containers/blood/OMinus,
/obj/item/reagent_containers/blood/OMinus,
/obj/item/reagent_containers/blood/OMinus,
/obj/item/reagent_containers/blood/OMinus,
/obj/item/reagent_containers/blood/OMinus,
/obj/item/reagent_containers/blood/OMinus,
/obj/item/reagent_containers/spray/cleaner,
/obj/item/deployable_kit/surgery_table,
/obj/item/deployable_kit/surgery_table,
/obj/item/storage/firstaid/surgery,
/obj/item/storage/firstaid/surgery,
/obj/machinery/iv_drip{
	density = 0
	},
/obj/machinery/iv_drip{
	density = 0
	},
/turf/unsimulated/floor{
	icon_state = "platebot"
	},
/area/centcom/distress_prep)

(1,1,1) = {"
d
"}
(2,1,1) = {"
f
"}
(3,1,1) = {"
S
"}
(4,1,1) = {"
r
"}
