//MAP CONVERTED BY dmm2tgm.py THIS HEADER COMMENT PREVENTS RECONVERSION, DO NOT REMOVE
"a" = (
/obj/machinery/power/emitter,
/obj/effect/decal/warning_stripes,
/turf/unsimulated/floor{
	icon_state = "vault";
	dir = 5
	},
/area/centcom/distress_prep)
"b" = (
/turf/unsimulated/floor{
	icon_state = "vault";
	dir = 5
	},
/area/centcom/distress_prep)
"c" = (
/obj/structure/table/rack,
/obj/item/stack/material/steel{
	amount = 50
	},
/obj/item/stack/material/plasteel{
	amount = 50;
	pixel_x = 2;
	pixel_y = -2
	},
/obj/item/stack/material/glass{
	amount = 50;
	pixel_x = 4;
	pixel_y = -4
	},
/obj/item/device/debugger{
	pixel_x = 2;
	pixel_y = -5
	},
/obj/item/device/debugger{
	pixel_y = -5
	},
/obj/item/device/multitool{
	pixel_x = -2;
	pixel_y = -6
	},
/obj/item/device/multitool{
	pixel_x = -4;
	pixel_y = -6
	},
/obj/item/clothing/gloves/yellow/specialu,
/obj/item/clothing/gloves/yellow/specialu,
/turf/unsimulated/floor{
	icon_state = "vault";
	dir = 5
	},
/area/centcom/distress_prep)
"d" = (
/obj/structure/closet/crate/freezer{
	name = "rations"
	},
/obj/item/reagent_containers/food/snacks/koisbar_clean,
/obj/item/reagent_containers/food/snacks/koisbar_clean,
/obj/item/reagent_containers/food/snacks/koisbar_clean,
/obj/item/reagent_containers/food/snacks/koisbar_clean,
/obj/item/reagent_containers/food/snacks/liquidfood,
/obj/item/reagent_containers/food/snacks/liquidfood,
/obj/item/reagent_containers/food/snacks/liquidfood,
/obj/item/reagent_containers/food/snacks/liquidfood,
/obj/item/reagent_containers/food/snacks/liquidfood,
/obj/item/reagent_containers/food/snacks/liquidfood,
/obj/item/reagent_containers/food/snacks/liquidfood,
/obj/item/reagent_containers/food/snacks/liquidfood,
/obj/item/reagent_containers/food/snacks/liquidfood,
/obj/item/reagent_containers/food/snacks/liquidfood,
/obj/item/reagent_containers/food/snacks/skrellsnacks,
/obj/item/reagent_containers/food/snacks/skrellsnacks,
/obj/item/reagent_containers/food/snacks/skrellsnacks,
/obj/item/reagent_containers/food/snacks/skrellsnacks,
/obj/item/reagent_containers/food/snacks/nathisnack,
/obj/item/reagent_containers/food/snacks/nathisnack,
/obj/item/reagent_containers/food/drinks/cans/waterbottle,
/obj/item/reagent_containers/food/drinks/cans/waterbottle,
/obj/item/reagent_containers/food/drinks/cans/waterbottle,
/obj/item/reagent_containers/food/drinks/cans/waterbottle,
/obj/item/reagent_containers/food/drinks/cans/waterbottle,
/obj/item/reagent_containers/food/drinks/cans/waterbottle,
/obj/item/reagent_containers/food/drinks/cans/waterbottle,
/obj/item/reagent_containers/food/drinks/cans/waterbottle,
/obj/item/reagent_containers/food/drinks/cans/waterbottle,
/obj/item/reagent_containers/food/drinks/cans/waterbottle,
/turf/unsimulated/floor{
	icon_state = "platebot"
	},
/area/centcom/distress_prep)
"e" = (
/obj/structure/table/rack,
/obj/item/gun/projectile/heavysniper/unathi{
	pixel_y = 4
	},
/obj/item/ammo_casing/slugger,
/obj/item/ammo_casing/slugger,
/obj/item/ammo_casing/slugger,
/obj/item/device/binoculars{
	pixel_x = -4;
	pixel_y = -6
	},
/obj/item/device/binoculars{
	pixel_x = 4;
	pixel_y = -6
	},
/turf/unsimulated/floor{
	icon_state = "platebot"
	},
/area/centcom/distress_prep)
"f" = (
/obj/structure/table/rack,
/obj/item/storage/backpack/satchel/hegemony{
	pixel_x = -2;
	pixel_y = 2
	},
/obj/item/storage/backpack/satchel/hegemony{
	pixel_x = 2;
	pixel_y = -2
	},
/turf/unsimulated/floor{
	icon_state = "platebot"
	},
/area/centcom/distress_prep)
"g" = (
/mob/living/heavy_vehicle/premade/light/kataphract,
/turf/unsimulated/floor{
	icon_state = "platebot"
	},
/area/centcom/distress_prep)

(1,1,1) = {"
a
c
d
"}
(2,1,1) = {"
b
b
e
"}
(3,1,1) = {"
b
b
f
"}
(4,1,1) = {"
b
b
g
"}
