//MAP CONVERTED BY dmm2tgm.py THIS HEADER COMMENT PREVENTS RECONVERSION, DO NOT REMOVE
"a" = (
/obj/effect/landmark/clear,
/turf/template_noop,
/area/template_noop)
"h" = (
/obj/effect/landmark/clear,
/obj/structure/sign/flag/hegemony,
/turf/template_noop,
/area/template_noop)
"J" = (
/obj/effect/landmark/clear,
/obj/structure/survey_probe/hegemony/old,
/turf/template_noop,
/area/template_noop)

(1,1,1) = {"
a
a
a
"}
(2,1,1) = {"
h
J
a
"}
(3,1,1) = {"
a
a
a
"}
