//MAP CONVERTED BY dmm2tgm.py THIS HEADER COMMENT PREVENTS RECONVERSION, DO NOT REMOVE
"bj" = (
/obj/machinery/vending/engivend{
	req_access = null
	},
/obj/effect/floor_decal/corner/yellow/diagonal,
/obj/effect/floor_decal/industrial/outline/yellow,
/turf/simulated/floor/tiled/dark,
/area/gibson_resupply)
"ef" = (
/obj/effect/floor_decal/corner/lime/diagonal,
/obj/structure/table/steel,
/obj/item/storage/firstaid/surgery{
	pixel_y = 3;
	pixel_x = 2
	},
/obj/machinery/vending/wallmed1{
	pixel_y = 32;
	req_access = null
	},
/turf/simulated/floor/tiled/white,
/area/gibson_resupply)
"ew" = (
/obj/machinery/atmospherics/unary/vent_pump/high_volume/aux{
	dir = 8
	},
/obj/effect/map_effect/marker/airlock{
	master_tag = "gibson_resupply";
	name = "gibson_resupply";
	req_one_access = null
	},
/turf/simulated/floor/plating,
/area/gibson_resupply)
"iC" = (
/obj/machinery/embedded_controller/radio/airlock/docking_port{
	dir = 4;
	pixel_x = -28
	},
/obj/machinery/atmospherics/unary/vent_pump/high_volume/aux{
	dir = 4
	},
/obj/effect/map_effect/marker/airlock{
	master_tag = "gibson_resupply";
	name = "gibson_resupply";
	req_one_access = null
	},
/turf/simulated/floor/plating,
/area/gibson_resupply)
"mv" = (
/obj/effect/floor_decal/corner/lime/diagonal,
/obj/structure/table/steel,
/obj/item/storage/firstaid/fire{
	pixel_x = 13;
	pixel_y = 9
	},
/obj/item/storage/firstaid/regular{
	pixel_y = 5;
	pixel_x = 4
	},
/obj/item/storage/firstaid/o2{
	pixel_x = -3;
	pixel_y = 2
	},
/obj/structure/sign/flag/newgibson{
	pixel_y = 32
	},
/turf/simulated/floor/tiled/white,
/area/gibson_resupply)
"mx" = (
/obj/effect/floor_decal/corner/lime/diagonal,
/obj/item/reagent_containers/blood/OMinus,
/obj/item/reagent_containers/blood/OMinus,
/obj/item/reagent_containers/blood/OMinus,
/obj/structure/closet/crate/medical,
/turf/simulated/floor/tiled/white,
/area/gibson_resupply)
"nC" = (
/obj/machinery/atmospherics/portables_connector/aux{
	dir = 4
	},
/obj/machinery/portable_atmospherics/canister/air/airlock,
/obj/effect/floor_decal/industrial/hatch/yellow,
/obj/structure/sign/flag/newgibson{
	pixel_y = -32
	},
/turf/simulated/floor/plating,
/area/gibson_resupply)
"nR" = (
/obj/machinery/door/airlock/engineering,
/turf/simulated/floor/tiled,
/area/gibson_resupply)
"oZ" = (
/obj/structure/closet/crate/freezer/rations,
/obj/effect/floor_decal/corner/dark_blue/diagonal,
/turf/simulated/floor/marble,
/area/gibson_resupply)
"rP" = (
/obj/machinery/airlock_sensor{
	dir = 4;
	pixel_x = -28
	},
/obj/machinery/atmospherics/unary/vent_pump/high_volume/aux{
	dir = 4
	},
/obj/effect/map_effect/marker/airlock{
	master_tag = "gibson_resupply";
	name = "gibson_resupply";
	req_one_access = null
	},
/turf/simulated/floor/plating,
/area/gibson_resupply)
"sw" = (
/obj/machinery/light{
	dir = 1
	},
/obj/machinery/recharge_station,
/obj/effect/floor_decal/corner/yellow/diagonal,
/obj/effect/floor_decal/industrial/outline/yellow,
/turf/simulated/floor/tiled/dark,
/area/gibson_resupply)
"uq" = (
/obj/machinery/door/airlock/medical{
	dir = 8
	},
/turf/simulated/floor/tiled,
/area/gibson_resupply)
"vV" = (
/obj/effect/floor_decal/corner/yellow/diagonal,
/obj/structure/sign/flag/newgibson{
	pixel_x = 32
	},
/turf/simulated/floor/tiled/dark,
/area/gibson_resupply)
"zf" = (
/turf/simulated/wall/r_wall,
/area/gibson_resupply)
"zh" = (
/obj/machinery/vending/tool,
/obj/effect/floor_decal/corner/yellow/diagonal,
/obj/effect/floor_decal/industrial/outline/yellow,
/turf/simulated/floor/tiled/dark,
/area/gibson_resupply)
"zl" = (
/turf/simulated/floor/tiled,
/area/gibson_resupply)
"zA" = (
/obj/machinery/door/airlock/external{
	dir = 1
	},
/obj/machinery/access_button{
	pixel_x = 28;
	dir = 1;
	pixel_y = 5
	},
/obj/machinery/atmospherics/pipe/simple/hidden/aux,
/obj/effect/map_effect/marker/airlock{
	master_tag = "gibson_resupply";
	name = "gibson_resupply";
	req_one_access = null
	},
/obj/effect/map_effect/marker_helper/airlock/interior,
/turf/simulated/floor/plating,
/area/gibson_resupply)
"Cw" = (
/obj/machinery/suit_cycler/engineering/prepared{
	req_access = null
	},
/obj/effect/floor_decal/corner/yellow/diagonal,
/obj/effect/floor_decal/industrial/outline/yellow,
/turf/simulated/floor/tiled/dark,
/area/gibson_resupply)
"Et" = (
/obj/effect/floor_decal/corner/dark_blue/diagonal,
/turf/simulated/floor/marble,
/area/gibson_resupply)
"Fi" = (
/obj/structure/sign/flag/newgibson{
	pixel_y = 32
	},
/obj/structure/closet/crate/freezer/rations,
/obj/effect/floor_decal/corner/dark_blue/diagonal,
/turf/simulated/floor/marble,
/area/gibson_resupply)
"Fv" = (
/obj/effect/floor_decal/corner/lime/diagonal,
/obj/structure/table/steel,
/obj/item/folder/white{
	pixel_x = -5
	},
/obj/item/storage/box/masks{
	pixel_y = 5;
	pixel_x = 2
	},
/obj/item/storage/box/gloves{
	pixel_x = 5;
	pixel_y = -1
	},
/obj/item/reagent_containers/spray/cleaner{
	pixel_x = -6;
	pixel_y = 12
	},
/obj/item/reagent_containers/spray/sterilizine{
	pixel_y = -1;
	pixel_x = -8
	},
/turf/simulated/floor/tiled/white,
/area/gibson_resupply)
"Gu" = (
/turf/simulated/floor/exoplanet/snow{
	temperature = 73.15
	},
/area/template_noop)
"GR" = (
/obj/machinery/light{
	dir = 4
	},
/obj/effect/floor_decal/corner/dark_blue/diagonal,
/turf/simulated/floor/marble,
/area/gibson_resupply)
"HA" = (
/obj/machinery/door/airlock/service{
	dir = 4
	},
/turf/simulated/floor/tiled,
/area/gibson_resupply)
"HR" = (
/obj/effect/floor_decal/corner/lime/diagonal,
/turf/simulated/floor/tiled/white,
/area/gibson_resupply)
"KI" = (
/obj/machinery/atmospherics/pipe/simple/hidden/aux{
	dir = 10
	},
/turf/simulated/floor/tiled,
/area/gibson_resupply)
"Oc" = (
/obj/effect/floor_decal/corner/yellow/diagonal,
/turf/simulated/floor/tiled/dark,
/area/gibson_resupply)
"Om" = (
/obj/structure/closet/crate/freezer/kois/rations,
/obj/effect/floor_decal/corner/dark_blue/diagonal,
/turf/simulated/floor/marble,
/area/gibson_resupply)
"OH" = (
/obj/machinery/door/airlock/external{
	dir = 1
	},
/obj/machinery/access_button{
	pixel_x = 28;
	pixel_y = -5
	},
/obj/effect/map_effect/marker/airlock{
	master_tag = "gibson_resupply";
	name = "gibson_resupply";
	req_one_access = null
	},
/obj/effect/map_effect/marker_helper/airlock/exterior,
/turf/simulated/floor/plating,
/area/gibson_resupply)
"Pg" = (
/obj/machinery/light{
	dir = 1
	},
/turf/simulated/floor/tiled,
/area/gibson_resupply)
"PV" = (
/obj/machinery/atmospherics/pipe/manifold4w/hidden/aux,
/obj/effect/map_effect/marker/airlock{
	master_tag = "gibson_resupply";
	name = "gibson_resupply";
	req_one_access = null
	},
/turf/simulated/floor/plating,
/area/gibson_resupply)
"Rh" = (
/obj/structure/sign/flag/newgibson{
	pixel_y = 32
	},
/turf/simulated/floor/exoplanet/snow{
	temperature = 73.15
	},
/area/template_noop)
"Ry" = (
/obj/machinery/atmospherics/unary/vent_pump/high_volume/aux{
	dir = 8
	},
/obj/effect/map_effect/marker/airlock{
	master_tag = "gibson_resupply";
	name = "gibson_resupply";
	req_one_access = null
	},
/obj/machinery/light/small{
	dir = 4
	},
/turf/simulated/floor/plating,
/area/gibson_resupply)
"Sn" = (
/obj/structure/bed/roller,
/obj/machinery/iv_drip{
	pixel_x = 7
	},
/obj/effect/floor_decal/corner/lime,
/turf/simulated/floor/tiled/white,
/area/gibson_resupply)
"SX" = (
/obj/machinery/light{
	dir = 1
	},
/turf/simulated/floor/exoplanet/snow{
	temperature = 73.15
	},
/area/gibson_resupply)
"UP" = (
/obj/machinery/atmospherics/pipe/manifold/hidden/aux,
/obj/effect/map_effect/marker/airlock{
	master_tag = "gibson_resupply";
	name = "gibson_resupply";
	req_one_access = null
	},
/turf/simulated/floor/plating,
/area/gibson_resupply)
"Wa" = (
/obj/effect/floor_decal/corner/lime/diagonal,
/obj/machinery/sleeper{
	dir = 1
	},
/turf/simulated/floor/tiled/white,
/area/gibson_resupply)
"WE" = (
/obj/effect/floor_decal/corner/yellow/diagonal,
/obj/structure/sign/flag/newgibson{
	pixel_x = -32
	},
/turf/simulated/floor/tiled/dark,
/area/gibson_resupply)
"WK" = (
/obj/structure/closet/crate,
/obj/item/storage/box/lights/mixed,
/obj/item/device/radio,
/obj/item/device/radio,
/obj/random/powercell,
/obj/random/tech_supply,
/obj/random/tech_supply,
/obj/effect/floor_decal/corner/yellow/diagonal,
/obj/effect/floor_decal/industrial/outline/yellow,
/turf/simulated/floor/tiled/dark,
/area/gibson_resupply)
"ZS" = (
/obj/effect/floor_decal/corner/lime/diagonal,
/obj/machinery/light{
	dir = 8
	},
/turf/simulated/floor/tiled/white,
/area/gibson_resupply)

(1,1,1) = {"
Gu
Gu
Gu
Gu
Gu
Gu
Gu
Gu
Gu
Gu
Gu
Gu
Gu
Gu
Gu
Gu
Gu
Gu
Gu
"}
(2,1,1) = {"
Gu
Gu
Gu
Gu
Gu
Gu
Gu
Gu
Gu
Gu
Gu
Gu
Gu
Gu
Gu
Gu
Gu
Gu
Gu
"}
(3,1,1) = {"
Gu
Gu
Gu
Gu
Gu
Gu
Gu
Gu
Gu
Gu
Gu
Gu
Gu
Gu
Gu
Gu
Gu
Gu
Gu
"}
(4,1,1) = {"
Gu
Gu
Gu
Gu
Gu
Gu
zf
zf
zf
zf
zf
Gu
Gu
Gu
Gu
Gu
Gu
Gu
Gu
"}
(5,1,1) = {"
Gu
Gu
Gu
Gu
Gu
Gu
zf
Fv
ZS
mx
zf
Gu
Gu
Gu
Gu
Gu
Gu
Gu
Gu
"}
(6,1,1) = {"
Gu
Gu
Gu
Gu
Gu
Gu
zf
mv
HR
Wa
zf
Gu
Gu
Gu
Gu
Gu
Gu
Gu
Gu
"}
(7,1,1) = {"
Gu
Gu
Gu
Gu
Gu
Gu
zf
ef
HR
Sn
zf
Gu
Gu
Gu
Gu
Gu
Gu
Gu
Gu
"}
(8,1,1) = {"
Gu
Gu
zf
zf
zf
zf
zf
zf
uq
zf
zf
zf
zf
zf
Rh
Gu
Gu
Gu
Gu
"}
(9,1,1) = {"
Gu
Gu
zf
bj
WE
WK
zf
Pg
zl
nC
zf
rP
iC
zf
SX
Gu
Gu
Gu
Gu
"}
(10,1,1) = {"
Gu
Gu
zf
sw
Oc
Oc
nR
zl
zl
KI
zA
PV
UP
OH
Gu
Gu
Gu
Gu
Gu
"}
(11,1,1) = {"
Gu
Gu
zf
Cw
vV
zh
zf
Pg
zl
zl
zf
ew
Ry
zf
Gu
Gu
Gu
Gu
Gu
"}
(12,1,1) = {"
Gu
Gu
zf
zf
zf
zf
zf
zf
HA
zf
zf
zf
zf
zf
Rh
Gu
Gu
Gu
Gu
"}
(13,1,1) = {"
Gu
Gu
Gu
Gu
Gu
Gu
zf
oZ
Et
oZ
zf
Gu
Gu
Gu
Gu
Gu
Gu
Gu
Gu
"}
(14,1,1) = {"
Gu
Gu
Gu
Gu
Gu
Gu
zf
Fi
Et
oZ
zf
Gu
Gu
Gu
Gu
Gu
Gu
Gu
Gu
"}
(15,1,1) = {"
Gu
Gu
Gu
Gu
Gu
Gu
zf
oZ
GR
Om
zf
Gu
Gu
Gu
Gu
Gu
Gu
Gu
Gu
"}
(16,1,1) = {"
Gu
Gu
Gu
Gu
Gu
Gu
zf
zf
zf
zf
zf
Gu
Gu
Gu
Gu
Gu
Gu
Gu
Gu
"}
(17,1,1) = {"
Gu
Gu
Gu
Gu
Gu
Gu
Gu
Gu
Gu
Gu
Gu
Gu
Gu
Gu
Gu
Gu
Gu
Gu
Gu
"}
(18,1,1) = {"
Gu
Gu
Gu
Gu
Gu
Gu
Gu
Gu
Gu
Gu
Gu
Gu
Gu
Gu
Gu
Gu
Gu
Gu
Gu
"}
(19,1,1) = {"
Gu
Gu
Gu
Gu
Gu
Gu
Gu
Gu
Gu
Gu
Gu
Gu
Gu
Gu
Gu
Gu
Gu
Gu
Gu
"}
