//MAP CONVERTED BY dmm2tgm.py THIS HEADER COMMENT PREVENTS RECONVERSION, DO NOT REMOVE
"abJ" = (
/obj/structure/lattice/catwalk/indoor/urban,
/turf/simulated/floor/plating,
/area/template_noop)
"acy" = (
/turf/simulated/floor/sidewalk/detail,
/area/template_noop)
"ahJ" = (
/obj/structure/lattice/catwalk/indoor,
/obj/effect/map_effect/marker/mapmanip/submap/extract/dummy/hallway_floor,
/turf/simulated/floor/plating,
/area/template_noop)
"ajc" = (
/obj/effect/map_effect/marker_helper/mapmanip/submap/edge,
/turf/template_noop,
/area/template_noop)
"awt" = (
/turf/simulated/floor/sidewalk,
/area/template_noop)
"aEC" = (
/obj/effect/map_effect/marker_helper/mapmanip/submap/edge{
	dir = 8
	},
/turf/template_noop,
/area/template_noop)
"aSE" = (
/obj/structure/lattice/catwalk/indoor,
/turf/simulated/floor/plating,
/area/template_noop)
"aZi" = (
/turf/simulated/floor/sidewalk/dark,
/area/template_noop)
"fzU" = (
/obj/effect/map_effect/marker/mapmanip/submap/extract/dummy/priority,
/turf/simulated/floor/sidewalk/dark/detail,
/area/template_noop)
"gMw" = (
/turf/simulated/floor/sidewalk/paved,
/area/template_noop)
"gVr" = (
/obj/effect/map_effect/marker/mapmanip/submap/extract/dummy/medium,
/turf/simulated/floor/sidewalk/flat,
/area/template_noop)
"mak" = (
/obj/effect/map_effect/marker/mapmanip/submap/extract/dummy/hallway_horizontal,
/turf/template_noop,
/area/template_noop)
"nnM" = (
/obj/effect/map_effect/marker/mapmanip/submap/extract/dummy/hallway_vertical,
/turf/template_noop,
/area/template_noop)
"qai" = (
/turf/template_noop,
/area/template_noop)
"qoV" = (
/turf/simulated/floor/redgrid,
/area/template_noop)
"umm" = (
/turf/simulated/floor/sidewalk/dark/detail,
/area/template_noop)
"vll" = (
/obj/effect/map_effect/marker/mapmanip/submap/extract/dummy/small,
/turf/simulated/floor/sidewalk/dark,
/area/template_noop)
"vxY" = (
/turf/simulated/floor/sidewalk/flat,
/area/template_noop)

(1,1,1) = {"
qai
qai
qai
qai
qai
qai
qai
qai
qai
qai
qai
qai
qai
qai
qai
qai
qai
qai
qai
qai
qai
qai
qai
qai
qai
qai
qai
qai
qai
qai
qai
qai
qai
qai
qai
qai
qai
qai
qai
qai
qai
qai
qai
qai
qai
qai
qai
qai
qai
qai
qai
qai
qai
qai
qai
qai
qai
qai
qai
qai
"}
(2,1,1) = {"
qai
qai
qai
qai
qai
qai
qai
qai
qai
qai
qai
qai
qai
qai
qai
qai
qai
qai
qai
qai
qai
qai
qai
qai
qai
qai
qai
qai
qai
qai
qai
qai
qai
qai
qai
qai
qai
qai
qai
qai
qai
qai
qai
qai
qai
qai
qai
qai
qai
qai
qai
qai
qai
qai
qai
qai
qai
qai
qai
qai
"}
(3,1,1) = {"
qai
qai
qai
qai
qai
vxY
gMw
vxY
qai
qai
mak
qai
qai
qai
qai
qai
qai
vxY
gMw
vxY
qai
qai
mak
qai
qai
qai
qai
qai
qai
vxY
gMw
vxY
qai
qai
mak
qai
qai
qai
qai
qai
qai
vxY
gMw
vxY
qai
qai
mak
qai
qai
qai
aSE
aSE
ahJ
qai
qai
aSE
aSE
ahJ
qai
qai
"}
(4,1,1) = {"
qai
qai
qai
qai
qai
vxY
gMw
vxY
qai
qai
qai
qai
qai
qai
qai
qai
qai
vxY
gMw
vxY
qai
qai
qai
qai
qai
qai
qai
qai
qai
vxY
gMw
vxY
qai
qai
qai
qai
qai
qai
qai
qai
qai
vxY
gMw
vxY
qai
qai
qai
qai
qai
qai
aSE
aSE
aSE
qai
qai
aSE
aSE
aSE
qai
qai
"}
(5,1,1) = {"
qai
qai
qai
qai
qai
vxY
gMw
vxY
qai
qai
qai
qai
qai
qai
qai
qai
qai
vxY
gMw
vxY
qai
qai
qai
qai
qai
qai
qai
qai
qai
vxY
gMw
vxY
qai
qai
qai
qai
qai
qai
qai
qai
qai
vxY
gMw
vxY
qai
qai
qai
qai
qai
qai
aSE
aSE
aSE
qai
qai
aSE
aSE
aSE
qai
qai
"}
(6,1,1) = {"
qai
qai
qai
qai
qai
vxY
awt
vxY
qai
qai
qai
qai
qai
qai
qai
qai
qai
vxY
awt
vxY
qai
qai
qai
qai
qai
qai
qai
qai
qai
vxY
awt
vxY
qai
qai
qai
qai
qai
qai
qai
qai
qai
vxY
awt
vxY
qai
qai
qai
qai
qai
qai
qai
qai
qai
qai
qai
qai
qai
qai
qai
qai
"}
(7,1,1) = {"
qai
ajc
qai
qai
qai
vxY
acy
vxY
qai
qai
qai
qai
qai
ajc
qai
qai
qai
vxY
acy
vxY
qai
qai
qai
qai
qai
ajc
qai
qai
qai
vxY
acy
vxY
qai
qai
qai
qai
qai
ajc
qai
qai
qai
vxY
acy
vxY
qai
qai
qai
qai
qai
qai
qai
qai
qai
qai
qai
qai
qai
qai
qai
qai
"}
(8,1,1) = {"
qai
qai
qai
qai
qai
vxY
awt
vxY
qai
qai
qai
qai
qai
qai
qai
qai
qai
vxY
awt
vxY
qai
qai
qai
qai
qai
qai
qai
qai
qai
vxY
awt
vxY
qai
qai
qai
qai
qai
qai
qai
qai
qai
vxY
awt
vxY
qai
qai
qai
qai
qai
qai
aSE
aSE
ahJ
qai
qai
aSE
aSE
ahJ
qai
qai
"}
(9,1,1) = {"
qai
qai
qai
qai
qai
vxY
gMw
vxY
qai
qai
qai
qai
qai
qai
qai
qai
qai
vxY
gMw
vxY
qai
qai
qai
qai
qai
qai
qai
qai
qai
vxY
gMw
vxY
qai
qai
qai
qai
qai
qai
qai
qai
qai
vxY
gMw
vxY
qai
qai
qai
qai
qai
qai
aSE
aSE
aSE
qai
qai
aSE
aSE
aSE
qai
qai
"}
(10,1,1) = {"
qai
qai
qai
qai
qai
vxY
gMw
vxY
qai
qai
qai
qai
qai
qai
qai
qai
qai
vxY
gMw
vxY
qai
qai
qai
qai
qai
qai
qai
qai
qai
vxY
gMw
vxY
qai
qai
qai
qai
qai
qai
qai
qai
qai
vxY
gMw
vxY
qai
qai
qai
qai
qai
qai
aSE
aSE
aSE
qai
qai
aSE
aSE
aSE
qai
qai
"}
(11,1,1) = {"
qai
qai
qai
qai
qai
vxY
gMw
vxY
qai
qai
qai
qai
qai
qai
qai
qai
qai
vxY
gMw
vxY
qai
qai
qai
qai
qai
qai
qai
qai
qai
vxY
gMw
vxY
qai
qai
qai
qai
qai
qai
qai
qai
qai
vxY
gMw
vxY
qai
qai
qai
qai
qai
qai
qai
qai
qai
qai
qai
qai
qai
qai
qai
qai
"}
(12,1,1) = {"
qai
qai
qai
qai
qai
qai
aEC
qai
qai
qai
qai
qai
qai
qai
qai
qai
qai
qai
aEC
qai
qai
qai
qai
qai
qai
qai
qai
qai
qai
qai
aEC
qai
qai
qai
qai
qai
qai
qai
qai
qai
qai
qai
aEC
qai
qai
qai
qai
qai
qai
qai
qai
qai
qai
qai
qai
qai
qai
qai
qai
qai
"}
(13,1,1) = {"
qai
qai
qai
qai
qai
qai
qai
qai
qai
qai
qai
qai
qai
qai
qai
qai
qai
qai
qai
qai
qai
qai
qai
qai
qai
qai
qai
qai
qai
qai
qai
qai
qai
qai
qai
qai
qai
qai
qai
qai
qai
qai
qai
qai
qai
qai
qai
qai
qai
qai
qai
qai
qai
qai
qai
qai
qai
qai
qai
qai
"}
(14,1,1) = {"
qai
qai
qai
qai
qai
qai
qai
qai
qai
qai
qai
qai
qai
qai
qai
qai
qai
qai
qai
qai
qai
qai
qai
qai
qai
qai
qai
qai
qai
qai
qai
qai
qai
qai
qai
qai
qai
qai
qai
qai
qai
qai
qai
qai
qai
qai
qai
qai
qai
qai
qai
qai
qai
qai
qai
qai
qai
qai
qai
qai
"}
(15,1,1) = {"
qai
qai
qai
qai
qai
qai
qai
qai
qai
qai
nnM
qai
qai
qai
qai
qai
qai
qai
qai
qai
qai
qai
nnM
qai
qai
qai
qai
qai
qai
qai
qai
qai
qai
qai
nnM
qai
qai
qai
qai
qai
qai
qai
qai
qai
qai
qai
nnM
qai
qai
qai
qai
qai
qai
qai
qai
qai
qai
qai
qai
qai
"}
(16,1,1) = {"
qai
qai
qai
qai
qai
qai
qai
qai
qai
qai
qai
qai
qai
qai
qai
qai
qai
qai
qai
qai
qai
qai
qai
qai
qai
qai
qai
qai
qai
qai
qai
qai
qai
qai
qai
qai
qai
qai
qai
qai
qai
qai
qai
qai
qai
qai
qai
qai
qai
qai
qai
qai
qai
qai
qai
qai
qai
qai
qai
qai
"}
(17,1,1) = {"
qai
qai
qai
qai
qai
qai
qai
qai
qai
qai
qai
qai
qai
qai
qai
qai
qai
qai
qai
qai
qai
qai
qai
qai
qai
qai
qai
qai
qai
qai
qai
qai
qai
qai
qai
qai
qai
qai
qai
qai
qai
qai
qai
qai
qai
qai
qai
qai
qai
qai
qai
qai
qai
qai
qai
qai
qai
qai
qai
qai
"}
(18,1,1) = {"
qai
qai
aZi
aZi
aZi
aZi
aZi
aZi
aZi
aZi
aZi
qai
qai
qai
aZi
aZi
aZi
aZi
aZi
aZi
aZi
aZi
aZi
qai
qai
qai
aZi
aZi
aZi
aZi
aZi
aZi
aZi
aZi
aZi
qai
qai
qai
aZi
aZi
aZi
aZi
aZi
aZi
aZi
aZi
aZi
qai
qai
qai
qai
qai
qai
qai
qai
qai
qai
qai
qai
qai
"}
(19,1,1) = {"
qai
ajc
aZi
umm
umm
aZi
abJ
aZi
umm
umm
aZi
qai
qai
ajc
aZi
umm
umm
aZi
abJ
aZi
umm
umm
aZi
qai
qai
ajc
aZi
umm
umm
aZi
abJ
aZi
umm
umm
aZi
qai
qai
ajc
aZi
umm
umm
aZi
abJ
aZi
umm
umm
aZi
qai
qai
qai
qai
qai
qai
qai
qai
qai
qai
qai
qai
qai
"}
(20,1,1) = {"
qai
qai
aZi
aZi
aZi
aZi
aZi
aZi
aZi
aZi
aZi
qai
qai
qai
aZi
aZi
aZi
aZi
aZi
aZi
aZi
aZi
aZi
qai
qai
qai
aZi
aZi
aZi
aZi
aZi
aZi
aZi
aZi
aZi
qai
qai
qai
aZi
aZi
aZi
aZi
aZi
aZi
aZi
aZi
aZi
qai
qai
qai
qai
qai
qai
qai
qai
qai
qai
qai
qai
qai
"}
(21,1,1) = {"
qai
qai
qai
qai
qai
qai
qai
qai
qai
qai
qai
qai
qai
qai
qai
qai
qai
qai
qai
qai
qai
qai
qai
qai
qai
qai
qai
qai
qai
qai
qai
qai
qai
qai
qai
qai
qai
qai
qai
qai
qai
qai
qai
qai
qai
qai
qai
qai
qai
qai
qai
qai
qai
qai
qai
qai
qai
qai
qai
qai
"}
(22,1,1) = {"
qai
qai
qai
qai
qai
qai
qai
qai
qai
qai
qai
qai
qai
qai
qai
qai
qai
qai
qai
qai
qai
qai
qai
qai
qai
qai
qai
qai
qai
qai
qai
qai
qai
qai
qai
qai
qai
qai
qai
qai
qai
qai
qai
qai
qai
qai
qai
qai
qai
qai
qai
qai
qai
qai
qai
qai
qai
qai
qai
qai
"}
(23,1,1) = {"
qai
qai
qai
qai
qai
qai
qai
qai
qai
qai
qai
qai
qai
qai
qai
qai
qai
qai
qai
qai
qai
qai
qai
qai
qai
qai
qai
qai
qai
qai
qai
qai
qai
qai
qai
qai
qai
qai
qai
qai
qai
qai
qai
qai
qai
qai
qai
qai
qai
qai
qai
qai
qai
qai
qai
qai
qai
qai
qai
qai
"}
(24,1,1) = {"
qai
qai
qai
qai
qai
qai
aEC
qai
qai
qai
qai
qai
qai
qai
qai
qai
qai
qai
aEC
qai
qai
qai
qai
qai
qai
qai
qai
qai
qai
qai
aEC
qai
qai
qai
qai
qai
qai
qai
qai
qai
qai
qai
aEC
qai
qai
qai
qai
qai
qai
qai
qai
qai
qai
qai
qai
qai
qai
qai
qai
qai
"}
(25,1,1) = {"
qai
qai
qai
qai
qai
qai
qai
qai
qai
qai
qai
qai
qai
qai
qai
qai
qai
qai
qai
qai
qai
qai
qai
qai
qai
qai
qai
qai
qai
qai
qai
qai
qai
qai
qai
qai
qai
qai
qai
qai
qai
qai
qai
qai
qai
qai
qai
qai
qai
qai
qai
qai
qai
qai
qai
qai
qai
qai
qai
qai
"}
(26,1,1) = {"
qai
qai
qai
qai
qai
qai
qai
qai
qai
qai
qai
qai
qai
qai
qai
qai
qai
qai
qai
qai
qai
qai
qai
qai
qai
qai
qai
qai
qai
qai
qai
qai
qai
qai
qai
qai
qai
qai
qai
qai
qai
qai
qai
qai
qai
qai
qai
qai
qai
qai
qai
qai
qai
qai
qai
qai
qai
qai
qai
qai
"}
(27,1,1) = {"
qai
qai
aZi
aZi
aZi
aZi
aZi
aZi
aZi
aZi
vll
qai
qai
qai
aZi
aZi
aZi
aZi
aZi
aZi
aZi
aZi
vll
qai
qai
qai
aZi
aZi
aZi
aZi
aZi
aZi
aZi
aZi
vll
qai
qai
qai
aZi
aZi
aZi
aZi
aZi
aZi
aZi
aZi
vll
qai
qai
qai
qai
qai
qai
qai
qai
qai
qai
qai
qai
qai
"}
(28,1,1) = {"
qai
qai
aZi
gMw
gMw
gMw
gMw
gMw
gMw
gMw
aZi
qai
qai
qai
aZi
gMw
gMw
gMw
gMw
gMw
gMw
gMw
aZi
qai
qai
qai
aZi
gMw
gMw
gMw
gMw
gMw
gMw
gMw
aZi
qai
qai
qai
aZi
gMw
gMw
gMw
gMw
gMw
gMw
gMw
aZi
qai
qai
qai
qai
qai
qai
qai
qai
qai
qai
qai
qai
qai
"}
(29,1,1) = {"
qai
qai
aZi
gMw
gMw
gMw
gMw
gMw
gMw
gMw
aZi
qai
qai
qai
aZi
gMw
gMw
gMw
gMw
gMw
gMw
gMw
aZi
qai
qai
qai
aZi
gMw
gMw
gMw
gMw
gMw
gMw
gMw
aZi
qai
qai
qai
aZi
gMw
gMw
gMw
gMw
gMw
gMw
gMw
aZi
qai
qai
qai
qai
qai
qai
qai
qai
qai
qai
qai
qai
qai
"}
(30,1,1) = {"
qai
qai
aZi
gMw
gMw
gMw
gMw
gMw
gMw
gMw
aZi
qai
qai
qai
aZi
gMw
gMw
gMw
gMw
gMw
gMw
gMw
aZi
qai
qai
qai
aZi
gMw
gMw
gMw
gMw
gMw
gMw
gMw
aZi
qai
qai
qai
aZi
gMw
gMw
gMw
gMw
gMw
gMw
gMw
aZi
qai
qai
qai
qai
qai
qai
qai
qai
qai
qai
qai
qai
qai
"}
(31,1,1) = {"
qai
ajc
aZi
gMw
gMw
gMw
abJ
gMw
gMw
gMw
aZi
qai
qai
ajc
aZi
gMw
gMw
gMw
abJ
gMw
gMw
gMw
aZi
qai
qai
ajc
aZi
gMw
gMw
gMw
abJ
gMw
gMw
gMw
aZi
qai
qai
ajc
aZi
gMw
gMw
gMw
abJ
gMw
gMw
gMw
aZi
qai
qai
qai
qai
qai
qai
qai
qai
qai
qai
qai
qai
qai
"}
(32,1,1) = {"
qai
qai
aZi
gMw
gMw
gMw
gMw
gMw
gMw
gMw
aZi
qai
qai
qai
aZi
gMw
gMw
gMw
gMw
gMw
gMw
gMw
aZi
qai
qai
qai
aZi
gMw
gMw
gMw
gMw
gMw
gMw
gMw
aZi
qai
qai
qai
aZi
gMw
gMw
gMw
gMw
gMw
gMw
gMw
aZi
qai
qai
qai
qai
qai
qai
qai
qai
qai
qai
qai
qai
qai
"}
(33,1,1) = {"
qai
qai
aZi
gMw
gMw
gMw
gMw
gMw
gMw
gMw
aZi
qai
qai
qai
aZi
gMw
gMw
gMw
gMw
gMw
gMw
gMw
aZi
qai
qai
qai
aZi
gMw
gMw
gMw
gMw
gMw
gMw
gMw
aZi
qai
qai
qai
aZi
gMw
gMw
gMw
gMw
gMw
gMw
gMw
aZi
qai
qai
qai
qai
qai
qai
qai
qai
qai
qai
qai
qai
qai
"}
(34,1,1) = {"
qai
qai
aZi
gMw
gMw
gMw
gMw
gMw
gMw
gMw
aZi
qai
qai
qai
aZi
gMw
gMw
gMw
gMw
gMw
gMw
gMw
aZi
qai
qai
qai
aZi
gMw
gMw
gMw
gMw
gMw
gMw
gMw
aZi
qai
qai
qai
aZi
gMw
gMw
gMw
gMw
gMw
gMw
gMw
aZi
qai
qai
qai
qai
qai
qai
qai
qai
qai
qai
qai
qai
qai
"}
(35,1,1) = {"
qai
qai
aZi
aZi
aZi
aZi
aZi
aZi
aZi
aZi
aZi
qai
qai
qai
aZi
aZi
aZi
aZi
aZi
aZi
aZi
aZi
aZi
qai
qai
qai
aZi
aZi
aZi
aZi
aZi
aZi
aZi
aZi
aZi
qai
qai
qai
aZi
aZi
aZi
aZi
aZi
aZi
aZi
aZi
aZi
qai
qai
qai
qai
qai
qai
qai
qai
qai
qai
qai
qai
qai
"}
(36,1,1) = {"
qai
qai
qai
qai
qai
qai
aEC
qai
qai
qai
qai
qai
qai
qai
qai
qai
qai
qai
aEC
qai
qai
qai
qai
qai
qai
qai
qai
qai
qai
qai
aEC
qai
qai
qai
qai
qai
qai
qai
qai
qai
qai
qai
aEC
qai
qai
qai
qai
qai
qai
qai
qai
qai
qai
qai
qai
qai
qai
qai
qai
qai
"}
(37,1,1) = {"
qai
qai
qai
qai
qai
qai
qai
qai
qai
qai
qai
qai
qai
qai
qai
qai
qai
qai
qai
qai
qai
qai
qai
qai
qai
qai
qai
qai
qai
qai
qai
qai
qai
qai
qai
qai
qai
qai
qai
qai
qai
qai
qai
qai
qai
qai
qai
qai
qai
qai
qai
qai
qai
qai
qai
qai
qai
qai
qai
qai
"}
(38,1,1) = {"
qai
qai
qai
qai
qai
qai
qai
qai
qai
qai
qai
qai
qai
qai
qai
qai
qai
qai
qai
qai
qai
qai
qai
qai
qai
qai
qai
qai
qai
qai
qai
qai
qai
qai
qai
qai
qai
qai
qai
qai
qai
qai
qai
qai
qai
qai
qai
qai
qai
qai
qai
qai
qai
qai
qai
qai
qai
qai
qai
qai
"}
(39,1,1) = {"
qai
qai
aZi
aZi
aZi
aZi
aZi
aZi
aZi
aZi
vll
qai
qai
qai
vxY
vxY
vxY
vxY
vxY
vxY
vxY
vxY
vxY
vxY
vxY
vxY
vxY
vxY
gVr
qai
qai
qai
vxY
vxY
vxY
vxY
vxY
vxY
vxY
vxY
vxY
vxY
vxY
vxY
vxY
vxY
gVr
qai
qai
qai
qai
qai
qai
qai
qai
qai
qai
qai
qai
qai
"}
(40,1,1) = {"
qai
qai
aZi
gMw
gMw
gMw
gMw
gMw
gMw
gMw
aZi
qai
qai
qai
vxY
umm
umm
umm
umm
umm
umm
umm
umm
umm
umm
umm
umm
umm
vxY
qai
qai
qai
vxY
umm
umm
umm
umm
umm
umm
umm
umm
umm
umm
umm
umm
umm
vxY
qai
qai
qai
qai
qai
qai
qai
qai
qai
qai
qai
qai
qai
"}
(41,1,1) = {"
qai
qai
aZi
gMw
gMw
gMw
gMw
gMw
gMw
gMw
aZi
qai
qai
qai
vxY
umm
umm
umm
umm
umm
umm
umm
umm
umm
umm
umm
umm
umm
vxY
qai
qai
qai
vxY
umm
umm
umm
umm
umm
umm
umm
umm
umm
umm
umm
umm
umm
vxY
qai
qai
qai
qai
qai
qai
qai
qai
qai
qai
qai
qai
qai
"}
(42,1,1) = {"
qai
qai
aZi
gMw
gMw
gMw
gMw
gMw
gMw
gMw
aZi
qai
qai
qai
vxY
umm
umm
umm
umm
umm
umm
umm
umm
umm
umm
umm
umm
umm
vxY
qai
qai
qai
vxY
umm
umm
umm
umm
umm
umm
umm
umm
umm
umm
umm
umm
umm
vxY
qai
qai
qai
qai
qai
qai
qai
qai
qai
qai
qai
qai
qai
"}
(43,1,1) = {"
qai
ajc
aZi
gMw
gMw
gMw
abJ
gMw
gMw
gMw
aZi
qai
qai
qai
vxY
umm
umm
umm
umm
umm
umm
umm
umm
umm
umm
umm
umm
umm
vxY
qai
qai
qai
vxY
umm
umm
umm
umm
umm
umm
umm
umm
umm
umm
umm
umm
umm
vxY
qai
qai
qai
qai
qai
qai
qai
qai
qai
qai
qai
qai
qai
"}
(44,1,1) = {"
qai
qai
aZi
gMw
gMw
gMw
gMw
gMw
gMw
gMw
aZi
qai
qai
qai
vxY
umm
umm
umm
umm
umm
umm
umm
umm
umm
umm
umm
umm
umm
vxY
qai
qai
qai
vxY
umm
umm
umm
umm
umm
umm
umm
umm
umm
umm
umm
umm
umm
vxY
qai
qai
qai
qai
qai
qai
qai
qai
qai
qai
qai
qai
qai
"}
(45,1,1) = {"
qai
qai
aZi
gMw
gMw
gMw
gMw
gMw
gMw
gMw
aZi
qai
qai
qai
vxY
umm
umm
umm
umm
umm
umm
umm
umm
umm
umm
umm
umm
umm
vxY
qai
qai
qai
vxY
umm
umm
umm
umm
umm
umm
umm
umm
umm
umm
umm
umm
umm
vxY
qai
qai
qai
qai
qai
qai
qai
qai
qai
qai
qai
qai
qai
"}
(46,1,1) = {"
qai
qai
aZi
gMw
gMw
gMw
gMw
gMw
gMw
gMw
aZi
qai
qai
ajc
vxY
umm
umm
umm
umm
umm
umm
abJ
umm
umm
umm
umm
umm
umm
vxY
qai
qai
ajc
vxY
umm
umm
umm
umm
umm
umm
abJ
umm
umm
umm
umm
umm
umm
vxY
qai
qai
qai
qai
qai
qai
qai
qai
qai
qai
qai
qai
qai
"}
(47,1,1) = {"
qai
qai
aZi
aZi
aZi
aZi
aZi
aZi
aZi
aZi
aZi
qai
qai
qai
vxY
umm
umm
umm
umm
umm
umm
umm
umm
umm
umm
umm
umm
umm
vxY
qai
qai
qai
vxY
umm
umm
umm
umm
umm
umm
umm
umm
umm
umm
umm
umm
umm
vxY
qai
qai
qai
qai
qai
qai
qai
qai
qai
qai
qai
qai
qai
"}
(48,1,1) = {"
qai
qai
qai
qai
qai
qai
aEC
qai
qai
qai
qai
qai
qai
qai
vxY
umm
umm
umm
umm
umm
umm
umm
umm
umm
umm
umm
umm
umm
vxY
qai
qai
qai
vxY
umm
umm
umm
umm
umm
umm
umm
umm
umm
umm
umm
umm
umm
vxY
qai
qai
qai
qai
qai
qai
qai
qai
qai
qai
qai
qai
qai
"}
(49,1,1) = {"
qai
qai
qai
qai
qai
qai
qai
qai
qai
qai
qai
qai
qai
qai
vxY
umm
umm
umm
umm
umm
umm
umm
umm
umm
umm
umm
umm
umm
vxY
qai
qai
qai
vxY
umm
umm
umm
umm
umm
umm
umm
umm
umm
umm
umm
umm
umm
vxY
qai
qai
qai
qai
qai
qai
qai
qai
qai
qai
qai
qai
qai
"}
(50,1,1) = {"
qai
qai
qai
qai
qai
qai
qai
qai
qai
qai
qai
qai
qai
qai
vxY
umm
umm
umm
umm
umm
umm
umm
umm
umm
umm
umm
umm
umm
vxY
qai
qai
qai
vxY
umm
umm
umm
umm
umm
umm
umm
umm
umm
umm
umm
umm
umm
vxY
qai
qai
qai
qai
qai
qai
qai
qai
qai
qai
qai
qai
qai
"}
(51,1,1) = {"
qai
qai
aZi
aZi
aZi
aZi
aZi
aZi
aZi
aZi
vll
qai
qai
qai
vxY
umm
umm
umm
umm
umm
umm
umm
umm
umm
umm
umm
umm
umm
vxY
qai
qai
qai
vxY
umm
umm
umm
umm
umm
umm
umm
umm
umm
umm
umm
umm
umm
vxY
qai
qai
qai
qai
qai
qai
qai
qai
qai
qai
qai
qai
qai
"}
(52,1,1) = {"
qai
qai
aZi
gMw
gMw
gMw
gMw
gMw
gMw
gMw
aZi
qai
qai
qai
vxY
umm
umm
umm
umm
umm
umm
umm
umm
umm
umm
umm
umm
umm
vxY
qai
qai
qai
vxY
umm
umm
umm
umm
umm
umm
umm
umm
umm
umm
umm
umm
umm
vxY
qai
qai
qai
qai
qai
qai
qai
qai
qai
qai
qai
qai
qai
"}
(53,1,1) = {"
qai
qai
aZi
gMw
gMw
gMw
gMw
gMw
gMw
gMw
aZi
qai
qai
qai
vxY
vxY
vxY
vxY
vxY
vxY
vxY
vxY
vxY
vxY
vxY
vxY
vxY
vxY
vxY
qai
qai
qai
vxY
vxY
vxY
vxY
vxY
vxY
vxY
vxY
vxY
vxY
vxY
vxY
vxY
vxY
vxY
qai
qai
qai
qai
qai
qai
qai
qai
qai
qai
qai
qai
qai
"}
(54,1,1) = {"
qai
qai
aZi
gMw
gMw
gMw
gMw
gMw
gMw
gMw
aZi
qai
qai
qai
qai
qai
qai
qai
qai
qai
qai
aEC
qai
qai
qai
qai
qai
qai
qai
qai
qai
qai
qai
qai
qai
qai
qai
qai
qai
aEC
qai
qai
qai
qai
qai
qai
qai
qai
qai
qai
qai
qai
qai
qai
qai
qai
qai
qai
qai
qai
"}
(55,1,1) = {"
qai
ajc
aZi
gMw
gMw
gMw
abJ
gMw
gMw
gMw
aZi
qai
qai
qai
qai
qai
qai
qai
qai
qai
qai
qai
qai
qai
qai
qai
qai
qai
qai
qai
qai
qai
qai
qai
qai
qai
qai
qai
qai
qai
qai
qai
qai
qai
qai
qai
qai
qai
qai
qai
qai
qai
qai
qai
qai
qai
qai
qai
qai
qai
"}
(56,1,1) = {"
qai
qai
aZi
gMw
gMw
gMw
gMw
gMw
gMw
gMw
aZi
qai
qai
qai
qai
qai
qai
qai
qai
qai
qai
qai
qai
qai
qai
qai
qai
qai
qai
qai
qai
qai
qai
qai
qai
qai
qai
qai
qai
qai
qai
qai
qai
qai
qai
qai
qai
qai
qai
qai
qai
qai
qai
qai
qai
qai
qai
qai
qai
qai
"}
(57,1,1) = {"
qai
qai
aZi
gMw
gMw
gMw
gMw
gMw
gMw
gMw
aZi
qai
qai
qai
vxY
vxY
vxY
vxY
vxY
vxY
vxY
vxY
vxY
vxY
vxY
vxY
vxY
vxY
gVr
qai
qai
qai
umm
umm
umm
umm
umm
umm
umm
umm
umm
umm
umm
umm
umm
umm
fzU
qai
qai
qai
qai
qai
qai
qai
qai
qai
qai
qai
qai
qai
"}
(58,1,1) = {"
qai
qai
aZi
gMw
gMw
gMw
gMw
gMw
gMw
gMw
aZi
qai
qai
qai
vxY
umm
umm
umm
umm
umm
umm
umm
umm
umm
umm
umm
umm
umm
vxY
qai
qai
qai
umm
qoV
qoV
qoV
qoV
qoV
qoV
qoV
qoV
qoV
qoV
qoV
qoV
qoV
umm
qai
qai
qai
qai
qai
qai
qai
qai
qai
qai
qai
qai
qai
"}
(59,1,1) = {"
qai
qai
aZi
aZi
aZi
aZi
aZi
aZi
aZi
aZi
aZi
qai
qai
qai
vxY
umm
umm
umm
umm
umm
umm
umm
umm
umm
umm
umm
umm
umm
vxY
qai
qai
qai
umm
qoV
qoV
qoV
qoV
qoV
qoV
qoV
qoV
qoV
qoV
qoV
qoV
qoV
umm
qai
qai
qai
qai
qai
qai
qai
qai
qai
qai
qai
qai
qai
"}
(60,1,1) = {"
qai
qai
qai
qai
qai
qai
aEC
qai
qai
qai
qai
qai
qai
qai
vxY
umm
umm
umm
umm
umm
umm
umm
umm
umm
umm
umm
umm
umm
vxY
qai
qai
qai
umm
qoV
qoV
qoV
qoV
qoV
qoV
qoV
qoV
qoV
qoV
qoV
qoV
qoV
umm
qai
qai
qai
qai
qai
qai
qai
qai
qai
qai
qai
qai
qai
"}
(61,1,1) = {"
qai
qai
qai
qai
qai
qai
qai
qai
qai
qai
qai
qai
qai
qai
vxY
umm
umm
umm
umm
umm
umm
umm
umm
umm
umm
umm
umm
umm
vxY
qai
qai
qai
umm
qoV
qoV
qoV
qoV
qoV
qoV
qoV
qoV
qoV
qoV
qoV
qoV
qoV
umm
qai
qai
qai
qai
qai
qai
qai
qai
qai
qai
qai
qai
qai
"}
(62,1,1) = {"
qai
qai
qai
qai
qai
qai
qai
qai
qai
qai
qai
qai
qai
qai
vxY
umm
umm
umm
umm
umm
umm
umm
umm
umm
umm
umm
umm
umm
vxY
qai
qai
qai
umm
qoV
qoV
qoV
qoV
qoV
qoV
qoV
qoV
qoV
qoV
qoV
qoV
qoV
umm
qai
qai
qai
qai
qai
qai
qai
qai
qai
qai
qai
qai
qai
"}
(63,1,1) = {"
qai
qai
aZi
aZi
aZi
aZi
aZi
aZi
aZi
aZi
vll
qai
qai
qai
vxY
umm
umm
umm
umm
umm
umm
umm
umm
umm
umm
umm
umm
umm
vxY
qai
qai
qai
umm
qoV
qoV
qoV
qoV
qoV
qoV
qoV
qoV
qoV
qoV
qoV
qoV
qoV
umm
qai
qai
qai
qai
qai
qai
qai
qai
qai
qai
qai
qai
qai
"}
(64,1,1) = {"
qai
qai
aZi
gMw
gMw
gMw
gMw
gMw
gMw
gMw
aZi
qai
qai
ajc
vxY
umm
umm
umm
umm
umm
umm
abJ
umm
umm
umm
umm
umm
umm
vxY
qai
qai
ajc
umm
qoV
qoV
qoV
qoV
qoV
qoV
abJ
qoV
qoV
qoV
qoV
qoV
qoV
umm
qai
qai
qai
qai
qai
qai
qai
qai
qai
qai
qai
qai
qai
"}
(65,1,1) = {"
qai
qai
aZi
gMw
gMw
gMw
gMw
gMw
gMw
gMw
aZi
qai
qai
qai
vxY
umm
umm
umm
umm
umm
umm
umm
umm
umm
umm
umm
umm
umm
vxY
qai
qai
qai
umm
qoV
qoV
qoV
qoV
qoV
qoV
qoV
qoV
qoV
qoV
qoV
qoV
qoV
umm
qai
qai
qai
qai
qai
qai
qai
qai
qai
qai
qai
qai
qai
"}
(66,1,1) = {"
qai
qai
aZi
gMw
gMw
gMw
gMw
gMw
gMw
gMw
aZi
qai
qai
qai
vxY
umm
umm
umm
umm
umm
umm
umm
umm
umm
umm
umm
umm
umm
vxY
qai
qai
qai
umm
qoV
qoV
qoV
qoV
qoV
qoV
qoV
qoV
qoV
qoV
qoV
qoV
qoV
umm
qai
qai
qai
qai
qai
qai
qai
qai
qai
qai
qai
qai
qai
"}
(67,1,1) = {"
qai
ajc
aZi
gMw
gMw
gMw
abJ
gMw
gMw
gMw
aZi
qai
qai
qai
vxY
umm
umm
umm
umm
umm
umm
umm
umm
umm
umm
umm
umm
umm
vxY
qai
qai
qai
umm
qoV
qoV
qoV
qoV
qoV
qoV
qoV
qoV
qoV
qoV
qoV
qoV
qoV
umm
qai
qai
qai
qai
qai
qai
qai
qai
qai
qai
qai
qai
qai
"}
(68,1,1) = {"
qai
qai
aZi
gMw
gMw
gMw
gMw
gMw
gMw
gMw
aZi
qai
qai
qai
vxY
umm
umm
umm
umm
umm
umm
umm
umm
umm
umm
umm
umm
umm
vxY
qai
qai
qai
umm
qoV
qoV
qoV
qoV
qoV
qoV
qoV
qoV
qoV
qoV
qoV
qoV
qoV
umm
qai
qai
qai
qai
qai
qai
qai
qai
qai
qai
qai
qai
qai
"}
(69,1,1) = {"
qai
qai
aZi
gMw
gMw
gMw
gMw
gMw
gMw
gMw
aZi
qai
qai
qai
vxY
umm
umm
umm
umm
umm
umm
umm
umm
umm
umm
umm
umm
umm
vxY
qai
qai
qai
umm
qoV
qoV
qoV
qoV
qoV
qoV
qoV
qoV
qoV
qoV
qoV
qoV
qoV
umm
qai
qai
qai
qai
qai
qai
qai
qai
qai
qai
qai
qai
qai
"}
(70,1,1) = {"
qai
qai
aZi
gMw
gMw
gMw
gMw
gMw
gMw
gMw
aZi
qai
qai
qai
vxY
umm
umm
umm
umm
umm
umm
umm
umm
umm
umm
umm
umm
umm
vxY
qai
qai
qai
umm
qoV
qoV
qoV
qoV
qoV
qoV
qoV
qoV
qoV
qoV
qoV
qoV
qoV
umm
qai
qai
qai
qai
qai
qai
qai
qai
qai
qai
qai
qai
qai
"}
(71,1,1) = {"
qai
qai
aZi
aZi
aZi
aZi
aZi
aZi
aZi
aZi
aZi
qai
qai
qai
vxY
vxY
vxY
vxY
vxY
vxY
vxY
vxY
vxY
vxY
vxY
vxY
vxY
vxY
vxY
qai
qai
qai
umm
umm
umm
umm
umm
umm
umm
umm
umm
umm
umm
umm
umm
umm
umm
qai
qai
qai
qai
qai
qai
qai
qai
qai
qai
qai
qai
qai
"}
(72,1,1) = {"
qai
qai
qai
qai
qai
qai
aEC
qai
qai
qai
qai
qai
qai
qai
qai
qai
qai
qai
qai
qai
qai
aEC
qai
qai
qai
qai
qai
qai
qai
qai
qai
qai
qai
qai
qai
qai
qai
qai
qai
aEC
qai
qai
qai
qai
qai
qai
qai
qai
qai
qai
qai
qai
qai
qai
qai
qai
qai
qai
qai
qai
"}
(73,1,1) = {"
qai
qai
qai
qai
qai
qai
qai
qai
qai
qai
qai
qai
qai
qai
qai
qai
qai
qai
qai
qai
qai
qai
qai
qai
qai
qai
qai
qai
qai
qai
qai
qai
qai
qai
qai
qai
qai
qai
qai
qai
qai
qai
qai
qai
qai
qai
qai
qai
qai
qai
qai
qai
qai
qai
qai
qai
qai
qai
qai
qai
"}
